"zone_id","agrempn","fpsempn","herempn","mwtempn","othempn","retempn","totemp"
1,17,19494,2426,308,2301,401,24947
2,66,28872,3430,1801,4051,550,38770
3,2,3084,1395,120,589,166,5356
4,45,11935,2619,2167,3193,779,20738
5,6,5517,5724,751,3662,2839,18499
6,2,764,2407,65,269,119,3626
7,4,1239,7388,221,290,326,9468
8,14,761,3095,69,623,177,4739
9,0,3831,8596,442,17955,218,31042
10,2,1425,1427,221,3674,535,7284
11,0,2071,2990,388,2213,2785,10447
12,164,6885,5274,433,2718,542,16016
13,0,9457,1344,1328,2206,429,14764
14,12,12023,729,1362,5759,495,20380
15,17,7851,2205,321,3481,238,14113
16,101,11304,5423,945,4902,1631,24306
17,9,3381,1250,678,2395,264,7977
18,27,3380,1577,850,1162,349,7345
19,0,1283,1840,1007,2847,1256,8233
20,2,1088,1248,847,1404,384,4973
21,77,2887,1945,259,3357,382,8907
22,10,11880,3512,587,1599,442,18030
23,3,3818,794,2167,2483,229,9494
24,32,10071,1962,846,3289,230,16430
25,0,458,1396,188,385,339,2766
26,0,337,572,108,133,128,1278
27,0,179,1202,56,103,157,1697
28,0,1342,432,27,132,28,1961
29,2,198,1771,13,209,18,2211
30,0,245,998,109,271,131,1754
31,0,1109,2044,65,224,145,3587
32,0,387,1229,111,261,235,2223
33,2,306,627,85,271,149,1440
34,2,261,518,55,192,196,1224
35,0,306,219,45,103,36,709
36,0,430,1323,135,450,343,2681
37,0,1214,1082,224,306,266,3092
38,0,1690,583,231,537,185,3226
39,0,237,753,374,190,64,1618
40,5,589,1813,117,204,1014,3742
41,14,1676,4624,983,515,737,8549
42,0,114,135,64,465,19,797
43,12,477,690,73,993,184,2429
44,2,1763,1182,2149,400,126,5622
45,2,1239,1647,283,1053,503,4727
46,0,758,841,75,435,102,2211
47,3,397,2911,96,359,226,3992
48,21,286,723,12,83,50,1175
49,17,553,477,27,139,38,1251
50,4,694,1545,127,983,432,3785
51,3,1206,238,21,183,25,1676
52,6,1324,1465,419,1108,23,4345
53,35,96,2310,11,414,163,3029
54,2,350,676,83,180,251,1542
55,0,193,79,11,65,48,396
56,0,19,486,0,90,3,598
57,7,263,68,21,38,5,402
58,2,224,651,41,203,234,1355
59,0,358,859,71,218,42,1548
60,3,132,120,29,99,22,405
61,2,241,373,21,836,67,1540
62,4,536,865,124,403,157,2089
63,0,299,601,47,154,80,1181
64,0,473,489,54,260,160,1436
65,0,519,800,118,487,336,2260
66,2,318,991,222,264,260,2057
67,2,265,216,32,169,68,752
68,0,120,352,18,92,53,635
69,0,1127,3138,182,314,462,5223
70,0,767,1750,197,1177,568,4459
71,21,661,1692,102,363,205,3044
72,2,317,1090,59,133,87,1688
73,0,345,1055,111,442,243,2196
74,0,614,3314,95,305,251,4579
75,0,1311,1749,126,676,341,4203
76,8,628,1023,121,3507,123,5410
77,3,435,1071,103,208,105,1925
78,0,221,369,9,1131,28,1758
79,2,614,3110,80,1481,173,5460
80,0,140,222,16,115,24,517
81,0,358,1611,78,209,131,2387
82,3,391,572,52,264,403,1685
83,14,258,466,44,96,62,940
84,2,249,277,50,1306,129,2013
85,0,391,423,60,289,326,1489
86,0,427,1039,38,212,68,1784
87,0,257,1008,17,152,51,1485
88,0,302,858,112,226,400,1898
89,0,425,484,175,194,134,1412
90,0,234,7016,35,220,129,7634
91,5,287,368,36,70,32,798
92,0,155,5232,20,674,7,6088
93,0,376,308,50,206,68,1008
94,0,608,876,47,254,235,2020
95,0,401,363,33,873,43,1713
96,4,184,192,22,104,56,562
97,0,224,353,36,121,31,765
98,2,441,458,64,129,201,1295
99,0,145,368,15,97,97,722
100,0,477,1727,188,483,350,3225
101,4,659,1636,201,800,432,3732
102,0,229,287,92,145,24,777
103,0,294,434,39,227,112,1106
104,7,1829,1119,47,355,277,3634
105,2,383,586,37,168,89,1265
106,4,792,1475,259,5032,493,8055
107,0,2076,2592,1916,2707,1123,10414
108,2,1038,1297,1419,2215,437,6408
109,0,2445,1387,984,1695,415,6926
110,30,679,1330,1335,2476,809,6659
111,5,1029,1053,1015,1002,259,4363
112,2,411,445,221,328,84,1491
113,0,300,291,203,296,53,1143
114,2,528,622,320,251,185,1908
115,0,115,5749,51,969,15,6899
116,4,1799,1242,694,2429,390,6558
117,0,137,396,44,130,31,738
118,2,290,226,19,141,42,720
119,0,70,159,26,43,76,374
120,2,149,387,28,174,76,816
121,0,209,241,97,163,116,826
122,0,309,287,33,137,30,796
123,2,311,960,63,307,215,1858
124,0,200,400,55,148,37,840
125,0,110,220,10,96,25,461
126,0,127,63,19,139,313,661
127,0,285,290,37,137,69,818
128,0,273,379,37,185,62,936
129,4,257,186,53,187,31,718
130,0,398,244,45,160,195,1042
131,3,468,200,22,221,26,940
132,0,368,3253,88,227,315,4251
133,0,377,398,37,227,91,1130
134,0,367,540,101,339,212,1559
135,0,124,241,14,86,30,495
136,0,149,621,210,41,2,1023
137,0,139,110,34,146,114,543
138,6,341,759,92,377,143,1718
139,2,356,307,226,184,74,1149
140,2,111,101,79,33,10,336
141,0,71,96,10,68,16,261
142,9,1761,1751,4197,4032,780,12530
143,0,83,302,56,692,51,1184
144,0,4210,130,25,63,7,4435
145,0,4560,1055,911,712,159,7397
146,0,38,21,48,0,0,107
147,0,315,422,713,1217,101,2768
148,5,312,305,550,758,54,1984
149,0,854,268,216,266,22,1626
150,0,365,228,267,825,127,1812
151,0,72,39,13,61,2,187
152,0,138,254,24,92,13,521
153,0,80,98,575,89,6,848
154,0,136,195,106,59,52,548
155,3,74,62,10,24,7,180
156,0,59,70,17,11,9,166
157,0,17,15,7,18,7,64
158,0,19,215,3,11,5,253
159,0,118,98,10,39,12,277
160,0,71,79,12,56,13,231
161,0,104,86,10,68,21,289
162,0,107,148,53,128,79,515
163,0,88,82,8,32,6,216
164,0,188,376,275,122,139,1100
165,0,316,1022,58,752,401,2549
166,2,233,205,37,127,21,625
167,0,175,186,20,114,37,532
168,0,379,316,51,197,50,993
169,5,706,1311,95,469,130,2716
170,2,786,1201,134,380,261,2764
171,3,262,277,34,78,127,781
172,5,403,465,76,175,165,1289
173,0,223,74,27,74,29,427
174,0,295,312,12,137,23,779
175,0,435,1251,102,304,155,2247
176,0,183,488,41,113,355,1180
177,3,759,804,287,376,253,2482
178,2,289,316,87,171,38,903
179,0,222,349,54,169,120,914
180,2,158,306,53,129,61,709
181,0,303,212,29,83,37,664
182,3,196,123,45,167,44,578
183,0,226,452,62,150,119,1009
184,2,524,592,180,294,165,1757
185,0,861,1341,159,465,193,3019
186,7,624,722,126,187,31,1697
187,7,280,870,86,137,239,1619
188,0,224,1699,65,290,1380,3658
189,4,117,243,35,142,17,558
190,0,29,677,15,164,9,894
191,2,192,293,62,118,61,728
192,0,321,490,63,166,605,1645
193,0,491,1029,124,459,62,2165
194,12,249,2166,282,90,154,2953
195,2,171,425,68,197,55,918
196,0,161,165,22,94,20,462
197,0,87,61,48,48,108,352
198,0,351,555,92,58,19,1075
199,0,1398,1291,71,414,1253,4427
200,2,142,1421,163,179,2156,4063
201,0,236,617,169,244,164,1430
202,2,156,367,21,167,20,733
203,2,1043,599,78,366,246,2334
204,0,345,483,123,141,112,1204
205,0,141,175,24,90,13,443
206,0,151,68,37,42,18,316
207,0,101,202,148,145,27,623
208,0,1636,848,3290,1865,496,8135
209,0,298,455,71,113,20,957
210,0,98,146,165,90,73,572
211,0,352,882,115,317,218,1884
212,128,6053,4979,17164,3328,1915,33567
213,7,307,879,108,278,145,1724
214,0,232,322,36,343,23,956
215,0,173,235,186,326,166,1086
216,0,102,1784,13,28,353,2280
217,0,205,374,58,94,30,761
218,0,238,240,35,40,21,574
219,0,147,162,40,69,26,444
220,4,197,240,55,111,110,717
221,0,125,77,56,35,35,328
222,0,219,443,48,185,160,1055
223,0,330,648,167,388,59,1592
224,2,248,213,19,205,29,716
225,0,440,652,28,233,350,1703
226,4,290,619,173,267,247,1600
227,0,242,99,33,207,42,623
228,0,2,2,2,0,0,6
229,2,202,720,74,126,70,1194
230,0,300,827,139,125,369,1760
231,0,229,107,248,67,21,672
232,0,203,266,50,68,29,616
233,0,358,513,241,168,91,1371
234,0,2301,1447,638,825,1794,7005
235,0,162,329,46,427,47,1011
236,0,225,646,80,223,207,1381
237,2,261,1132,78,227,207,1907
238,0,110,365,394,322,53,1244
239,0,232,325,1158,822,21,2558
240,0,605,1756,188,790,473,3812
241,0,224,358,59,147,12,800
242,0,171,135,39,75,24,444
243,0,207,295,22,54,23,601
244,2,279,466,60,251,198,1256
245,5,292,130,61,68,16,572
246,0,927,3562,158,417,273,5337
247,3,248,286,49,116,19,721
248,16,3762,2769,4337,1943,551,13378
249,0,1774,1290,2608,840,361,6873
250,5,277,263,43,421,77,1086
251,37,1973,1649,508,1206,1474,6847
252,12,794,567,158,217,88,1836
253,2,214,82,4,41,16,359
254,9,777,346,92,402,23,1649
255,2,325,310,36,68,41,782
256,0,710,354,147,279,46,1536
257,8,2478,3664,393,924,721,8188
258,0,379,841,74,299,185,1778
259,0,229,516,63,147,138,1093
260,0,223,434,86,220,124,1087
261,5,355,617,209,415,106,1707
262,0,192,228,74,172,66,732
263,0,54,52,82,241,32,461
264,2,670,1545,151,509,126,3003
265,7,2296,659,952,1870,872,6656
266,10,4393,2197,1494,3393,617,12104
267,0,358,479,100,175,32,1144
268,0,196,464,32,173,22,887
269,8,281,291,54,95,115,844
270,0,128,66,13,41,85,333
271,0,213,169,36,85,27,530
272,0,299,334,122,100,111,966
273,75,283,34,50,348,9,799
274,0,1181,388,190,402,139,2300
275,0,731,566,300,401,353,2351
276,0,87,32,40,65,8,232
277,0,243,309,133,163,167,1015
278,2,6154,1946,175,688,840,9805
279,0,1221,405,130,668,444,2868
280,6,2559,990,327,891,351,5124
281,3,1161,1380,101,696,86,3427
282,7,901,814,583,587,70,2962
283,0,162,383,14,65,26,650
284,0,766,748,98,519,2356,4487
285,0,220,247,24,207,10,708
286,0,646,811,104,322,145,2028
287,4,520,1167,189,484,222,2586
288,2,335,1175,42,228,92,1874
289,0,415,125,103,121,34,798
290,0,231,174,43,60,42,550
291,0,1020,1415,597,1059,95,4186
292,2,148,703,21,677,9,1560
293,14,243,621,182,563,46,1669
294,14,316,904,52,305,55,1646
295,53,512,230,138,258,141,1332
296,248,1232,1977,295,944,296,4992
297,168,371,434,181,361,50,1565
298,756,1267,835,202,624,87,3771
299,39,441,437,70,351,150,1488
300,41,650,755,45,442,28,1961
301,2,469,663,125,314,111,1684
302,9,540,324,96,251,36,1256
303,3,263,1927,38,268,57,2556
304,5,429,368,55,160,45,1062
305,2,193,69,17,48,6,335
306,2,352,188,88,69,14,713
307,0,387,390,76,143,32,1028
308,15,235,214,20,89,14,587
309,6,1176,2000,777,746,899,5604
310,8,3584,1822,3818,2794,1210,13236
311,2,5753,2338,12077,8621,248,29039
312,4,500,298,225,267,32,1326
313,6,1473,770,1363,1908,940,6460
314,3,724,596,1446,1097,931,4797
315,0,3329,5401,493,10629,1486,21338
316,0,150,298,37,293,39,817
317,0,323,1253,41,228,79,1924
318,0,266,372,59,175,142,1014
319,2,237,226,32,131,19,647
320,0,268,406,31,183,16,904
321,0,404,328,65,194,222,1213
322,2,762,304,51,119,18,1256
323,0,170,298,85,168,515,1236
324,0,226,535,34,88,260,1143
325,0,187,181,22,106,264,760
326,0,164,301,27,274,183,949
327,11,368,425,24,131,164,1123
328,0,422,538,179,377,102,1618
329,2,484,444,1115,649,133,2827
330,0,572,218,32,70,60,952
331,0,1897,616,3606,5599,99,11817
332,0,1250,720,983,790,85,3828
333,15,268,761,71,107,589,1811
334,0,141,300,31,132,73,677
335,2,1016,961,14,113,38,2144
336,0,370,437,32,159,74,1072
337,0,149,147,29,3064,23,3412
338,0,152,70,13,52,30,317
339,4,394,451,39,355,18,1261
340,48,3465,874,71,2280,135,6873
341,38,1718,2286,278,721,864,5905
342,4,729,1007,107,216,16,2079
343,0,221,451,15,62,21,770
344,4,297,216,27,78,14,636
345,0,503,621,94,136,83,1437
346,4,3492,1123,100,563,90138,95420
347,37,2641,1345,183,241,57,4504
348,0,1982,100,876,255,2,3215
349,4,10992,7028,9905,954,54,28937
350,2,676,2606,10,58,6,3358
351,0,1858,2124,192,957,295,5426
352,0,0,7,0,2,0,9
353,0,22,114,8,66,8,218
354,0,609,2749,43,548,216,4165
355,0,924,34077,220,417,2297,37935
356,54,8735,4284,651,2243,1041,17008
357,8,691,540,48,149,59,1495
358,0,568,496,86,243,25,1418
359,4,658,331,36,126,33,1188
360,6,487,283,27,81,53,937
361,2,978,654,146,278,206,2264
362,2,980,1033,615,754,65,3449
363,0,164,425,16,61,24,690
364,0,182,460,108,58,71,879
365,0,442,328,51,163,144,1128
366,4,788,1357,108,747,186,3190
367,2,671,1004,87,142,85,1991
368,0,731,425,37,146,33,1372
369,28,741,833,108,205,111,2026
370,7,2824,1916,309,1182,605,6843
371,0,957,678,196,277,81,2189
372,0,859,955,186,305,1499,3804
373,0,181,193,14,88,55,531
374,7,1478,1152,1507,1489,721,6354
375,0,129,159,13,89,165,555
376,5,860,261,489,188,101,1904
377,4,670,442,236,524,512,2388
378,5,2668,2424,341,2185,214,7837
379,2,250,420,45,67,73,857
380,0,72,112,31,104,37,356
381,2,693,793,249,734,273,2744
382,0,412,273,11,65,28,789
383,0,243,1409,57,90,150,1949
384,2,520,556,62,79,43,1262
385,2,329,245,47,168,35,826
386,25,248,157,22,61,16,529
387,4,525,425,33,208,185,1380
388,2,1054,1578,114,230,76,3054
389,0,513,1901,72,146,245,2877
390,0,353,438,150,248,334,1523
391,0,447,500,120,178,528,1773
392,0,83,113,46,33,53,328
393,0,238,541,229,120,254,1382
394,2,336,859,99,2589,246,4131
395,0,675,398,2885,1100,148,5206
396,0,858,88,1592,631,233,3402
397,0,5477,94,1512,324,393,7800
398,0,294,483,306,285,84,1452
399,2,3525,99,2038,2348,103,8115
400,0,104,196,23,137,16,476
401,14,4353,1320,3539,3920,602,13748
402,0,280,130,82,1275,2,1769
403,6,2224,955,7972,2010,42,13209
404,0,1435,405,3703,1366,25,6934
405,0,297,638,2039,1519,683,5176
406,2,2069,1012,8027,1000,179,12289
407,13,2851,2456,7910,3091,968,17289
408,12,4462,887,3868,2681,243,12153
409,16,3395,905,8993,738,118,14165
410,0,511,225,8708,3279,11,12734
411,0,0,0,691,7,0,698
412,0,4645,660,21657,1514,285,28761
413,2,801,568,476,260,125,2232
414,0,1461,907,5135,1790,375,9668
415,14,6693,2382,14703,2795,911,27498
416,0,2093,903,1038,840,145,5019
417,2,2660,23,2758,446,4,5893
418,0,692,299,2174,473,105,3743
419,0,108,317,28,127,86,666
420,0,105,112,17,65,4,303
421,2,169,292,131,55,167,816
422,2,494,360,919,287,64,2126
423,2,127,266,39,51,48,533
424,2,381,607,167,151,43,1351
425,0,127,248,19,74,92,560
426,0,314,130,1413,94,248,2199
427,3,2837,841,6509,2470,1171,13831
428,6,3948,1974,2800,1319,440,10487
429,6,1673,931,8570,306,125,11611
430,0,2192,527,7986,1039,151,11895
431,0,2742,204,3637,1512,138,8233
432,24,3693,1030,5009,2251,879,12886
433,0,489,483,114,494,62,1642
434,0,1682,474,1826,385,126,4493
435,2,7769,3999,4975,2063,236,19044
436,3,161,1458,42,87,41,1792
437,0,191,369,46,111,234,951
438,33,178,902,103,113,216,1545
439,0,157,201,67,77,33,535
440,0,381,429,22,71,120,1023
441,0,325,340,31,610,33,1339
442,0,256,341,48,116,87,848
443,2,423,321,18,82,17,863
444,12,275,1106,114,163,235,1905
445,0,299,715,68,199,402,1683
446,0,270,111,93,175,90,739
447,0,289,280,72,147,228,1016
448,5,437,825,29,187,1110,2593
449,2,376,815,82,137,367,1779
450,0,1032,1359,279,508,530,3708
451,17,327,428,104,106,56,1038
452,0,261,997,108,165,38,1569
453,0,327,863,669,153,56,2068
454,0,389,349,13,60,22,833
455,2,1206,392,479,158,43,2280
456,0,353,526,97,225,231,1432
457,0,309,336,34,101,8,788
458,0,234,134,10,74,15,467
459,10,798,647,87,188,89,1819
460,0,828,1113,4986,312,429,7668
461,0,268,1172,24,145,40,1649
462,4,1756,604,143,429,1479,4415
463,0,345,221,37,117,653,1373
464,0,199,162,43,68,22,494
465,0,684,1299,489,805,1054,4331
466,0,481,990,225,159,2238,4093
467,0,1895,1436,411,1126,496,5364
468,6,738,1075,121,428,381,2749
469,0,298,313,79,163,14,867
470,0,323,386,53,136,110,1008
471,2,318,1072,112,120,649,2273
472,0,1035,1072,230,345,124,2806
473,0,428,285,206,178,36,1133
474,0,217,274,32,105,153,781
475,0,484,850,155,455,1306,3250
476,5,645,1341,102,391,398,2882
477,0,288,735,38,224,51,1336
478,0,201,275,104,86,313,979
479,0,593,701,80,237,80,1691
480,0,294,363,15,66,10,748
481,3,293,389,65,107,92,949
482,0,213,189,62,99,19,582
483,0,1049,868,223,387,532,3059
484,2,1089,1360,228,398,305,3382
485,21,1449,1948,2328,770,278,6794
486,7,582,754,187,252,628,2410
487,0,444,670,32,239,70,1455
488,34,618,709,134,205,31,1731
489,6,635,665,127,91,27,1551
490,2,845,935,478,307,332,2899
491,0,210,89,39,48,24,410
492,2,395,194,49,74,26,740
493,3,739,581,207,174,46,1750
494,11,828,716,71,163,238,2027
495,2,801,440,247,166,28,1684
496,3,731,691,96,306,91,1918
497,8,950,1819,228,470,39,3514
498,0,744,723,252,208,51,1978
499,0,570,741,116,249,341,2017
500,0,242,125,15,141,22,545
501,2,195,112,25,41,27,402
502,0,224,327,42,109,86,788
503,6,380,742,47,240,58,1473
504,11,2912,2476,2244,3079,1287,12009
505,0,278,209,139,398,24,1048
506,0,365,1679,137,151,31,2363
507,6,589,445,49,210,86,1385
508,0,984,460,458,612,6,2520
509,0,1046,1103,260,466,158,3033
510,11,518,335,85,116,18,1083
511,6,2036,3271,707,1083,729,7832
512,39,526,212,41,338,61,1217
513,5,331,285,50,80,33,784
514,8,721,571,97,170,271,1838
515,2,357,3984,34,136,23,4536
516,0,360,384,51,96,21,912
517,2,534,1296,68,278,158,2336
518,2,1002,3246,246,329,830,5655
519,4,745,3985,1346,309,116,6505
520,0,458,512,210,436,143,1759
521,2,521,1066,229,431,309,2558
522,13,491,1049,52,376,116,2097
523,4,445,539,108,309,528,1933
524,4,369,175,95,118,30,791
525,2,269,377,42,70,33,793
526,16,501,646,98,208,64,1533
527,2,1113,1048,122,474,756,3515
528,10,585,654,62,221,59,1591
529,8,769,493,344,167,181,1962
530,14,3944,2168,770,1861,919,9676
531,0,1009,672,77,270,340,2368
532,0,190,243,42,84,82,641
533,0,810,2404,365,419,148,4146
534,0,647,1354,19,350,104,2474
535,4,225,1050,173,219,291,1962
536,0,123,163,43,117,258,704
537,7,1196,1258,703,709,414,4287
538,4,751,304,156,795,62,2072
539,2,840,1794,1064,1032,429,5161
540,16,1492,1635,247,631,287,4308
541,2,545,2960,223,275,173,4178
542,21,568,801,132,824,70,2416
543,0,743,1014,3382,839,298,6276
544,0,193,527,47,478,86,1331
545,4,226,850,292,394,75,1841
546,0,1174,735,600,4203,56,6768
547,2,822,354,619,1228,280,3305
548,5,295,745,80,207,123,1455
549,0,901,1487,94,1740,169,4391
550,0,98,564,22,53,29,766
551,0,312,592,288,703,117,2012
552,0,72,63,48,63,21,267
553,0,49,148,21,77,32,327
554,2,303,599,6,242,65,1217
555,0,195,639,132,179,169,1314
556,0,29,543,0,146,24,742
557,2,1389,1948,278,4329,204,8150
558,25,9676,3738,826,3747,328,18340
559,12,235,453,30,106,63,899
560,0,2906,700,144,151,96,3997
561,0,165,223,506,174,3679,4747
562,0,145,136,29,87,65,462
563,98,1561,1897,4948,4335,1130,13969
564,0,297,1530,37,116,234,2214
565,6,362,391,338,539,617,2253
566,2,699,400,152,415,398,2066
567,2,307,504,373,288,145,1619
568,4,226,269,292,202,72,1065
569,0,34,174,18,52,67,345
570,0,89,238,25,57,103,512
571,0,100,189,11,44,18,362
572,0,73,268,6,27,6,380
573,0,130,374,40,103,44,691
574,0,286,590,46,166,73,1161
575,0,159,217,53,102,15,546
576,0,155,167,73,163,27,585
577,0,104,276,16,34,12,442
578,15,180,567,40,137,303,1242
579,0,80,265,262,557,150,1314
580,0,95,120,482,90,57,844
581,0,67,83,2,123,11,286
582,0,1185,926,33,422,285,2851
583,2,508,1385,171,240,1969,4275
584,0,94,473,66,53,15,701
585,0,103,178,7,81,156,525
586,0,145,449,31,247,530,1402
587,0,48,197,10,35,30,320
588,0,88,147,11,57,54,357
589,0,83,158,28,30,18,317
590,0,35,78,11,2,9,135
591,0,319,678,120,211,131,1459
592,0,141,223,48,197,52,661
593,4,548,306,1599,579,156,3192
594,0,138,94,39,59,15,345
595,0,76,2610,29,77,199,2991
596,0,91,25,8,27,15,166
597,0,87,770,339,207,63,1466
598,0,298,310,74,76,64,822
599,0,181,60,47,55,13,356
600,0,174,156,66,62,29,487
601,18,795,453,223,326,82,1897
602,0,962,282,1042,3925,246,6457
603,57,1123,585,853,2046,396,5060
604,0,213,651,4949,210,63,6086
605,2,2500,1687,10520,1724,808,17241
606,0,1074,514,988,358,111,3045
607,2,671,1749,675,1674,2073,6844
608,7,1370,1020,5244,1499,172,9312
609,2,1158,889,293,885,434,3661
610,0,74,5,761,51,11,902
611,4,479,692,91,166,198,1630
612,0,450,366,1347,189,181,2533
613,0,105,364,45,74,83,671
614,0,573,779,96,116,139,1703
615,0,274,354,54,80,9,771
616,0,120,1393,27,53,14,1607
617,0,104,596,45,167,203,1115
618,0,169,95,22,92,26,404
619,0,280,461,124,65,8,938
620,0,256,605,54,155,199,1269
621,0,159,288,18,43,432,940
622,0,209,538,85,70,42,944
623,0,319,134,95,68,24,640
624,0,209,48,18,38,6,319
625,4,298,304,30,63,138,837
626,0,122,315,12,65,11,525
627,0,437,551,60,119,131,1298
628,4,313,315,163,230,38,1063
629,7,367,356,51,145,230,1156
630,0,174,463,38,72,18,765
631,0,130,266,27,45,27,495
632,0,222,611,26,93,475,1427
633,0,239,1027,45,125,75,1511
634,0,93,425,67,86,129,800
635,0,157,215,43,140,129,684
636,0,147,255,37,228,244,911
637,28,458,304,51,196,20,1057
638,0,309,338,25,55,23,750
639,0,131,473,55,46,356,1061
640,0,74,121,11,44,14,264
641,0,70,442,6,38,14,570
642,0,202,68,52,213,34,569
643,0,145,146,28,23,15,357
644,0,271,80,46,42,23,462
645,0,384,311,29,65,22,811
646,0,138,170,21,46,52,427
647,2,280,69,40,402,29,822
648,4,525,300,49,40,46,964
649,0,161,598,51,126,329,1265
650,0,142,184,24,91,56,497
651,2,249,765,51,126,252,1445
652,0,187,269,26,115,38,635
653,0,1262,1130,1149,579,425,4545
654,6,876,504,141,933,56,2516
655,4,1365,1181,220,371,108,3249
656,0,2477,516,5338,488,32,8851
657,7,218,47,38,141,37,488
658,0,179,106,26,68,22,401
659,2,193,477,137,444,75,1328
660,9,2341,2453,5419,1179,975,12376
661,0,605,1684,223,117,100,2729
662,0,167,333,28,149,46,723
663,0,175,340,46,55,16,632
664,12,365,358,451,581,55,1822
665,0,527,680,68,345,395,2015
666,2,333,122,29,32,43,561
667,0,94,127,39,53,85,398
668,0,251,396,32,38,21,738
669,2,227,500,57,189,591,1566
670,0,161,543,46,111,21,882
671,0,157,59,14,131,10,371
672,0,110,148,23,57,15,353
673,0,207,462,55,100,249,1073
674,0,279,351,33,74,135,872
675,0,387,542,158,165,77,1329
676,0,574,1389,104,249,1155,3471
677,2,607,1513,104,131,1245,3602
678,0,137,287,27,77,6,534
679,0,225,358,56,155,321,1115
680,4,393,441,136,214,543,1731
681,9,345,436,35,111,114,1050
682,4,993,536,54,1345,190,3122
683,4,173,176,17,63,116,549
684,8,297,682,47,154,179,1367
685,4,377,522,36,149,94,1182
686,2,406,616,147,188,368,1727
687,0,207,952,38,613,1418,3228
688,10,283,801,155,179,228,1656
689,4,362,153,60,84,125,788
690,0,685,525,68,200,97,1575
691,0,254,209,37,32,13,545
692,0,280,854,98,110,180,1522
693,0,284,425,27,81,89,906
694,4,342,255,18,135,38,792
695,2,818,297,98,167,63,1445
696,155,979,341,46,1050,69,2640
697,79,1738,332,319,165,29,2662
698,65,523,773,117,284,337,2099
699,142,307,368,93,105,92,1107
700,254,1539,2109,5708,1783,1210,12603
701,59,509,470,176,201,345,1760
702,363,1454,1845,177,872,291,5002
703,12,334,141,678,234,24,1423
704,53,340,689,107,163,54,1406
705,29,346,939,131,226,88,1759
706,471,633,1969,1537,697,2783,8090
707,20,594,1762,955,1469,952,5752
708,16,402,709,34,348,60,1569
709,4,328,627,75,315,353,1702
710,2,413,571,34,135,179,1334
711,22,434,192,86,156,42,932
712,224,396,874,187,422,125,2228
713,188,501,154,397,556,94,1890
714,106,84,118,1443,359,2,2112
715,112,8188,1593,5964,4174,488,20519
716,19,1176,895,219,477,86,2872
717,2,237,1064,237,553,187,2280
718,11,1207,780,1595,1796,463,5852
719,0,185,301,38,127,55,706
720,11,148,234,486,398,362,1639
721,0,338,830,163,282,1279,2892
722,0,126,214,97,174,78,689
723,6,722,1224,111,541,240,2844
724,4,1727,1852,83,358,521,4545
725,4,209,171,38,80,71,573
726,6,308,343,73,246,230,1206
727,0,70,344,16,34,2,466
728,68,1138,798,1352,1285,148,4789
729,33,1239,2857,1066,769,1313,7277
730,8,865,1779,1061,1708,2398,7819
731,0,136,58,22,81,13,310
732,0,1229,1485,729,1944,675,6062
733,4,968,1925,225,1181,1113,5416
734,59,866,721,325,481,67,2519
735,60,639,854,144,459,366,2522
736,2,5114,2297,5619,796,3522,17350
737,0,1750,1018,1616,933,450,5767
738,6,241,115,11,67,18,458
739,45,2754,1930,1947,3047,357,10080
740,0,305,754,263,69,165,1556
741,2,197,331,36,92,38,696
742,8,7414,3647,4944,2780,1904,20697
743,0,2992,1331,948,1386,362,7019
744,11,290,2360,101,736,109,3607
745,0,181,235,24,126,33,599
746,141,1045,772,224,500,197,2879
747,9,337,170,163,77,12,768
748,0,205,79,40,57,27,408
749,2,380,587,251,160,153,1533
750,0,1634,1008,6456,633,106,9837
751,2,3408,2785,14926,7272,2395,30788
752,31,4402,1723,11283,1819,1085,20343
753,3,383,188,68,62,22,726
754,2,725,1172,157,160,34,2250
755,2,854,530,78,229,136,1829
756,8,823,740,824,954,361,3710
757,0,58,86,13,18,42,217
758,0,209,414,78,55,26,782
759,2,230,760,182,144,110,1428
760,0,126,179,57,162,111,635
761,0,1076,1070,288,335,281,3050
762,0,146,268,35,95,20,564
763,0,510,671,95,114,44,1434
764,0,242,1059,96,278,426,2101
765,0,313,826,26,87,353,1605
766,0,125,176,587,103,124,1115
767,0,1860,2120,2947,529,2473,9929
768,21,1577,845,3511,729,520,7203
769,0,855,709,1454,353,96,3467
770,2,472,903,743,194,201,2515
771,10,249,561,66,138,256,1280
772,0,86,155,43,81,36,401
773,0,505,707,319,510,459,2500
774,0,1073,1076,214,367,244,2974
775,9,295,325,129,175,47,980
776,2,487,1019,43,205,18,1774
777,7,2750,2779,133,3467,1048,10184
778,11,2503,3535,436,2616,182,9283
779,2,328,244,49,47,30,700
780,2,549,608,106,126,91,1482
781,2,248,261,59,102,32,704
782,0,251,381,80,191,70,973
783,0,96,26,55,46,3,226
784,2,175,466,73,118,480,1314
785,0,154,229,33,49,124,589
786,0,140,110,25,63,32,370
787,0,176,276,75,128,57,712
788,0,268,180,30,81,27,586
789,18,148,113,49,61,34,423
790,0,197,336,132,54,31,750
791,2,139,235,35,31,31,473
792,0,75,52,26,24,6,183
793,0,224,292,152,56,73,797
794,0,179,84,43,327,22,655
795,0,272,503,813,238,61,1887
796,25,593,2141,2342,312,1208,6621
797,4,700,962,4004,511,562,6743
798,0,102,340,77,56,11,586
799,2,177,137,37,75,176,604
800,0,169,821,61,344,37,1432
801,0,757,694,604,255,238,2548
802,3,54,521,9,37,10,634
803,2,54,380,12,41,9,498
804,0,157,562,15,75,268,1077
805,0,195,326,47,66,8,642
806,4,1308,1769,6334,1313,1172,11900
807,2,55,152,17,27,88,341
808,0,40,1442,12,27,11,1532
809,7,270,125,1570,605,66,2643
810,39,4004,2185,14419,4191,1628,26466
811,31,200,1617,306,193,139,2486
812,0,341,1058,71,1008,1008,3486
813,0,169,963,21,46,103,1302
814,0,31,117,25,37,53,263
815,0,32,247,2,0,5,286
816,0,47,161,20,24,97,349
817,0,68,210,29,158,39,504
818,0,84,240,25,25,24,398
819,2,103,291,27,46,238,707
820,6,612,767,91,146,134,1756
821,0,445,456,18,123,62,1104
822,0,191,94,24,127,16,452
823,0,336,704,102,148,29,1319
824,0,317,529,110,217,318,1491
825,0,96,263,32,52,3,446
826,2,173,225,204,176,290,1070
827,0,285,652,45,2168,149,3299
828,0,273,641,149,450,177,1690
829,0,43,211,7,802,22,1085
830,0,79,409,28,40,55,611
831,0,28,523,246,29,45,871
832,0,147,454,19,87,73,780
833,0,35,144,19,44,15,257
834,0,281,312,1876,38,22,2529
835,0,201,396,54,122,264,1037
836,0,73,34,7,31,206,351
837,0,157,674,75,183,54,1143
838,0,284,409,98,109,198,1098
839,2,1067,1411,276,1085,417,4258
840,2,395,670,66,153,154,1440
841,7,203,594,32,91,33,960
842,0,134,370,32,97,134,767
843,0,121,171,32,68,13,405
844,25,706,578,101,522,169,2101
845,28,281,838,63,125,47,1382
846,4,192,519,68,152,72,1007
847,9,461,641,58,459,219,1847
848,2,223,2704,132,206,390,3657
849,2,157,503,23,129,26,840
850,0,201,167,23,144,11,546
851,0,117,73,16,113,14,333
852,0,199,401,29,111,42,782
853,2,215,721,76,218,27,1259
854,0,111,283,28,256,77,755
855,0,47,194,36,46,47,370
856,0,127,779,49,177,822,1954
857,8,129,463,123,92,55,870
858,4,263,638,95,115,437,1552
859,0,58,160,34,101,73,426
860,0,396,861,13133,619,154,15163
861,2,302,1123,451,605,39,2522
862,14,429,710,1266,749,764,3932
863,0,209,334,624,185,326,1678
864,2,650,1448,328,292,746,3466
865,0,84,449,23,82,14,652
866,0,181,545,30,376,14,1146
867,0,73,237,46,60,73,489
868,2,162,414,19,84,99,780
869,0,207,371,49,134,89,850
870,0,132,135,93,124,220,704
871,7,975,2724,326,542,867,5441
872,2,162,727,559,244,1189,2883
873,4,1603,1387,8889,2007,1133,15023
874,0,392,226,1479,152,16,2265
875,29,3174,3727,2187,2320,865,12302
876,0,36,9,14,6,0,65
877,10,14,166,68,18,4,280
878,0,161,257,204,100,13,735
879,0,60,108,160,55,208,591
880,0,19,392,10,47,202,670
881,0,35,37,4,22,7,105
882,0,196,467,24,133,60,880
883,0,370,161,18,177,43,769
884,0,231,400,60,57,165,913
885,5,531,839,64,322,153,1914
886,0,147,281,28,93,151,700
887,0,91,834,24,50,42,1041
888,0,39,104,6,14,14,177
889,0,31,160,15,10,7,223
890,0,32,672,10,38,55,807
891,0,50,177,37,67,58,389
892,0,180,206,336,366,34,1122
893,100,22,196,74,222,47,661
894,0,93,118,687,237,6,1141
895,2,334,217,131,89,39,812
896,0,268,304,1599,461,222,2854
897,0,58,204,31,51,71,415
898,0,38,278,150,59,28,553
899,0,112,603,25,628,57,1425
900,0,111,582,26,1272,180,2171
901,0,144,91,11,46,13,305
902,0,33,545,9,38,27,652
903,0,179,518,14,91,20,822
904,0,84,708,42,47,41,922
905,0,111,274,28,82,34,529
906,3,68,439,12,174,73,769
907,0,117,256,4,44,17,438
908,0,187,299,35,104,141,766
909,0,129,349,30,80,53,641
910,6,258,751,27,124,54,1220
911,0,166,275,15,76,21,553
912,7,376,486,51,114,126,1160
913,25,1173,893,115,698,391,3295
914,0,341,136,30,100,14,621
915,8,319,294,63,358,34,1076
916,0,403,1104,47,86,365,2005
917,9,322,352,32,155,44,914
918,2,588,725,54,162,28,1559
919,0,119,63,15,80,3,280
920,3,263,465,15,53,23,822
921,2,239,142,23,117,82,605
922,0,280,493,54,153,54,1034
923,5,124,342,24,81,56,632
924,0,87,777,24,61,93,1042
925,0,146,780,56,126,164,1272
926,0,494,1312,883,880,572,4141
927,2,37,849,18,63,64,1033
928,0,114,255,2,48,31,450
929,0,42,69,4,50,8,173
930,0,22,434,15,24,15,510
931,0,38,627,10,68,14,757
932,0,34,35,4,45,8,126
933,0,71,427,56,72,56,682
934,2,154,613,85,145,100,1099
935,0,52,69,55,62,10,248
936,0,71,174,19,32,16,312
937,0,172,286,43,179,253,933
938,7,329,314,53,75,26,804
939,0,581,701,115,388,231,2016
940,2,177,339,598,438,34,1588
941,2,113,151,27,53,9,355
942,0,328,716,31,183,146,1404
943,0,169,439,23,120,139,890
944,0,149,334,6,52,120,661
945,2,3205,1500,939,3303,147,9096
946,2,836,1309,1029,2512,199,5887
947,2,804,3827,613,724,344,6314
948,0,402,713,354,3552,169,5190
949,2,205,468,132,239,122,1168
950,0,538,449,66,202,65,1320
951,0,215,266,20,122,16,639
952,4,1093,889,1905,667,71,4629
953,4,459,693,228,126,142,1652
954,0,255,1488,223,108,781,2855
955,2,201,1143,58,2200,260,3864
956,0,189,440,21,114,71,835
957,0,125,285,14,61,18,503
958,2,241,335,21,253,21,873
959,0,212,404,45,219,92,972
960,0,1643,1913,1083,677,457,5773
961,0,243,262,326,97,12,940
962,0,517,461,29,68,23,1098
963,9,118,305,24,100,22,578
964,0,194,193,232,134,5,758
965,0,183,89,354,492,26,1144
966,0,235,590,658,168,49,1700
967,83,892,1476,1066,1274,201,4992
968,4,5367,5632,1820,6320,582,19725
969,0,2579,1140,1943,4425,98,10185
970,0,1835,1070,125,6028,117,9175
971,0,5614,8653,608,3669,210,18754
972,2,643,2752,196,576,648,4817
973,2,399,722,31,281,60,1495
974,0,398,1857,202,397,378,3232
975,0,122,289,40,94,33,578
976,0,365,711,131,409,151,1767
977,0,258,2440,186,537,54,3475
978,8,392,486,78,221,78,1263
979,165,287,3509,92,263,220,4536
980,0,45,162,47,40,38,332
981,0,53,133,3,17,35,241
982,0,94,424,89,39,27,673
983,0,39,66,20,123,0,248
984,0,212,671,498,500,46,1927
985,0,77,215,6,24,4,326
986,0,102,154,165,61,14,496
987,0,65,112,25,327,26,555
988,32,477,330,1055,665,467,3026
989,2,147,453,392,236,45,1275
990,0,77,94,91,200,35,497
991,4,6113,5237,3610,2773,2192,19929
992,0,86,227,42,100,9,464
993,2,199,694,204,463,102,1664
994,0,42,32,49,29,41,193
995,0,83,317,29,74,22,525
996,0,144,431,177,169,71,992
997,2,65,56,22,142,2,289
998,2,319,925,182,277,165,1870
999,2,595,1207,4110,157,343,6414
1000,2,193,556,74,90,111,1026
1001,2,103,266,43,107,17,538
1002,0,301,588,31,176,130,1226
1003,2,99,2082,89,95,184,2551
1004,2,254,1783,126,149,111,2425
1005,2,285,881,39,87,22,1316
1006,2,164,326,28,34,144,698
1007,0,62,813,7,36,10,928
1008,2,240,6151,61,189,912,7555
1009,0,98,792,39,142,159,1230
1010,0,398,747,6,129,22,1302
1011,0,248,1090,138,487,375,2338
1012,0,161,457,23,76,31,748
1013,3,113,199,239,129,37,720
1014,21,3404,4509,5009,2233,1480,16656
1015,0,164,673,203,1633,82,2755
1016,14,211,990,90,176,174,1655
1017,0,234,372,33,139,101,879
1018,0,3171,4992,214,3448,612,12437
1019,0,10439,16175,10,775,8,27407
1020,0,89,635,15,162,20,921
1021,2,378,700,104,304,121,1609
1022,0,151,182,52,187,59,631
1023,0,160,831,66,127,149,1333
1024,5,143,212,105,159,38,662
1025,0,153,762,81,90,231,1317
1026,0,114,233,82,59,49,537
1027,0,374,845,158,153,370,1900
1028,2,296,242,35,39,4,618
1029,0,232,132,52,97,19,532
1030,0,133,165,22,55,21,396
1031,0,295,403,78,70,43,889
1032,0,115,228,53,21,19,436
1033,2,305,578,71,137,300,1393
1034,4,438,719,63,251,226,1701
1035,0,77,502,39,12,6,636
1036,0,76,162,16,90,11,355
1037,6,157,552,37,173,44,969
1038,0,38,163,34,544,275,1054
1039,0,250,661,138,235,225,1509
1040,0,118,222,21,45,91,497
1041,0,175,678,34,112,400,1399
1042,0,150,311,14,28,14,517
1043,3,149,202,27,62,20,463
1044,0,249,157,21,77,22,526
1045,3,197,222,46,67,18,553
1046,0,136,205,20,53,6,420
1047,2,89,208,28,450,207,984
1048,0,105,219,20,95,54,493
1049,0,495,543,39,195,223,1495
1050,0,161,413,91,280,133,1078
1051,3,258,766,182,141,575,1925
1052,0,64,45,6,6,2,123
1053,0,144,249,26,62,16,497
1054,0,111,259,7,28,46,451
1055,2,190,324,37,152,281,986
1056,0,75,364,29,810,66,1344
1057,0,38,54,0,18,23,133
1058,39,535,778,65,438,104,1959
1059,2,952,1011,2870,1868,459,7162
1060,0,331,777,341,115,20,1584
1061,2,159,994,824,1943,147,4069
1062,312,935,709,2638,908,986,6488
1063,0,68,117,25,210,22,442
1064,0,41,187,302,18,26,574
1065,0,94,638,21,83,64,900
1066,0,400,1904,62,607,382,3355
1067,0,118,271,48,192,116,745
1068,50,284,143,738,737,53,2005
1069,9,1921,1392,2202,860,2232,8616
1070,0,73,132,25,30,8,268
1071,0,103,121,43,100,17,384
1072,2,121,1065,52,252,193,1685
1073,0,101,170,56,32,8,367
1074,3,486,1180,120,153,1150,3092
1075,47,264,400,30,93,177,1011
1076,2,135,533,17,60,9,756
1077,4,205,506,82,162,94,1053
1078,0,256,424,37,168,85,970
1079,5,408,645,108,268,69,1503
1080,0,166,417,50,75,147,855
1081,0,36,77,8,10,21,152
1082,2,239,399,154,128,205,1127
1083,6,930,2233,4473,630,120,8392
1084,6,244,567,50,157,178,1202
1085,0,226,259,157,101,186,929
1086,0,330,393,52,278,176,1229
1087,17,284,280,90,112,29,812
1088,0,89,64,382,102,53,690
1089,3,158,409,144,163,144,1021
1090,0,96,573,1127,139,50,1985
1091,2,149,993,136,384,263,1927
1092,0,428,721,2115,2063,77,5404
1093,0,136,285,8,1856,17,2302
1094,2,223,450,70,2373,43,3161
1095,0,371,292,1500,1188,169,3520
1096,14,1582,1057,779,1643,624,5699
1097,27,2395,2324,4032,2608,560,11946
1098,0,330,211,43,67,12,663
1099,0,488,844,91,306,372,2101
1100,0,484,1320,153,430,172,2559
1101,9,212,260,11,115,28,635
1102,26,87,24,74,87,7,305
1103,8,424,560,40,190,146,1368
1104,0,131,196,29,61,13,430
1105,0,45,39,2,15,2,103
1106,0,365,525,58,234,180,1362
1107,2,103,36,15,54,6,216
1108,2,222,833,54,104,371,1586
1109,0,188,1248,61,140,55,1692
1110,2,561,979,255,427,261,2485
1111,0,151,514,26,313,19,1023
1112,0,172,5015,17,233,72,5509
1113,8,3727,2201,1098,1909,1107,10050
1114,0,69,18,42,53,24,206
1115,0,108,241,31,81,60,521
1116,0,95,300,16,310,49,770
1117,0,156,254,159,185,42,796
1118,0,601,774,885,1158,487,3905
1119,6,358,741,122,145,157,1529
1120,2,191,306,57,112,153,821
1121,46,4650,3184,1402,1626,1774,12682
1122,26,4491,3705,3814,2593,4091,18720
1123,2,803,714,164,266,735,2684
1124,4,549,773,64,2106,267,3763
1125,20,225,173,46,185,88,737
1126,0,307,433,91,202,105,1138
1127,2,805,2580,76,387,67,3917
1128,0,322,1218,25,156,81,1802
1129,0,247,2120,87,917,124,3495
1130,2,186,170,38,72,5,473
1131,17,455,255,73,242,100,1142
1132,13,465,509,40,148,61,1236
1133,8,676,613,143,836,228,2504
1134,0,686,995,150,728,663,3222
1135,0,235,726,147,204,71,1383
1136,2,1020,2247,275,419,153,4116
1137,0,1758,3144,438,1797,399,7536
1138,5,654,911,154,276,288,2288
1139,4,292,113,14,65,56,544
1140,0,301,819,97,82,109,1408
1141,9,527,4292,84,233,55,5200
1142,2,459,307,31,120,11,930
1143,4,667,635,31,111,40,1488
1144,4,737,804,66,282,54,1947
1145,21,9720,4910,1590,4009,1786,22036
1146,11,3263,5172,449,750,2408,12053
1147,15,551,662,80,183,56,1547
1148,17,744,485,49,220,184,1699
1149,4,565,623,584,390,154,2320
1150,4,1025,1602,134,651,486,3902
1151,8,368,529,42,131,47,1125
1152,17,1805,1921,1533,906,443,6625
1153,0,529,589,104,149,80,1451
1154,44,1148,1385,222,441,260,3500
1155,0,139,67,39,58,12,315
1156,6,624,416,36,101,91,1274
1157,4,412,630,31,167,154,1398
1158,7,324,821,109,193,246,1700
1159,2,191,1175,50,120,105,1643
1160,4,529,510,131,162,133,1469
1161,27,3419,4718,715,2113,1493,12485
1162,4,95,40,12,86,10,247
1163,5,268,269,68,54,6,670
1164,14,669,679,144,242,79,1827
1165,31,600,536,77,283,70,1597
1166,20,1268,877,362,462,273,3262
1167,2,588,691,269,246,98,1894
1168,20,7537,5078,3055,18832,4110,38632
1169,7,1973,1337,291,297,454,4359
1170,33,2077,4548,763,1406,816,9643
1171,0,569,828,51,207,209,1864
1172,10,229,402,48,104,299,1092
1173,2,127,340,14,78,19,580
1174,0,410,450,48,147,16,1071
1175,339,1705,1185,2202,729,1093,7253
1176,80,2796,2639,553,2319,949,9336
1177,95,1175,1787,490,855,288,4690
1178,97,2632,3538,401,1671,2487,10826
1179,81,1513,2280,300,1502,683,6359
1180,12,364,606,120,293,100,1495
1181,2,97,152,41,183,24,499
1182,30,329,525,115,279,485,1763
1183,3,117,267,263,631,300,1581
1184,0,105,417,26,43,43,634
1185,8,1072,1091,237,375,676,3459
1186,2,485,1058,104,157,265,2071
1187,2,405,1040,180,299,403,2329
1188,2,319,818,490,242,204,2075
1189,0,898,1880,384,1692,1425,6279
1190,0,58,203,9,34,278,582
1191,0,80,259,38,99,153,629
1192,0,85,250,23,51,4,413
1193,2,242,374,31,170,337,1156
1194,8,218,400,28,101,59,814
1195,11,565,1016,112,343,168,2215
1196,0,230,343,43,92,147,855
1197,0,107,644,29,522,397,1699
1198,0,61,581,53,103,86,884
1199,0,400,1063,441,370,691,2965
1200,0,269,462,48,247,217,1243
1201,0,75,217,36,112,7,447
1202,0,112,243,23,57,22,457
1203,0,44,526,41,1163,3,1777
1204,15,48,484,830,36,334,1747
1205,2,271,429,1070,89,94,1955
1206,0,107,457,194,242,79,1079
1207,10,137,106,42,29,20,344
1208,0,190,424,332,77,129,1152
1209,0,71,32,12,43,6,164
1210,0,76,247,61,46,36,466
1211,16,1626,1006,3631,1926,627,8832
1212,4,770,797,82,330,96,2079
1213,0,260,475,21,190,123,1069
1214,2,193,121,596,111,16,1039
1215,4,288,556,44,128,197,1217
1216,0,160,221,31,43,32,487
1217,0,532,216,91,372,26,1237
1218,2,127,52,21,41,13,256
1219,2,172,215,26,886,30,1331
1220,8,357,289,33,146,107,940
1221,0,105,296,8,86,14,509
1222,0,60,511,15,30,14,630
1223,0,299,778,506,1285,142,3010
1224,2,282,670,253,1287,72,2566
1225,0,108,229,21,247,13,618
1226,0,91,247,26,206,145,715
1227,0,71,137,39,81,32,360
1228,7,34,188,6,39,4,278
1229,0,252,664,16,90,148,1170
1230,0,323,440,11,266,148,1188
1231,0,128,486,14,67,176,871
1232,0,326,307,14,284,30,961
1233,0,197,284,15,65,388,949
1234,2,220,738,91,277,159,1487
1235,0,238,368,33,116,61,816
1236,0,67,136,23,39,79,344
1237,0,34,72,18,22,14,160
1238,5,175,464,273,1558,12,2487
1239,0,57,41,19,17,8,142
1240,0,185,316,33,50,279,863
1241,0,560,967,277,311,837,2952
1242,0,710,3581,20,190,143,4644
1243,2,116,1951,18,74,29,2190
1244,2,115,765,13,6,25,926
1245,0,143,229,13,37,36,458
1246,102,592,1409,224,177,1676,4180
1247,0,658,499,1014,591,296,3058
1248,33,1486,1062,360,1106,634,4681
1249,47,951,1702,703,624,854,4881
1250,0,726,671,2240,1482,1284,6403
1251,12,280,766,79,584,68,1789
1252,3,248,687,1354,6180,246,8718
1253,0,78,89,11,33,2,213
1254,0,161,159,15,39,13,387
1255,0,62,125,32,50,19,288
1256,0,195,175,173,469,28,1040
1257,2,158,470,31,78,13,752
1258,0,44,38,2,29,4,117
1259,0,199,731,79,138,308,1455
1260,0,138,270,53,509,71,1041
1261,5,172,319,45,169,158,868
1262,0,466,1185,341,1516,105,3613
1263,2,181,577,13,1362,7,2142
1264,0,295,346,33,50,80,804
1265,0,166,2908,72,150,1570,4866
1266,8,224,575,17,204,27,1055
1267,2,163,391,27,160,98,841
1268,84,820,1136,151,218,325,2734
1269,7,984,1239,156,127,647,3160
1270,0,840,859,1616,942,220,4477
1271,0,504,720,75,189,151,1639
1272,0,5,317,0,1373,0,1695
1273,0,144,754,50,96,108,1152
1274,0,231,704,57,351,374,1717
1275,0,105,264,15,38,124,546
1276,2,88,213,46,37,25,411
1277,0,158,176,21,56,25,436
1278,4,128,124,27,48,37,368
1279,308,874,1401,2259,1062,896,6800
1280,4,707,2157,410,339,2588,6205
1281,2,998,636,60,395,611,2702
1282,6,570,767,146,473,431,2393
1283,0,931,883,99,264,83,2260
1284,6,1290,3047,152,841,453,5789
1285,9,238,424,76,145,11,903
1286,215,426,87,102,603,43,1476
1287,564,246,96,533,348,129,1916
1288,69,514,1090,126,370,286,2455
1289,32,407,766,1058,560,300,3123
1290,503,476,660,580,618,346,3183
1291,110,372,724,407,364,720,2697
1292,155,1688,1691,3701,3034,527,10796
1293,20,471,263,128,149,27,1058
1294,0,89,3250,236,131,38,3744
1295,13,275,853,127,335,711,2314
1296,32,200,416,88,123,113,972
1297,55,574,1605,190,386,357,3167
1298,56,900,2378,587,685,658,5264
1299,29,1040,1095,366,1118,362,4010
1300,2,171,420,65,115,115,888
1301,11,345,785,181,267,71,1660
1302,0,136,525,112,76,402,1251
1303,6,242,113,32,64,31,488
1304,2,179,502,92,183,189,1147
1305,4,1045,681,143,198,292,2363
1306,12,577,2829,338,299,913,4968
1307,13,270,1069,165,154,63,1734
1308,255,293,757,402,319,38,2064
1309,169,497,656,529,312,269,2432
1310,104,213,980,324,1293,65,2979
1311,576,641,1583,1045,433,143,4421
1312,239,76,39,57,167,35,613
1313,271,272,1837,612,327,480,3799
1314,744,1179,1754,1445,627,909,6658
1315,707,357,246,1489,445,215,3459
1316,227,175,213,564,165,92,1436
1317,32,277,1598,213,314,202,2636
1318,271,596,490,490,269,172,2288
1319,12,338,1026,138,238,144,1896
1320,129,755,1198,515,324,389,3310
1321,9,276,357,111,191,189,1133
1322,104,347,318,153,198,32,1152
1323,39,1242,2928,595,1045,891,6740
1324,395,504,192,1549,359,350,3349
1325,110,3188,1162,2733,810,1363,9366
1326,17,438,278,65,184,32,1014
1327,41,454,993,123,274,26,1911
1328,271,303,334,125,1298,53,2384
1329,132,359,444,461,338,417,2151
1330,0,246,289,75,225,358,1193
1331,12,379,455,227,302,251,1626
1332,25,1428,2668,783,1785,1092,7781
1333,0,123,127,19,76,20,365
1334,4,152,436,25,153,21,791
1335,8,409,786,80,191,671,2145
1336,31,1946,3046,2631,1226,459,9339
1337,87,2369,1885,2044,1207,1548,9140
1338,6,147,307,49,224,84,817
1339,7,266,270,70,133,29,775
1340,0,305,333,422,257,74,1391
1341,15,282,499,33,111,24,964
1342,5,227,2095,23,71,60,2481
1343,0,114,274,4,82,69,543
1344,11,1063,1067,113,539,424,3217
1345,0,90,276,24,38,131,559
1346,4,755,696,416,435,218,2524
1347,2,579,680,52,1302,49,2664
1348,10,640,1025,1077,638,2362,5752
1349,9,714,482,139,206,146,1696
1350,37,499,828,66,709,226,2365
1351,4,201,629,79,61,22,996
1352,13,308,99,73,79,30,602
1353,37,454,318,134,326,38,1307
1354,76,722,649,135,329,283,2194
1355,0,132,285,26,59,22,524
1356,6,395,633,90,142,133,1399
1357,2,206,309,81,171,56,825
1358,21,391,1710,52,310,242,2726
1359,4,370,3638,75,220,541,4848
1360,2,152,288,26,147,78,693
1361,17,2122,2799,303,2400,1686,9327
1362,5,1099,954,78,363,169,2668
1363,4,814,7292,60,2512,225,10907
1364,4,116,295,16,65,102,598
1365,6,482,698,109,162,227,1684
1366,17,2087,2010,1425,773,304,6616
1367,12,339,447,169,197,55,1219
1368,107,2146,2097,4184,1901,749,11184
1369,12,548,1812,1165,743,604,4884
1370,152,410,606,163,371,173,1875
1371,0,259,255,40,140,67,761
1372,2,129,198,20,51,22,422
1373,8,971,1542,441,1040,438,4440
1374,12,1269,1567,928,940,1304,6020
1375,2,423,845,288,540,53,2151
1376,53,778,1038,306,288,100,2563
1377,53,191,263,191,347,136,1181
1378,5,187,575,509,218,357,1851
1379,2,72,166,27,94,33,394
1380,2,464,974,1321,1152,1522,5435
1381,30,1942,1250,2242,778,416,6658
1382,174,419,916,141,249,76,1975
1383,160,519,312,448,336,98,1873
1384,63,880,1862,572,652,934,4963
1385,10,301,256,85,187,59,898
1386,37,441,1426,152,315,220,2591
1387,68,363,227,135,286,67,1146
1388,80,359,361,113,286,39,1238
1389,34,250,927,83,364,84,1742
1390,7,81,291,32,166,24,601
1391,8,192,532,414,201,261,1608
1392,169,239,374,408,186,67,1443
1393,104,191,213,113,198,60,879
1394,363,416,619,185,263,79,1925
1395,43,748,979,705,1050,615,4140
1396,46,537,860,114,305,303,2165
1397,133,553,235,452,309,94,1776
1398,20,186,393,79,90,28,796
1399,85,827,2286,1727,725,1098,6748
1400,449,316,246,587,388,69,2055
1401,684,336,1003,659,218,70,2970
1402,33,399,939,656,443,339,2809
1403,42,155,827,114,424,100,1662
1404,2,678,195,97,159,22,1153
1405,2,501,1275,117,607,970,3472
1406,2,514,330,293,571,149,1859
1407,22,1471,985,917,1315,155,4865
1408,6,451,458,75,843,66,1899
1409,2,817,1111,277,478,251,2936
1410,0,343,532,89,494,307,1765
1411,11,664,1283,1063,461,69,3551
1412,2,1820,1401,393,1048,531,5195
1413,2,2808,576,32,453,97,3968
1414,19,568,352,79,294,119,1431
1415,171,491,666,288,563,141,2320
1416,58,64,196,12,305,28,663
1417,0,45,91,0,11,17,164
1418,9,140,380,39,378,19,965
1419,0,228,293,24,121,52,718
1420,12,630,559,73,301,64,1639
1421,21,1043,4178,168,637,1098,7145
1422,2,1287,1982,146,3117,83,6617
1423,7,591,506,74,301,84,1563
1424,8,1768,2660,1174,2298,206,8114
1425,0,392,858,91,1442,59,2842
1426,118,680,440,200,272,96,1806
1427,6,1090,1439,143,309,547,3534
1428,18,3781,2442,2007,2610,1399,12257
1429,4,773,1124,668,626,714,3909
1430,33,2525,3173,547,1648,890,8816
1431,5,874,835,188,369,125,2396
1432,4,772,1247,412,597,479,3511
1433,4,291,75,42,123,6,541
1434,6,543,554,99,415,91,1708
1435,0,135,423,56,184,14,812
1436,8,556,3080,77,305,92,4118
1437,8,1078,1469,96,398,427,3476
1438,19,1838,1902,611,2002,1922,8294
1439,0,0,0,0,0,0,0
1440,6,711,1392,128,324,331,2892
1441,9,1191,1648,406,606,870,4730
1442,4,808,943,216,349,438,2758
1443,15,984,1461,211,384,226,3281
1444,0,765,1274,150,176,239,2604
1445,10,814,583,208,312,83,2010
1446,29,1704,1208,114,407,123,3585
1447,8,332,159,21,145,12,677
1448,28,3186,2505,709,1873,649,8950
1449,0,72,567,7,52,206,904
1450,4,641,440,73,276,112,1546
1451,8,525,333,61,212,63,1202
1452,9,1056,855,132,574,316,2942
1453,0,115,399,16,205,0,735
1454,27,98,212,27,230,70,664
