TAZ1454,AGREMPN,FPSEMPN,HEREMPN,MWTEMPN,OTHEMPN,RETEMPN,TOTEMP
1,6,17516,1743,639,1931,392,22227
2,23,21995,3573,1701,5480,367,33139
3,0,1100,476,4,510,33,2123
4,2,16615,3835,924,4105,516,25997
5,0,7626,5235,1348,2042,3347,19598
6,0,606,3935,39,208,81,4869
7,0,2065,6392,1458,86,384,10385
8,0,1044,3915,100,574,117,5750
9,0,1200,6614,7,2351,117,10289
10,0,5749,18401,1674,13487,293,39604
11,0,4262,4965,226,3294,2655,15402
12,0,11508,8120,1317,1699,2659,25303
13,4,16605,1991,634,2579,194,22007
14,5,24618,1135,10097,5224,74,41153
15,0,9554,1310,7731,3154,121,21870
16,16,19526,3057,3116,9844,342,35901
17,6,8101,2056,3003,6163,413,19742
18,1,3322,2887,607,3308,318,10443
19,0,5957,6614,644,3343,1315,17873
20,0,2727,2029,885,1672,600,7913
21,16,9503,3315,4307,1821,317,19279
22,8,10160,3320,325,2821,266,16900
23,0,6847,1504,663,2372,207,11593
24,4,10057,3341,353,4760,585,19100
25,0,250,1843,19,31,157,2300
26,0,3118,1507,216,1207,46,6094
27,0,77,1913,0,0,102,2092
28,0,158,684,4,36,24,906
29,0,601,1872,38,8,17,2536
30,0,230,988,577,86,112,1993
31,0,421,2372,14,17,17,2841
32,0,250,1598,13,55,351,2267
33,0,320,1012,89,62,94,1577
34,0,234,918,26,34,168,1380
35,2,173,412,8,2,23,620
36,11,317,2126,26,78,266,2824
37,0,795,1925,179,264,82,3245
38,0,682,810,276,139,158,2065
39,4,140,793,14,27,23,1001
40,4,857,1312,512,45,214,2944
41,0,3421,2990,435,58,991,7895
42,3,30,544,30,202,1,810
43,0,669,1571,55,40,273,2608
44,0,362,1044,15,183,73,1677
45,3,696,1796,174,321,225,3215
46,0,843,1931,25,215,46,3060
47,0,734,2723,101,70,111,3739
48,0,152,853,78,19,87,1189
49,0,183,1294,7,23,3,1510
50,1,290,1471,34,133,414,2343
51,0,70,418,40,25,109,662
52,20,1924,2970,614,1622,348,7498
53,0,17,1588,0,65,2,1672
54,0,64,865,17,40,188,1174
55,0,44,285,20,20,42,411
56,0,204,4213,0,2,0,4419
57,0,37,263,11,6,0,317
58,0,73,771,32,24,46,946
59,0,128,982,75,98,18,1301
60,0,22,916,1,10,10,959
61,0,773,519,2,12,25,1331
62,0,179,1191,45,84,153,1652
63,0,133,674,5,82,89,983
64,0,84,501,9,52,130,776
65,2,309,1012,31,134,278,1766
66,0,199,1431,38,49,264,1981
67,0,80,687,11,31,42,851
68,0,265,922,0,48,49,1284
69,0,273,13372,23,58,318,14044
70,0,509,1579,25,162,528,2803
71,11,385,2625,18,38,132,3209
72,0,291,1229,21,11,66,1618
73,0,122,1456,27,64,318,1987
74,0,468,3248,23,18,197,3954
75,0,826,4848,51,44,410,6179
76,0,397,1241,21,1852,140,3651
77,0,187,1938,7,64,147,2343
78,0,93,1557,25,4,6,1685
79,0,490,9236,420,4477,167,14790
80,0,187,541,15,19,16,778
81,8,453,14301,57,117,61,14997
82,0,541,706,17,40,264,1568
83,0,437,159,15,21,19,651
84,0,255,1712,45,70,29,2111
85,0,202,807,58,205,171,1443
86,0,49,1169,6,33,52,1309
87,0,123,2220,8,23,25,2399
88,12,204,782,44,218,433,1693
89,0,170,1019,68,58,101,1416
90,0,189,500,0,43,9,741
91,1,84,462,7,49,8,611
92,0,40,175,0,18,5,238
93,0,147,251,57,54,4,513
94,0,165,681,11,15,193,1065
95,0,211,384,8,80,13,696
96,0,112,129,8,29,6,284
97,0,106,1150,119,32,102,1509
98,0,183,512,12,40,177,924
99,0,92,600,196,19,14,921
100,0,839,1562,62,113,237,2813
101,0,579,2420,177,254,379,3809
102,0,176,1097,243,82,219,1817
103,0,259,665,31,25,121,1101
104,0,427,1151,6,67,335,1986
105,1,188,1691,63,115,149,2207
106,0,1171,3056,105,439,492,5263
107,0,2526,31146,16711,12732,1537,64652
108,0,1211,3397,608,520,232,5968
109,0,3409,1472,487,2873,138,8379
110,0,4714,3594,1759,128,255,10450
111,0,2136,3398,1185,1723,500,8942
112,0,311,316,283,96,47,1053
113,0,190,531,148,253,19,1141
114,0,290,499,121,136,323,1369
115,0,219,496,17,1,13,746
116,0,3686,2688,575,1067,1015,9031
117,0,373,557,37,30,20,1017
118,0,54,512,4,30,72,672
119,0,27,369,2,19,77,494
120,0,155,525,36,166,55,937
121,0,107,275,103,102,109,696
122,0,311,471,79,120,39,1020
123,0,381,1797,111,102,221,2612
124,0,36,219,5,25,85,370
125,0,21,147,1,15,6,190
126,0,47,247,7,46,0,347
127,0,74,581,1,48,105,809
128,0,223,426,70,39,38,796
129,0,112,188,25,33,1,359
130,6,287,474,2,23,155,947
131,0,78,229,92,76,2,477
132,0,97,390,45,15,185,732
133,0,177,3201,25,114,66,3583
134,0,124,719,81,90,54,1068
135,0,98,499,11,34,112,754
136,0,50,1276,2,46,0,1374
137,0,34,335,1,55,64,489
138,0,162,1396,30,1534,224,3346
139,0,154,656,71,130,118,1129
140,0,0,246,56,18,42,362
141,0,40,246,8,102,13,409
142,0,1911,1743,4653,4216,797,13320
143,0,92,779,102,244,42,1259
144,0,194,622,2,13,0,831
145,0,86,798,27,391,0,1302
146,0,31,53,47,1,0,132
147,0,232,531,647,583,40,2033
148,0,165,503,719,1087,288,2762
149,0,448,344,62,250,2,1106
150,2,399,854,199,836,202,2492
151,0,1,146,8,6,24,185
152,0,594,340,1,21,10,966
153,0,17,251,27,24,0,319
154,0,59,525,36,8,160,788
155,0,25,363,0,32,3,423
156,0,5,215,0,11,2,233
157,0,0,206,7,5,5,223
158,0,10,388,0,4,0,402
159,0,16,384,4,31,31,466
160,0,32,251,7,11,0,301
161,0,29,406,5,29,13,482
162,0,65,447,15,76,62,665
163,0,13,451,7,37,12,520
164,4,2631,540,30,33,104,3342
165,0,77,1123,6,62,143,1411
166,0,37,1076,7,126,12,1258
167,0,20,422,4,57,14,517
168,0,46,628,15,81,1,771
169,0,228,909,30,168,53,1388
170,0,429,1601,46,183,123,2382
171,18,38,371,156,39,119,741
172,3,48,565,40,87,114,857
173,0,32,129,7,39,31,238
174,0,57,368,8,93,6,532
175,0,214,1043,25,37,159,1478
176,0,81,399,11,19,51,561
177,0,295,1203,56,65,184,1803
178,0,89,443,17,65,12,626
179,0,59,722,20,102,4,907
180,0,34,459,15,32,69,609
181,0,38,822,56,92,29,1037
182,0,25,482,19,122,36,684
183,0,33,1621,17,59,126,1856
184,0,140,575,32,77,113,937
185,0,289,1709,20,98,129,2245
186,1,207,1326,37,136,69,1776
187,26,678,265,9,59,263,1300
188,0,135,8073,1,12,850,9071
189,0,291,704,5,0,8,1008
190,0,17,1100,87,6,0,1210
191,0,113,280,6,44,23,466
192,0,208,610,5,14,719,1556
193,5,302,1507,124,526,86,2550
194,0,41,3057,16,120,45,3279
195,0,30,237,6,34,0,307
196,0,31,254,5,17,5,312
197,0,36,278,0,4,158,476
198,0,29,856,31,0,17,933
199,0,145,580,5,34,1254,2018
200,44,293,1045,97,93,2613,4185
201,0,103,634,140,135,273,1285
202,0,22,401,13,59,8,503
203,0,427,1001,63,896,233,2620
204,0,71,419,12,37,134,673
205,0,52,252,5,15,1,325
206,0,61,78,2,23,3,167
207,0,46,394,290,9,43,782
208,49,3120,836,2963,1021,518,8507
209,0,56,419,39,57,2,573
210,0,154,290,147,155,70,816
211,58,461,724,100,156,192,1691
212,277,12645,6737,32649,3646,1325,57279
213,0,118,1074,17,121,168,1498
214,0,87,486,6,328,72,979
215,0,69,335,5,1,79,489
216,0,35,3527,2,34,139,3737
217,0,126,294,9,51,63,543
218,0,339,1599,48,96,277,2359
219,0,0,249,1,19,68,337
220,0,31,293,0,37,14,375
221,0,29,204,3,24,81,341
222,0,66,551,33,34,122,806
223,0,173,641,58,337,104,1313
224,0,31,276,23,84,15,429
225,0,114,589,24,97,91,915
226,3,124,541,3,107,187,965
227,7,44,193,46,65,4,359
228,0,0,23,0,0,0,23
229,0,39,1072,4,12,15,1142
230,0,44,865,205,13,379,1506
231,0,25,188,29,9,1,252
232,0,92,345,5,35,8,485
233,0,57,298,13,56,95,519
234,0,1527,1254,370,2783,1481,7415
235,0,26,451,18,401,9,905
236,0,462,578,22,64,108,1234
237,0,211,909,32,38,159,1349
238,0,113,446,494,105,37,1195
239,0,1321,2998,1967,59,427,6772
240,0,388,2138,161,143,294,3124
241,0,119,373,9,125,0,626
242,0,29,271,3,13,5,321
243,0,31,86,8,12,1,138
244,0,145,569,46,197,252,1209
245,0,22,332,8,36,0,398
246,0,759,4385,67,142,179,5532
247,0,25,156,4,28,0,213
248,0,9803,4255,3447,1344,382,19231
249,0,1811,1670,1407,564,255,5707
250,0,99,486,19,152,56,812
251,0,1264,1554,134,668,986,4606
252,0,488,1000,89,199,0,1776
253,0,46,104,24,25,28,227
254,8,135,425,13,41,0,622
255,0,86,394,20,9,14,523
256,0,1219,1067,31,75,2,2394
257,1,2026,4242,171,1079,673,8192
258,0,189,817,19,122,13,1160
259,0,122,1344,170,109,125,1870
260,0,446,639,107,199,88,1479
261,0,76,418,25,74,22,615
262,0,146,490,27,78,65,806
263,0,4,187,49,58,2,300
264,0,442,486,24,94,111,1157
265,0,4535,1008,305,3534,750,10132
266,0,10378,2258,2370,2295,616,17917
267,0,59,459,23,27,0,568
268,0,28,705,38,5,0,776
269,0,46,385,28,11,75,545
270,0,27,45,3,158,0,233
271,0,147,228,71,5,168,619
272,0,25,148,1,5,7,186
273,0,26,53,4,11,7,101
274,0,1745,362,17,340,69,2533
275,0,777,514,181,400,193,2065
276,0,36,188,60,17,20,321
277,0,77,533,50,42,22,724
278,0,2889,1258,93,2148,562,6950
279,0,3015,1578,319,1326,536,6774
280,0,1441,1045,93,171,288,3038
281,0,918,1305,146,520,225,3114
282,13,5216,564,63,179,96,6131
283,0,10,311,10,8,2,341
284,0,449,2375,21,83,1415,4343
285,0,12,263,10,5,0,290
286,0,142,947,49,90,231,1459
287,0,378,713,26,185,31,1333
288,0,146,1222,27,52,138,1585
289,0,77,322,16,27,43,485
290,0,31,49,54,33,0,167
291,0,295,1624,434,305,110,2768
292,0,54,217,12,24,24,331
293,24,94,259,171,91,55,694
294,13,121,670,68,127,97,1096
295,61,96,571,355,133,176,1392
296,197,625,2341,133,269,344,3909
297,558,77,705,55,87,47,1529
298,138,524,1244,81,85,81,2153
299,27,239,569,12,223,147,1217
300,0,135,948,39,63,4,1189
301,0,87,458,4,97,69,715
302,10,176,95,10,52,5,348
303,0,133,587,17,36,4,777
304,10,67,1231,22,47,0,1377
305,0,11,112,4,3,0,130
306,0,48,139,4,26,2,219
307,0,179,383,95,27,5,689
308,0,61,235,69,93,3,461
309,0,1318,2209,51,214,469,4261
310,0,4588,2740,2196,2289,1291,13104
311,1,6999,3492,2111,5484,150,18237
312,0,179,205,179,194,2,759
313,9,3444,2618,1508,2756,521,10856
314,0,1153,4785,1137,1104,262,8441
315,0,4072,6610,524,14075,974,26255
316,0,94,104,16,63,81,358
317,0,301,1458,107,98,43,2007
318,0,151,326,5,94,10,586
319,0,60,218,0,61,6,345
320,0,62,451,6,108,1,628
321,0,241,425,14,72,150,902
322,0,204,357,53,25,32,671
323,0,176,626,153,88,460,1503
324,0,106,381,0,132,162,781
325,0,96,118,0,84,235,533
326,0,114,508,101,271,516,1510
327,0,127,568,53,26,157,931
328,0,213,204,47,44,21,529
329,0,1136,734,444,792,155,3261
330,0,127,303,22,126,48,626
331,25,4715,1098,3387,29845,98,39168
332,21,2970,1485,623,761,34,5894
333,0,73,834,17,47,456,1427
334,0,190,648,21,105,78,1042
335,5,1013,236,24,13,373,1664
336,0,412,311,25,13,209,970
337,0,36,219,5,161,0,421
338,0,52,64,0,25,0,141
339,0,51,940,0,121,0,1112
340,10,2426,934,169,1673,30,5242
341,0,1664,2867,63,627,823,6044
342,0,153,1978,21,35,24,2211
343,0,68,630,0,19,3,720
344,0,37,193,43,11,0,284
345,0,373,416,17,27,31,864
346,7,4892,1372,928,988,91,8278
347,116,402,2543,193,107,13,3374
348,0,3778,245,229,6426,0,10678
349,0,7942,5164,4168,1139,151,18564
350,0,746,205,15,3,101,1070
351,19,2482,2961,137,518,197,6314
352,0,0,143,0,61,0,204
353,0,38,166,1,10,47,262
354,1,544,22536,1,5,35,23122
355,2,416,29391,130,48,1910,31897
356,0,7861,5130,621,9235,848,23695
357,0,303,470,40,95,3,911
358,0,284,653,24,57,10,1028
359,0,295,444,71,67,17,894
360,3,220,315,7,48,16,609
361,0,192,509,44,36,114,895
362,0,976,1005,2017,97,62,4157
363,0,67,772,3,9,155,1006
364,0,28,397,11,0,92,528
365,0,286,358,25,182,81,932
366,0,1559,1484,1575,650,312,5580
367,0,4499,1449,68,107,94,6217
368,1,135,421,41,18,2,618
369,0,321,858,15,48,7,1249
370,12,1646,1507,55,593,310,4123
371,0,533,1606,16,142,196,2493
372,0,510,1484,74,213,964,3245
373,0,2083,580,42,612,113,3430
374,8,1624,968,750,868,672,4890
375,0,105,342,0,13,5,465
376,18,903,993,755,166,116,2951
377,0,517,193,219,2226,40,3195
378,0,5231,2897,72,1559,109,9868
379,9,85,608,8,289,10,1009
380,0,23,346,68,32,45,514
381,0,286,629,96,354,237,1602
382,0,111,315,12,2,24,464
383,0,155,4901,150,115,88,5409
384,0,131,662,11,17,25,846
385,0,89,74,16,14,0,193
386,0,33,155,22,8,14,232
387,0,85,497,8,80,203,873
388,0,265,1748,37,53,19,2122
389,0,204,1360,55,53,278,1950
390,0,174,294,97,47,40,652
391,0,441,2287,4,23,484,3239
392,0,161,187,0,5,27,380
393,0,48,452,393,60,69,1022
394,0,185,667,45,222,23,1142
395,0,5243,204,889,490,14,6840
396,0,1852,658,1011,231,2,3754
397,0,1779,289,507,629,151,3355
398,0,562,403,215,450,241,1871
399,0,6953,343,1127,3816,230,12469
400,0,88,350,13,17,9,477
401,2,7664,4643,3648,31562,465,47984
402,0,1598,413,5068,1188,0,8267
403,0,7832,881,3798,18123,23,30657
404,0,962,565,1271,3322,7,6127
405,0,2271,722,995,280,763,5031
406,0,5045,1095,7208,1149,165,14662
407,1,2893,1584,4979,2920,682,13059
408,0,13548,644,3436,1647,238,19513
409,0,7202,1850,7128,793,51,17024
410,0,4754,561,3092,513,19,8939
411,0,1,0,769,0,0,770
412,2,3945,1390,16959,111,285,22692
413,0,192,583,1791,22,138,2726
414,0,2365,1499,4164,2305,259,10592
415,6,10665,3454,3399,1624,238,19386
416,0,3401,470,776,643,28,5318
417,0,2117,154,3568,209,14,6062
418,0,967,426,2164,399,63,4019
419,0,52,240,12,14,12,330
420,0,4,204,1,8,34,251
421,0,128,240,58,37,253,716
422,0,235,391,188,931,17,1762
423,0,26,240,33,6,55,360
424,0,100,479,70,15,47,711
425,0,27,229,3,366,75,700
426,0,142,232,1143,7,226,1750
427,0,7691,1679,2993,949,301,13613
428,1,6229,1187,1829,386,568,10200
429,1,3265,853,6450,212,13,10794
430,0,9768,934,8294,1483,284,20763
431,0,1744,355,1898,910,92,4999
432,0,5314,1034,3486,2890,470,13194
433,0,635,1050,488,1223,61,3457
434,0,602,1512,2639,724,718,6195
435,2,11311,2010,2675,3003,254,19255
436,0,134,1225,93,33,326,1811
437,0,26,293,11,28,124,482
438,0,53,580,5,18,61,717
439,33,100,695,8,7,240,1083
440,0,92,1017,19,13,37,1178
441,0,194,677,9,64,127,1071
442,0,49,498,8,17,47,619
443,0,29,193,1,51,8,282
444,4,198,956,113,54,41,1366
445,0,133,498,8,14,95,748
446,0,102,220,27,7,81,437
447,0,221,377,14,7,93,712
448,0,306,874,26,22,388,1616
449,0,196,1266,14,18,388,1882
450,0,2241,1858,349,430,512,5390
451,2,116,853,9,66,329,1375
452,0,21,1408,16,11,3,1459
453,0,194,1008,283,34,355,1874
454,0,99,1339,56,50,14,1558
455,0,25,614,12,14,114,779
456,0,204,395,42,17,12,670
457,0,86,189,0,18,0,293
458,0,48,237,0,3,12,300
459,0,149,846,6,44,130,1175
460,3,336,7161,37884,218,378,45980
461,0,109,188,5,56,13,371
462,0,317,1410,14,45,370,2156
463,0,137,101,21,64,24,347
464,0,117,189,2,10,6,324
465,0,271,1352,64,24,779,2490
466,0,171,1112,176,23,4046,5528
467,3,2664,2483,85,1272,766,7273
468,0,225,854,28,104,179,1390
469,0,335,738,4,35,90,1202
470,0,153,683,129,72,83,1120
471,2,167,1319,54,63,504,2109
472,0,520,1110,167,129,28,1954
473,0,116,654,39,10,33,852
474,0,14,271,12,62,8,367
475,0,169,899,37,47,763,1915
476,0,380,1861,32,89,363,2725
477,2,68,867,11,78,84,1110
478,0,850,703,75,53,1137,2818
479,0,510,908,51,60,25,1554
480,0,43,286,9,1,8,347
481,0,49,302,2,13,72,438
482,0,53,121,7,18,13,212
483,0,596,732,17,55,156,1556
484,0,966,1356,288,345,180,3135
485,0,936,2104,168,57,414,3679
486,0,386,637,76,36,487,1622
487,0,154,720,8,36,95,1013
488,0,218,816,228,13,6,1281
489,0,80,572,1,35,6,694
490,0,296,2427,470,104,329,3626
491,0,79,164,19,9,260,531
492,0,323,302,20,85,166,896
493,0,219,567,6,21,3,816
494,0,395,556,30,39,90,1110
495,25,101,397,53,49,7,632
496,0,241,802,24,96,22,1185
497,36,177,2227,52,100,0,2592
498,0,327,923,34,68,139,1491
499,0,283,1106,11,43,368,1811
500,0,15,238,2,37,0,292
501,0,2,150,0,34,45,231
502,0,77,573,2,14,304,970
503,0,179,1711,75,25,153,2143
504,0,1786,4166,1904,2237,665,10758
505,0,23,277,3,59,32,394
506,0,302,1588,462,38,36,2426
507,2,86,732,19,129,76,1044
508,0,4650,644,966,607,0,6867
509,0,1030,637,109,300,183,2259
510,5,49,155,32,18,0,259
511,15,854,3074,262,848,328,5381
512,2,115,215,37,67,1,437
513,6,55,291,6,16,5,379
514,1,181,1237,23,64,232,1738
515,0,68,407,1,56,27,559
516,0,28,260,3,10,1,302
517,0,29,993,44,149,120,1335
518,0,419,2900,77,119,648,4163
519,0,695,6754,1654,110,39,9252
520,0,241,781,44,52,73,1191
521,1,467,2098,130,440,310,3446
522,0,198,579,9,203,69,1058
523,0,134,543,9,68,644,1398
524,0,101,54,34,45,9,243
525,0,68,617,52,18,25,780
526,11,99,710,17,51,38,926
527,0,279,936,25,104,125,1469
528,17,461,1046,20,134,110,1788
529,2,138,422,50,68,251,931
530,0,3766,2433,474,830,983,8486
531,0,934,1425,40,37,2520,4956
532,0,110,893,8,17,118,1146
533,0,631,8372,8,33,67,9111
534,0,391,673,432,39,73,1608
535,0,365,943,23,13,196,1540
536,0,50,576,28,58,149,861
537,0,728,1540,1169,299,265,4001
538,61,341,299,7,36,13,757
539,0,1084,3178,603,929,678,6472
540,1,1373,2364,167,108,206,4219
541,0,188,1676,20,53,180,2117
542,0,839,1785,65,769,3,3461
543,60,483,4043,135,986,99,5806
544,0,165,380,15,39,73,672
545,0,410,1153,19,37,39,1658
546,0,2425,12580,492,12246,44,27787
547,0,3257,1185,551,2499,213,7705
548,0,146,769,51,24,46,1036
549,1,1682,1287,61,167,153,3351
550,0,178,461,2,24,24,689
551,0,147,718,331,189,81,1466
552,0,26,160,0,197,0,383
553,0,21,201,13,18,26,279
554,0,118,404,0,40,60,622
555,0,135,730,66,24,62,1017
556,0,13,720,0,0,0,733
557,0,784,8366,176,3060,73,12459
558,14,12813,3591,328,7866,174,24786
559,0,124,474,15,49,33,695
560,0,2105,1283,212,57,5,3662
561,13,40,477,168,78,71,847
562,2,12,234,11,99,50,408
563,6,1923,3797,5273,3575,1562,16136
564,0,47,1005,16,63,864,1995
565,0,769,694,171,162,6,1802
566,0,89,567,130,397,100,1283
567,0,208,792,517,281,213,2011
568,0,27,489,117,64,78,775
569,0,3,221,4,10,8,246
570,0,80,294,0,5,127,506
571,2,4,168,2,23,0,199
572,8,9,743,6,2,7,775
573,0,2,197,9,18,39,265
574,0,21,355,0,22,26,424
575,0,26,761,54,42,90,973
576,0,62,342,37,99,28,568
577,0,4,497,1,2,3,507
578,0,73,391,14,11,109,598
579,0,64,833,321,450,681,2349
580,0,33,324,132,162,57,708
581,0,19,328,1,19,126,493
582,0,139,1573,184,41,387,2324
583,0,273,2250,24,68,1231,3846
584,0,47,473,20,26,87,653
585,0,80,322,3,40,86,531
586,0,44,524,3,37,279,887
587,0,15,473,0,0,6,494
588,0,27,399,4,11,35,476
589,0,45,385,49,33,52,564
590,0,36,258,43,2,272,611
591,0,84,702,16,83,79,964
592,12,22,339,93,50,45,561
593,0,146,274,1183,1330,108,3041
594,0,83,336,13,96,19,547
595,0,170,4400,0,0,76,4646
596,0,31,657,16,11,138,853
597,0,116,665,460,32,5,1278
598,1,309,471,39,31,66,917
599,0,18,151,7,11,0,187
600,0,20,270,3,10,8,311
601,0,706,719,46,54,84,1609
602,0,1190,408,980,1924,268,4770
603,12,922,1083,1544,1106,425,5092
604,0,555,2945,3161,941,108,7710
605,0,1808,2019,7593,1013,1003,13436
606,4,1428,989,1252,99,29,3801
607,0,397,1839,145,724,2524,5629
608,0,2071,1487,4995,1540,354,10447
609,0,418,734,99,783,147,2181
610,0,64,338,89,55,38,584
611,0,121,1050,84,58,91,1404
612,0,495,861,820,25,69,2270
613,0,19,441,62,2,132,656
614,0,24,655,3,8,19,709
615,0,63,323,11,22,7,426
616,0,10,820,6,3,0,839
617,0,15,396,17,6,70,504
618,0,12,127,6,2,4,151
619,0,31,372,3,2,1,409
620,0,110,906,60,141,103,1320
621,0,23,479,22,8,241,773
622,0,2,449,1,6,7,465
623,0,10,261,8,20,4,303
624,0,16,101,0,0,0,117
625,0,143,726,1,17,113,1000
626,0,36,405,0,1,11,453
627,0,91,580,4,90,170,935
628,72,106,626,20,27,15,866
629,0,46,310,11,44,4,415
630,0,102,742,13,24,130,1011
631,0,7,985,3,15,2,1012
632,0,71,840,24,33,726,1694
633,0,99,1768,53,77,18,2015
634,2,73,641,42,558,309,1625
635,0,57,420,23,68,14,582
636,0,76,522,7,40,203,848
637,5,135,134,22,122,2,420
638,0,18,336,1,21,31,407
639,0,10,290,0,65,164,529
640,0,7,269,3,32,10,321
641,0,4,418,0,13,18,453
642,3,33,103,0,36,0,175
643,0,6,364,2,15,5,392
644,0,27,652,39,8,205,931
645,0,141,1002,3,16,8,1170
646,0,6,307,0,0,0,313
647,9,53,106,0,13,4,185
648,0,51,286,6,11,11,365
649,0,13,575,3,44,192,827
650,0,70,806,15,13,69,973
651,0,26,1041,32,24,71,1194
652,0,241,481,15,71,54,862
653,2,148,1739,31,27,116,2063
654,0,92,445,0,23,4,564
655,0,330,706,103,68,2,1209
656,3,1796,1367,3360,936,105,7567
657,0,129,380,17,22,88,636
658,0,43,111,4,30,2,190
659,0,271,407,20,9,42,749
660,0,1626,1884,1714,643,324,6191
661,0,731,7441,2647,56,531,11406
662,0,19,211,0,33,0,263
663,0,12,232,4,28,7,283
664,0,48,320,5,68,25,466
665,0,230,560,4,22,112,928
666,0,114,224,14,16,10,378
667,0,65,407,12,12,70,566
668,0,22,283,30,51,8,394
669,0,19,646,47,43,49,804
670,0,27,791,16,49,23,906
671,0,254,369,9,37,152,821
672,0,142,265,34,15,19,475
673,0,51,454,11,18,52,586
674,0,142,746,3,57,142,1090
675,0,300,569,8,42,141,1060
676,0,337,1511,1287,100,582,3817
677,0,286,1665,32,61,1281,3325
678,0,22,218,9,19,5,273
679,37,42,711,51,16,395,1252
680,0,147,494,5,73,842,1561
681,0,218,748,39,39,167,1211
682,0,239,665,5,43,47,999
683,0,23,187,2,9,183,404
684,0,49,609,18,103,162,941
685,0,82,475,38,26,25,646
686,0,359,432,3,11,132,937
687,0,150,963,0,19,2152,3284
688,0,55,2336,33,27,134,2585
689,0,41,237,2,21,82,383
690,0,155,568,7,70,178,978
691,0,14,281,7,27,18,347
692,0,184,369,17,17,175,762
693,0,42,424,6,9,16,497
694,0,46,203,0,30,1,280
695,0,184,221,7,87,0,499
696,40,165,501,707,136,16,1565
697,247,1919,207,157,76,47,2653
698,83,137,916,57,78,414,1685
699,196,142,121,70,33,48,610
700,54,1727,2650,5799,974,979,12183
701,1,218,662,188,371,148,1588
702,8,609,1850,115,489,254,3325
703,10,112,224,19,62,24,451
704,32,43,197,91,88,5,456
705,85,105,1801,124,187,48,2350
706,811,372,2341,1789,658,2502,8473
707,59,532,2719,605,638,623,5176
708,0,77,759,1,237,60,1134
709,5,300,1022,42,193,363,1925
710,0,267,706,3,22,119,1117
711,14,120,327,23,116,12,612
712,128,133,724,184,264,63,1496
713,60,273,274,141,259,58,1065
714,5,4,42,0,7,170,228
715,19,13126,1279,6751,3001,884,25060
716,0,589,329,482,1004,42,2446
717,0,84,913,112,235,28,1372
718,0,745,669,975,1830,360,4579
719,15,79,266,27,48,23,458
720,1,461,364,709,133,49,1717
721,0,415,1354,39,316,1267,3391
722,0,79,276,49,116,39,559
723,0,343,979,73,118,74,1587
724,1,277,2000,41,79,481,2879
725,0,102,192,101,98,38,531
726,0,125,238,16,200,180,759
727,0,23,321,0,11,0,355
728,0,1926,1423,2541,1553,1981,9424
729,8,1074,2261,585,1115,998,6041
730,13,3521,2546,1032,930,1625,9667
731,0,83,74,8,9,20,194
732,0,1032,2321,941,697,888,5879
733,0,586,2783,189,55,1199,4812
734,1,637,770,264,858,149,2679
735,1,47,382,68,105,6,609
736,0,4543,1525,244,6469,1607,14388
737,0,1286,1097,2242,702,444,5771
738,0,21,654,6,14,0,695
739,1,2851,2284,993,1814,315,8258
740,0,54,581,11,67,17,730
741,0,133,554,29,38,199,953
742,8,10933,7563,2093,2825,2139,25561
743,131,1533,1006,780,907,188,4545
744,0,80,1634,73,354,29,2170
745,0,44,120,15,46,31,256
746,77,544,601,179,200,144,1745
747,5,40,82,6,5,3,141
748,0,35,56,2,13,5,111
749,0,170,436,772,4,44,1426
750,2,1574,820,9554,665,516,13131
751,0,4789,2273,19116,3303,4145,33626
752,0,3748,3095,21544,2289,794,31470
753,0,64,174,10,7,5,260
754,9,103,1164,39,7,42,1364
755,4,390,578,217,511,30,1730
756,0,634,575,329,614,162,2314
757,0,3,194,0,12,6,215
758,0,21,738,2,84,142,987
759,0,62,206,67,39,27,401
760,0,40,326,4,22,27,419
761,0,404,1594,22,61,305,2386
762,0,46,132,9,68,11,266
763,0,1629,2503,3,98,29,4262
764,0,99,1201,34,57,650,2041
765,0,117,593,20,20,166,916
766,0,107,405,37,81,45,675
767,0,1380,2399,5590,291,1321,10981
768,19,3645,548,3489,315,96,8112
769,2,1863,417,567,535,12,3396
770,0,216,806,123,66,239,1450
771,0,367,990,16,39,332,1744
772,0,58,71,17,59,84,289
773,0,177,515,336,379,177,1584
774,0,398,1073,460,88,198,2217
775,0,77,407,17,70,39,610
776,0,135,831,27,47,8,1048
777,0,3111,3839,96,907,956,8909
778,0,1549,6220,30,274,11,8084
779,0,32,153,28,5,3,221
780,2,297,631,1,15,52,998
781,0,47,129,38,46,5,265
782,0,131,356,40,26,7,560
783,0,168,28,18,234,0,448
784,0,73,486,10,12,175,756
785,0,34,302,48,12,33,429
786,0,19,116,2,2,29,168
787,0,75,475,23,21,151,745
788,0,67,377,48,5,8,505
789,0,30,211,17,11,9,278
790,0,30,363,31,12,2,438
791,0,206,700,91,9,168,1174
792,0,12,114,1,7,0,134
793,0,89,331,20,18,61,519
794,0,72,80,21,0,27,200
795,2,631,498,1027,173,17,2348
796,21,543,2257,2930,274,1354,7379
797,0,5834,840,5003,1334,298,13309
798,0,86,520,370,84,24,1084
799,0,56,127,25,10,0,218
800,0,54,1407,30,301,89,1881
801,0,536,816,362,90,323,2127
802,0,226,196,18,14,5,459
803,5,28,625,10,0,9,677
804,0,58,350,13,26,40,487
805,0,63,272,8,62,73,478
806,25,1053,1277,6528,1131,650,10664
807,0,24,136,41,12,75,288
808,0,2,147,0,5,0,154
809,0,274,431,1777,743,9,3234
810,15,6592,2682,13099,3908,2875,29171
811,0,272,1988,767,318,450,3795
812,0,698,895,22,39,575,2229
813,0,4,1689,3,3,0,1699
814,0,14,232,13,6,64,329
815,0,21,235,1,0,5,262
816,0,5,575,0,13,141,734
817,0,9,324,21,20,8,382
818,0,2,576,1,32,4,615
819,0,77,143,30,57,125,432
820,0,100,758,128,13,48,1047
821,0,43,3030,12,11,46,3142
822,0,11,201,2,46,0,260
823,0,49,549,7,260,13,878
824,0,326,551,51,398,519,1845
825,0,26,166,6,12,16,226
826,0,108,291,98,187,145,829
827,0,110,1201,17,563,169,2060
828,0,369,686,58,447,546,2106
829,0,64,492,8,464,8,1036
830,0,16,350,8,32,210,616
831,0,14,451,67,11,60,603
832,0,62,487,9,19,30,607
833,0,6,114,2,1,0,123
834,0,80,265,752,31,38,1166
835,0,77,283,15,10,81,466
836,0,32,135,196,106,360,829
837,0,58,610,25,188,21,902
838,0,145,625,2,26,162,960
839,0,534,1767,32,543,264,3140
840,0,203,821,25,69,229,1347
841,0,67,626,13,18,44,768
842,0,288,282,0,32,209,811
843,0,20,242,7,4,12,285
844,6,218,723,32,101,102,1182
845,0,40,646,20,49,20,775
846,0,124,538,121,30,105,918
847,0,353,459,10,127,24,973
848,0,363,3174,35,68,557,4197
849,0,46,428,13,29,65,581
850,0,73,74,29,32,1,209
851,0,52,237,6,20,0,315
852,1,26,229,6,47,44,353
853,0,35,1810,32,13,30,1920
854,0,23,347,2,12,67,451
855,0,24,623,15,23,18,703
856,0,104,704,20,86,708,1622
857,0,39,823,3,23,148,1036
858,0,154,525,29,23,390,1121
859,0,18,225,4,11,42,300
860,2,497,1102,3011,1322,134,6068
861,1,422,6105,346,60,9,6943
862,0,1525,1164,1850,2026,1355,7920
863,0,124,388,34,44,402,992
864,0,252,2187,1022,81,388,3930
865,1,13,462,6,37,3,522
866,0,35,738,2,34,5,814
867,0,11,131,21,16,51,230
868,0,50,266,0,35,7,358
869,0,80,661,26,519,113,1399
870,0,72,250,150,467,78,1017
871,0,1338,2486,154,162,407,4547
872,0,980,601,236,262,294,2373
873,0,1546,1529,5767,2184,1787,12813
874,0,334,149,3628,0,0,4111
875,70,4904,4826,8480,2469,748,21497
876,7,0,78,11,29,0,125
877,0,55,356,38,20,72,541
878,0,118,269,234,66,51,738
879,0,27,139,170,87,56,479
880,0,0,532,3,35,33,603
881,0,6,138,3,29,11,187
882,0,92,508,1,22,119,742
883,0,21,1387,0,5,0,1413
884,0,54,244,11,32,6,347
885,0,555,991,36,11,6,1599
886,0,111,227,3,43,14,398
887,0,6,883,1,0,28,918
888,0,1,245,4,13,7,270
889,0,10,277,1,0,4,292
890,0,48,326,0,18,16,408
891,0,17,198,7,9,32,263
892,0,233,169,863,57,10,1332
893,6,214,192,144,166,14,736
894,0,268,315,448,100,0,1131
895,0,599,1148,706,169,3,2625
896,151,316,178,2202,279,562,3688
897,0,126,237,26,5,225,619
898,0,37,311,132,6,12,498
899,0,5,713,7,17,39,781
900,0,86,648,7,15,172,928
901,0,23,182,1,3,0,209
902,0,11,704,0,5,56,776
903,0,22,149,1,10,8,190
904,0,6,348,22,40,16,432
905,0,17,400,9,15,9,450
906,0,35,2264,19,6,298,2622
907,0,53,222,15,37,12,339
908,0,45,170,0,17,42,274
909,0,38,315,3,32,12,400
910,0,88,728,28,23,0,867
911,0,78,801,60,27,124,1090
912,0,63,330,48,30,14,485
913,0,525,569,141,61,294,1590
914,0,136,122,103,19,9,389
915,0,134,688,4,30,24,880
916,0,161,1465,20,3,303,1952
917,1,108,316,8,219,113,765
918,0,105,754,12,31,18,920
919,0,45,47,19,17,0,128
920,0,10,377,73,5,13,478
921,0,99,220,8,15,4,346
922,0,160,315,22,34,20,551
923,0,89,366,17,21,226,719
924,0,9,395,0,12,149,565
925,0,381,639,11,28,104,1163
926,6,773,2292,750,220,549,4590
927,0,67,887,8,2,29,993
928,0,7,371,0,11,3,392
929,0,5,507,11,23,10,556
930,0,11,991,1,27,1,1031
931,0,42,2778,9,18,5,2852
932,5,0,204,8,10,2,229
933,0,12,637,60,20,35,764
934,0,94,803,10,16,59,982
935,0,9,241,0,0,2,252
936,0,15,204,0,2,3,224
937,0,48,317,23,64,222,674
938,4,134,89,10,4,2,243
939,0,340,492,63,27,158,1080
940,0,101,414,19,32,57,623
941,0,6,549,34,43,11,643
942,0,321,983,19,50,65,1438
943,0,59,408,34,4,27,532
944,0,109,352,1,10,128,600
945,0,3071,1701,25,9819,5,14621
946,0,487,1967,489,1033,128,4104
947,30,785,2051,749,611,419,4645
948,0,199,527,91,777,124,1718
949,18,42,780,132,49,192,1213
950,5,276,883,6,63,173,1406
951,0,42,451,39,5,36,573
952,0,1398,1213,2335,1065,49,6060
953,0,134,480,22,22,122,780
954,0,132,923,15,3,809,1882
955,0,50,2027,11,588,78,2754
956,0,39,393,2,26,14,474
957,0,61,872,4,5,0,942
958,0,32,275,6,2,26,341
959,0,92,326,19,14,184,635
960,0,1415,1486,528,749,141,4319
961,0,1140,669,441,32,257,2539
962,18,13,495,9,5,13,553
963,0,94,625,39,350,12,1120
964,0,242,165,460,268,63,1198
965,0,40,132,2783,45,33,3033
966,0,166,629,683,68,6,1552
967,0,1092,1894,611,677,524,4798
968,0,2079,4237,9344,2968,279,18907
969,0,6501,2572,1913,1692,398,13076
970,0,1406,1742,171,4778,182,8279
971,15,13315,5300,629,4474,70,23803
972,0,967,1487,114,212,811,3591
973,0,125,9398,13,27,25,9588
974,4,259,1512,41,33,417,2266
975,0,56,674,0,16,45,791
976,0,293,882,88,224,323,1810
977,0,144,3826,79,247,24,4320
978,0,55,334,88,113,59,649
979,0,496,5737,114,136,571,7054
980,0,12,97,0,1,11,121
981,0,4,269,0,0,5,278
982,0,109,387,0,27,0,523
983,0,10,239,0,20,2,271
984,0,79,400,228,118,47,872
985,0,22,298,34,0,4,358
986,0,19,112,0,1,15,147
987,0,23,159,12,2,4,200
988,0,380,206,2440,570,1210,4806
989,2,95,306,472,410,20,1305
990,0,68,197,376,77,27,745
991,21,12521,3395,3133,3572,1585,24227
992,0,15,144,67,94,8,328
993,0,206,483,419,246,41,1395
994,0,11,222,0,14,7,254
995,0,40,417,60,31,0,548
996,0,537,307,93,61,29,1027
997,0,22,46,30,195,8,301
998,0,162,1353,76,151,155,1897
999,1,258,643,0,29,390,1321
1000,0,127,428,79,85,57,776
1001,0,48,233,2,23,31,337
1002,0,290,614,7,49,65,1025
1003,0,109,3229,12,34,219,3603
1004,2,112,237,12,122,74,559
1005,0,93,419,16,33,7,568
1006,0,68,431,66,30,35,630
1007,0,4,291,0,11,0,306
1008,0,210,1052,8,83,254,1607
1009,0,64,391,25,3,132,615
1010,0,455,1023,29,365,49,1921
1011,0,334,785,9,61,516,1705
1012,0,89,401,16,42,8,556
1013,0,37,175,47,44,55,358
1014,116,3738,3943,3785,1664,1772,15018
1015,0,171,1138,38,10,182,1539
1016,0,171,613,84,30,62,960
1017,0,108,1759,18,24,23,1932
1018,23,3105,3778,129,1490,485,9010
1019,0,199,189,2,116,0,506
1020,0,51,352,16,13,1,433
1021,0,360,830,2,227,46,1465
1022,0,4637,173,75,7,132,5024
1023,0,49,674,38,49,143,953
1024,0,56,161,15,12,25,269
1025,0,49,452,38,87,52,678
1026,0,20,235,60,22,119,456
1027,0,218,956,9,47,220,1450
1028,0,53,80,7,36,0,176
1029,0,73,94,15,63,0,245
1030,8,13,130,6,6,10,173
1031,0,68,160,1,27,0,256
1032,0,7,127,0,23,3,160
1033,0,223,589,43,34,113,1002
1034,0,173,272,9,16,146,616
1035,0,58,601,0,20,16,695
1036,0,91,497,9,53,28,678
1037,0,119,407,47,44,66,683
1038,15,87,598,1,147,309,1157
1039,0,124,481,40,99,139,883
1040,0,12,269,4,5,50,340
1041,0,276,739,13,26,579,1633
1042,0,15,325,0,13,0,353
1043,0,1094,555,25,29,15,1718
1044,0,93,191,3,5,22,314
1045,0,39,102,48,48,0,237
1046,0,3,208,3,17,2,233
1047,0,36,421,1,29,122,609
1048,0,106,295,12,12,42,467
1049,0,318,327,15,83,302,1045
1050,0,245,860,90,87,224,1506
1051,0,184,1534,10,350,646,2724
1052,0,8,114,0,5,0,127
1053,0,26,500,0,32,0,558
1054,0,22,355,7,10,71,465
1055,0,65,484,30,61,59,699
1056,0,59,530,4,501,47,1141
1057,0,15,171,7,0,43,236
1058,0,164,861,174,151,274,1624
1059,81,1089,899,3143,1029,1176,7417
1060,5,114,1003,649,56,26,1853
1061,0,42,906,80,122,166,1316
1062,22,1456,897,5440,954,177,8946
1063,0,78,2591,15,55,37,2776
1064,0,16,389,17,26,14,462
1065,0,32,602,15,14,52,715
1066,0,138,2730,4,250,581,3703
1067,0,46,481,60,66,83,736
1068,0,257,326,927,652,5,2167
1069,0,1167,1954,2955,1979,1106,9161
1070,0,6,256,48,33,21,364
1071,0,95,277,60,52,43,527
1072,0,16,1497,12,13,172,1710
1073,0,13,407,148,5,4,577
1074,0,166,1342,19,118,1047,2692
1075,0,84,713,0,11,121,929
1076,0,5,369,0,9,1,384
1077,0,62,314,1,79,15,471
1078,0,60,516,38,14,35,663
1079,0,70,831,1,66,200,1168
1080,0,51,722,4,15,120,912
1081,0,10,190,22,16,0,238
1082,0,187,645,320,16,35,1203
1083,0,902,2161,1657,360,201,5281
1084,3,64,432,0,42,61,602
1085,0,51,602,6,33,110,802
1086,0,50,518,6,132,222,928
1087,29,41,162,26,16,8,282
1088,0,21,82,126,2,0,231
1089,0,41,421,829,26,79,1396
1090,0,100,173,818,91,17,1199
1091,0,78,6463,30,21,151,6743
1092,0,255,957,45,664,37,1958
1093,0,85,432,13,3976,7,4513
1094,0,144,224,157,3503,22,4050
1095,0,561,247,1887,1641,125,4461
1096,0,823,952,1134,1084,620,4613
1097,1,3039,1589,4026,5166,541,14362
1098,0,177,362,64,54,226,883
1099,0,501,467,65,84,28,1145
1100,3,91,506,9,69,264,942
1101,0,130,183,13,46,22,394
1102,49,2,24,4,44,0,123
1103,0,147,538,12,178,190,1065
1104,0,57,132,0,2,0,191
1105,0,2,52,0,2,0,56
1106,4,226,1338,20,62,172,1822
1107,0,107,585,3,24,15,734
1108,0,67,500,44,55,458,1124
1109,0,41,2506,41,76,7,2671
1110,44,456,864,25,33,302,1724
1111,0,60,520,36,401,2,1019
1112,0,241,1653,44,109,42,2089
1113,0,6409,2512,494,485,1080,10980
1114,0,37,163,25,14,140,379
1115,0,64,222,76,59,125,546
1116,0,2318,950,25,38,26,3357
1117,0,93,224,3,45,3,368
1118,0,592,1511,511,677,860,4151
1119,0,220,713,41,92,195,1261
1120,0,109,428,38,11,250,836
1121,0,6254,4434,572,633,1379,13272
1122,0,5005,7390,2876,1859,3858,20988
1123,0,542,942,77,322,792,2675
1124,0,278,3577,19,304,127,4305
1125,0,45,318,25,43,170,601
1126,0,145,344,7,20,9,525
1127,1,470,4272,23,111,59,4936
1128,0,92,456,44,129,71,792
1129,1,160,1547,15,516,125,2364
1130,0,94,222,7,35,4,362
1131,1,116,144,15,45,56,377
1132,1,137,900,33,55,8,1134
1133,11,455,467,247,204,208,1592
1134,0,669,1361,173,280,626,3109
1135,8,46,631,25,14,0,724
1136,0,1508,1708,30,554,14,3814
1137,7,2840,7054,1332,541,571,12345
1138,0,238,598,26,93,77,1032
1139,16,26,110,7,9,3,171
1140,0,221,1367,42,9,233,1872
1141,3,177,6643,167,28,126,7144
1142,0,72,171,0,37,1,281
1143,0,141,1880,29,70,12,2132
1144,0,441,709,68,52,40,1310
1145,4,9461,4955,1563,1374,1955,19312
1146,4,1900,10053,138,119,2772,14986
1147,0,504,1381,44,247,133,2309
1148,0,86,833,13,0,0,932
1149,0,210,422,0,103,39,774
1150,0,781,1775,54,221,491,3322
1151,0,106,478,32,28,7,651
1152,0,1191,3761,202,261,577,5992
1153,0,316,665,16,37,12,1046
1154,16,423,1509,103,212,159,2422
1155,0,125,100,3,31,16,275
1156,4,130,194,33,27,62,450
1157,0,173,787,7,31,56,1054
1158,0,210,850,20,117,327,1524
1159,0,46,1373,6,21,28,1474
1160,7,157,713,7,42,0,926
1161,1,2036,4684,341,1085,959,9106
1162,0,42,35,17,29,12,135
1163,19,32,139,17,4,14,225
1164,8,224,514,35,131,8,920
1165,1,175,719,51,198,20,1164
1166,3,212,2118,83,76,57,2549
1167,0,246,642,39,105,48,1080
1168,8,13215,5195,3198,4158,883,26657
1169,0,1616,883,187,614,836,4136
1170,14,1350,3153,322,706,720,6265
1171,0,213,808,35,36,144,1236
1172,0,50,380,44,12,133,619
1173,0,18,510,1,27,12,568
1174,0,54,440,154,26,4,678
1175,1362,2300,1006,1426,245,160,6499
1176,73,1106,4310,205,494,577,6765
1177,77,358,1125,286,385,50,2281
1178,25,854,6927,276,732,2168,10982
1179,350,1000,3736,697,1860,853,8496
1180,37,122,942,177,365,69,1712
1181,7,30,163,49,50,8,307
1182,42,331,1051,221,318,332,2295
1183,0,195,263,1596,411,54,2519
1184,0,39,394,35,27,90,585
1185,5,343,1976,61,296,1147,3828
1186,0,236,3333,51,51,530,4201
1187,0,140,1873,13,71,312,2409
1188,0,105,904,306,505,110,1930
1189,0,764,2593,818,1025,1614,6814
1190,0,36,507,0,9,179,731
1191,0,47,858,1,7,32,945
1192,0,13,336,3,20,0,372
1193,0,104,700,13,35,274,1126
1194,0,30,389,1,7,3,430
1195,0,141,789,35,133,121,1219
1196,0,54,230,28,56,0,368
1197,0,55,1020,0,12,260,1347
1198,0,21,1609,0,82,384,2096
1199,0,285,1908,973,879,419,4464
1200,0,67,489,3,78,12,649
1201,0,30,220,164,9,0,423
1202,0,43,242,0,16,117,418
1203,0,22,1179,46,394,5,1646
1204,0,41,422,238,327,332,1360
1205,0,123,362,1166,303,1,1955
1206,0,16,369,375,176,141,1077
1207,0,137,127,60,25,1,350
1208,0,26,392,12,12,97,539
1209,0,8,107,398,3,40,556
1210,0,22,304,64,43,39,472
1211,96,1648,759,3933,2158,459,9053
1212,0,241,829,60,445,40,1615
1213,0,88,403,0,26,117,634
1214,0,79,129,3,13,23,247
1215,0,87,496,11,9,223,826
1216,0,52,100,6,25,16,199
1217,60,283,116,22,271,13,765
1218,0,17,96,0,6,2,121
1219,0,102,299,4,350,34,789
1220,0,177,249,62,37,111,636
1221,0,9,210,6,29,6,260
1222,0,16,1995,37,11,0,2059
1223,0,68,208,705,1158,17,2156
1224,0,126,935,147,369,72,1649
1225,3,16,75,5,150,34,283
1226,1,196,71,355,1,87,711
1227,0,0,164,26,2,40,232
1228,0,5,122,1,29,0,157
1229,0,92,712,6,13,128,951
1230,0,31,349,12,6,50,448
1231,0,36,353,12,7,54,462
1232,0,246,618,10,48,170,1092
1233,0,74,247,3,3,16,343
1234,0,223,1663,102,310,209,2507
1235,0,25,174,3,0,29,231
1236,0,16,447,1,2,55,521
1237,0,5,89,0,4,0,98
1238,0,247,726,383,291,0,1647
1239,0,11,45,1,0,0,57
1240,0,4,382,24,13,59,482
1241,0,250,2703,356,70,563,3942
1242,0,84,5129,6,9,29,5257
1243,0,28,1358,0,4,23,1413
1244,1,72,434,5,25,6,543
1245,0,4,117,4,6,5,136
1246,55,261,1344,51,58,1878,3647
1247,0,383,850,1029,1187,239,3688
1248,19,2341,2057,175,590,518,5700
1249,20,786,1208,738,537,415,3704
1250,5,272,1019,2539,343,829,5007
1251,0,105,758,117,483,375,1838
1252,0,474,887,82,262,36,1741
1253,0,0,62,4,22,7,95
1254,0,15,185,40,40,1,281
1255,23,28,402,0,5,57,515
1256,0,50,223,108,97,12,490
1257,0,17,212,2,4,3,238
1258,0,5,148,0,14,32,199
1259,0,208,590,549,36,138,1521
1260,0,16,148,2,47,9,222
1261,0,96,170,7,40,142,455
1262,0,312,877,96,3904,46,5235
1263,0,100,704,8,805,21,1638
1264,0,195,479,51,1,182,908
1265,0,108,3541,19,38,1245,4951
1266,0,150,557,20,36,202,965
1267,0,96,459,0,171,162,888
1268,9,494,1606,42,97,87,2335
1269,0,72,1664,23,107,761,2627
1270,0,523,1348,1074,328,32,3305
1271,0,87,421,64,44,69,685
1272,0,0,2590,0,1475,0,4065
1273,0,183,499,22,53,139,896
1274,0,220,875,55,113,479,1742
1275,0,42,197,6,12,68,325
1276,0,128,358,7,3,100,596
1277,0,20,166,5,20,11,222
1278,0,47,200,2,14,117,380
1279,83,652,2736,2719,2292,458,8940
1280,4,262,3301,215,181,2614,6577
1281,0,736,562,180,55,564,2097
1282,4,325,1391,143,853,619,3335
1283,0,87,896,58,12,14,1067
1284,0,623,1692,92,1135,380,3922
1285,0,165,307,9,45,16,542
1286,598,81,78,21,425,4,1207
1287,231,110,14,268,191,45,859
1288,258,200,899,51,242,354,2004
1289,86,392,1228,1513,486,544,4249
1290,342,94,688,205,391,258,1978
1291,51,291,1204,125,25,612,2308
1292,113,2597,1937,3737,1697,262,10343
1293,335,75,468,67,135,90,1170
1294,31,188,4063,218,213,19,4732
1295,40,339,1363,156,245,793,2936
1296,230,50,299,101,73,40,793
1297,135,270,2326,76,192,239,3238
1298,30,1325,2150,707,128,576,4916
1299,51,644,1875,205,2755,182,5712
1300,6,80,370,199,160,14,829
1301,0,407,591,151,321,38,1508
1302,0,36,440,46,100,453,1075
1303,4,14,82,18,31,4,153
1304,47,84,523,2,90,20,766
1305,100,501,2447,387,129,508,4072
1306,233,428,3880,223,212,640,5616
1307,29,65,938,39,56,28,1155
1308,303,166,811,552,120,11,1963
1309,249,4,23,112,0,1,389
1310,42,28,2120,306,81,166,2743
1311,627,220,954,1784,207,21,3813
1312,205,19,66,38,54,6,388
1313,503,157,2256,2293,180,54,5443
1314,584,508,1961,1360,325,407,5145
1315,623,86,329,3050,438,73,4599
1316,140,25,24,268,21,0,478
1317,169,220,1633,506,218,191,2937
1318,181,232,607,469,100,73,1662
1319,55,205,909,69,244,97,1579
1320,94,1067,1668,343,137,292,3601
1321,49,181,315,97,137,34,813
1322,0,0,0,0,5,0,5
1323,209,701,3144,230,518,616,5418
1324,379,1105,263,2189,495,168,4599
1325,77,2787,2024,4450,587,403,10328
1326,13,102,222,3,65,22,427
1327,18,89,1966,59,474,10,2616
1328,245,128,319,89,138,14,933
1329,236,203,524,400,232,505,2100
1330,0,43,313,40,215,75,686
1331,5,232,743,336,268,534,2118
1332,8,1148,2679,897,500,936,6168
1333,0,20,142,5,58,13,238
1334,0,29,220,21,63,10,343
1335,0,114,964,17,106,344,1545
1336,21,1341,3142,1657,638,494,7293
1337,30,1740,4825,1687,1543,1078,10903
1338,1,34,359,13,102,84,593
1339,0,59,356,37,55,323,830
1340,0,60,470,331,229,8,1098
1341,5,37,383,20,63,6,514
1342,0,25,2237,16,31,9,2318
1343,0,32,542,0,27,9,610
1344,0,235,894,24,326,294,1773
1345,0,32,91,9,17,17,166
1346,0,554,2218,436,366,61,3635
1347,2,241,471,17,191,84,1006
1348,16,597,1467,623,487,2093,5283
1349,5,251,835,55,97,261,1504
1350,8,294,739,28,161,221,1451
1351,0,57,499,0,78,2,636
1352,0,18,54,47,45,0,164
1353,38,67,239,248,29,44,665
1354,63,117,351,125,273,149,1078
1355,0,30,443,3,71,32,579
1356,0,84,776,19,65,372,1316
1357,0,143,321,11,45,62,582
1358,0,152,2227,29,47,196,2651
1359,0,165,4852,28,63,482,5590
1360,5,297,334,2,79,51,768
1361,16,2166,1988,90,1311,819,6390
1362,0,592,971,45,227,130,1965
1363,0,352,8774,0,2896,238,12260
1364,0,125,546,21,21,117,830
1365,0,150,685,40,2023,50,2948
1366,20,815,2761,2501,278,212,6587
1367,34,88,811,27,246,21,1227
1368,132,2634,3678,4921,1320,290,12975
1369,12,300,1860,716,537,531,3956
1370,171,78,483,169,229,94,1224
1371,16,34,540,3,99,45,737
1372,2,36,385,4,41,17,485
1373,0,1159,1617,503,366,226,3871
1374,0,1256,1926,546,674,804,5206
1375,0,594,1016,419,57,134,2220
1376,2,946,1036,146,245,189,2564
1377,18,546,831,37,117,385,1934
1378,0,141,995,287,134,242,1799
1379,0,12,297,0,59,81,449
1380,24,958,1467,1264,1566,1797,7076
1381,76,1195,1792,1094,1191,217,5565
1382,141,87,1177,255,155,39,1854
1383,243,110,322,413,208,66,1362
1384,20,785,1801,643,560,487,4296
1385,31,77,409,135,95,22,769
1386,81,436,946,206,193,281,2143
1387,72,103,133,45,184,6,543
1388,6,25,25,0,46,0,102
1389,44,108,703,62,157,77,1151
1390,47,29,286,21,46,17,446
1391,17,52,670,22,71,129,961
1392,86,55,244,445,82,32,944
1393,14,55,355,440,53,21,938
1394,30,489,794,357,168,11,1849
1395,62,1204,1358,771,802,660,4857
1396,86,134,1112,107,108,153,1700
1397,84,143,235,537,300,266,1565
1398,362,39,290,11,51,6,759
1399,18,653,2805,869,594,579,5518
1400,204,48,148,695,49,29,1173
1401,1185,120,860,1584,148,28,3925
1402,406,189,1080,783,400,241,3099
1403,56,67,396,60,55,36,670
1404,4,118,100,54,38,1,315
1405,0,274,1213,123,190,903,2703
1406,0,536,635,209,1243,246,2869
1407,8,2582,1420,2986,719,166,7881
1408,0,118,629,142,75,16,980
1409,65,502,884,154,100,175,1880
1410,0,234,478,13,412,286,1423
1411,6,129,1185,12,158,12,1502
1412,0,731,2571,306,718,510,4836
1413,0,532,502,118,24,58,1234
1414,0,88,365,28,89,38,608
1415,329,149,909,286,240,108,2021
1416,36,9,251,11,50,2,359
1417,0,10,107,0,5,0,122
1418,5,43,388,20,51,24,531
1419,0,48,297,117,59,59,580
1420,3,91,633,29,214,94,1064
1421,0,873,4883,273,230,561,6820
1422,0,343,1455,164,223,89,2274
1423,7,116,500,44,60,42,769
1424,1,1431,2204,278,501,103,4518
1425,0,928,1213,12,2350,38,4541
1426,0,87,225,69,62,130,573
1427,0,603,2135,61,142,461,3402
1428,0,1878,1904,1428,1922,2439,9571
1429,0,406,709,409,650,610,2784
1430,0,1291,3404,372,1057,514,6638
1431,0,286,600,25,117,89,1117
1432,2,369,1294,53,248,191,2157
1433,0,247,331,14,40,4,636
1434,0,99,457,13,169,392,1130
1435,1,215,528,0,33,4,781
1436,0,167,2335,13,93,217,2825
1437,0,405,4303,37,63,228,5036
1438,0,1820,1437,297,234,1091,4879
1439,0,0,17,0,2124,0,2141
1440,0,293,1460,87,164,138,2142
1441,0,456,1772,423,363,929,3943
1442,4,293,799,58,112,288,1554
1443,3,239,1428,34,104,281,2089
1444,0,299,760,81,209,418,1767
1445,4,280,770,32,76,60,1222
1446,6,329,782,55,207,49,1428
1447,0,141,198,1,56,50,446
1448,2,1506,1916,660,465,619,5168
1449,0,22,346,0,5,91,464
1450,0,165,574,7,28,268,1042
1451,0,764,376,100,74,48,1362
1452,0,464,906,88,385,158,2001
1453,4,71,609,0,16,0,700
1454,62,71,263,19,59,51,525
