COUNTY_NAME,TAZ1454,AGREMPN,FPSEMPN,HEREMPN,MWTEMPN,RETEMPN,OTHEMPN,TOTEMP
San Francisco,1,3,12759,1759,485,221,1593,16820
San Francisco,2,7,16414,2674,1027,79,4107,24308
San Francisco,3,0,1182,488,1,54,331,2056
San Francisco,4,0,13636,2643,397,512,4327,21515
San Francisco,5,0,5356,3226,587,2210,1474,12853
San Francisco,6,0,428,2631,29,66,100,3254
San Francisco,7,0,1214,4194,8,371,139,5926
San Francisco,8,0,582,2570,32,39,699,3922
San Francisco,9,0,685,3635,4,137,1789,6250
San Francisco,10,10,3946,10153,684,143,9558,24494
San Francisco,11,0,3154,4040,268,1853,1587,10902
San Francisco,12,0,7976,5017,584,1148,1419,16144
San Francisco,13,1,13665,1246,313,146,1932,17303
San Francisco,14,0,17093,462,4861,38,2864,25318
San Francisco,15,11,7661,993,2767,310,2377,14119
San Francisco,16,0,16815,1573,1006,484,11775,31653
San Francisco,17,0,4955,1295,2016,203,5311,13780
San Francisco,18,0,2873,2044,529,242,2459,8147
San Francisco,19,0,6739,966,321,895,2329,11250
San Francisco,20,0,2479,1593,662,315,1603,6652
San Francisco,21,21,4185,2430,1502,251,1943,10332
San Francisco,22,12,9319,2158,169,261,1653,13572
San Francisco,23,0,4069,804,453,118,1428,6872
San Francisco,24,10,6611,2544,235,546,5335,15281
San Francisco,25,0,234,1284,27,184,26,1755
San Francisco,26,0,2359,974,121,42,913,4409
San Francisco,27,0,50,1234,22,131,3,1440
San Francisco,28,0,164,590,32,10,25,821
San Francisco,29,0,529,863,23,11,0,1426
San Francisco,30,0,207,722,12,105,43,1089
San Francisco,31,0,369,1654,6,13,23,2065
San Francisco,32,0,246,1777,7,239,57,2326
San Francisco,33,0,306,942,21,78,64,1411
San Francisco,34,0,196,692,26,134,29,1077
San Francisco,35,2,277,239,0,21,0,539
San Francisco,36,12,217,1783,39,224,26,2301
San Francisco,37,0,713,1541,113,102,174,2643
San Francisco,38,0,452,575,140,211,108,1486
San Francisco,39,0,86,435,5,21,17,564
San Francisco,40,8,765,893,316,191,41,2214
San Francisco,41,0,2102,2315,244,803,83,5547
San Francisco,42,0,116,389,58,3,93,659
San Francisco,43,0,263,769,152,263,29,1476
San Francisco,44,0,393,667,25,73,84,1242
San Francisco,45,0,662,1711,120,225,229,2947
San Francisco,46,0,662,852,71,22,67,1674
San Francisco,47,0,768,1553,26,96,142,2585
San Francisco,48,0,168,528,65,73,36,870
San Francisco,49,0,117,819,7,0,22,965
San Francisco,50,0,326,1167,14,369,113,1989
San Francisco,51,0,67,347,43,7,77,541
San Francisco,52,1,1676,1890,324,298,1393,5582
San Francisco,53,0,33,961,0,3,22,1019
San Francisco,54,0,57,417,28,178,35,715
San Francisco,55,0,27,169,4,28,16,244
San Francisco,56,0,142,2785,0,23,2,2952
San Francisco,57,0,32,212,11,0,9,264
San Francisco,58,0,71,619,12,48,34,784
San Francisco,59,3,118,700,22,31,73,947
San Francisco,60,0,30,474,0,13,14,531
San Francisco,61,0,219,459,0,22,25,725
San Francisco,62,0,149,929,36,119,45,1278
San Francisco,63,0,139,344,6,66,95,650
San Francisco,64,0,62,394,0,117,48,621
San Francisco,65,3,254,857,18,181,113,1426
San Francisco,66,14,144,849,27,246,57,1337
San Francisco,67,0,52,573,10,64,31,730
San Francisco,68,0,206,453,0,38,41,738
San Francisco,69,0,244,7086,17,269,30,7646
San Francisco,70,0,491,921,13,414,141,1980
San Francisco,71,20,374,1532,18,124,37,2105
San Francisco,72,0,176,831,5,67,23,1102
San Francisco,73,0,169,1008,14,236,68,1495
San Francisco,74,0,363,2337,22,186,28,2936
San Francisco,75,0,685,2900,6,377,33,4001
San Francisco,76,0,293,730,8,44,1563,2638
San Francisco,77,0,92,1597,17,157,30,1893
San Francisco,78,0,69,1004,2,3,3,1081
San Francisco,79,0,407,4408,254,164,3339,8572
San Francisco,80,0,214,295,5,20,14,548
San Francisco,81,0,441,14021,9,57,91,14619
San Francisco,82,0,339,578,7,272,41,1237
San Francisco,83,1,467,230,1,9,6,714
San Francisco,84,0,168,1030,27,29,44,1298
San Francisco,85,0,166,692,23,180,206,1267
San Francisco,86,0,65,894,4,27,32,1022
San Francisco,87,0,122,1224,6,31,15,1398
San Francisco,88,31,171,576,34,426,138,1376
San Francisco,89,0,154,624,13,92,85,968
San Francisco,90,0,119,16406,1,55,28,16609
San Francisco,91,0,64,273,5,9,30,381
San Francisco,92,0,55,86,0,6,27,174
San Francisco,93,0,102,200,90,15,60,467
San Francisco,94,0,180,480,24,133,15,832
San Francisco,95,0,196,339,11,3,32,581
San Francisco,96,3,96,148,2,9,21,279
San Francisco,97,0,114,396,75,86,24,695
San Francisco,98,0,190,398,8,160,16,772
San Francisco,99,0,79,356,239,18,74,766
San Francisco,100,0,557,1193,46,200,132,2128
San Francisco,101,16,433,1761,330,233,284,3057
San Francisco,102,0,90,980,155,141,267,1633
San Francisco,103,0,191,595,65,75,55,981
San Francisco,104,0,491,867,34,299,126,1817
San Francisco,105,5,121,1168,29,162,78,1563
San Francisco,106,0,690,1926,89,411,548,3664
San Francisco,107,0,2409,4268,9628,1167,9150,26622
San Francisco,108,0,1075,2257,553,286,259,4430
San Francisco,109,0,2545,1185,376,103,1538,5747
San Francisco,110,0,2802,2723,1031,116,173,6845
San Francisco,111,0,1861,2388,1225,234,1167,6875
San Francisco,112,0,249,294,134,41,68,786
San Francisco,113,0,250,423,114,15,118,920
San Francisco,114,0,245,443,51,342,166,1247
San Francisco,115,0,191,322,18,11,15,557
San Francisco,116,0,1997,1219,316,665,767,4964
San Francisco,117,0,428,428,34,9,27,926
San Francisco,118,0,220,345,4,53,18,640
San Francisco,119,0,25,272,6,82,16,401
San Francisco,120,0,50,371,21,51,129,622
San Francisco,121,0,128,161,52,55,37,433
San Francisco,122,0,439,429,59,33,92,1052
San Francisco,123,0,228,1035,102,160,125,1650
San Francisco,124,0,26,154,2,91,19,292
San Francisco,125,0,30,164,0,9,21,224
San Francisco,126,0,41,163,4,0,30,238
San Francisco,127,0,47,396,11,102,45,601
San Francisco,128,0,164,280,10,34,48,536
San Francisco,129,0,70,122,6,1,41,240
San Francisco,130,12,214,346,2,172,18,764
San Francisco,131,0,64,168,79,6,45,362
San Francisco,132,0,64,320,42,139,13,578
San Francisco,133,0,103,1638,18,54,121,1934
San Francisco,134,0,111,494,28,36,75,744
San Francisco,135,0,67,389,9,63,36,564
San Francisco,136,0,75,632,2,0,49,758
San Francisco,137,0,22,246,1,32,75,376
San Francisco,138,0,102,1055,28,195,966,2346
San Francisco,139,10,171,532,51,68,124,956
San Francisco,140,0,4,187,24,31,17,263
San Francisco,141,0,44,218,18,12,34,326
San Francisco,142,4,1465,1091,2095,869,2791,8315
San Francisco,143,0,64,536,54,25,134,813
San Francisco,144,0,192,417,4,0,12,625
San Francisco,145,0,70,389,21,0,262,742
San Francisco,146,0,16,51,14,0,0,81
San Francisco,147,4,123,380,432,24,490,1453
San Francisco,148,0,101,383,563,17,761,1825
San Francisco,149,0,472,259,9,5,157,902
San Francisco,150,0,360,656,152,210,567,1945
San Francisco,151,0,4,90,2,24,3,123
San Francisco,152,0,434,228,2,5,28,697
San Francisco,153,0,10,167,26,1,23,227
San Francisco,154,0,66,371,12,107,10,566
San Francisco,155,0,40,288,0,11,37,376
San Francisco,156,0,2,172,3,2,6,185
San Francisco,157,0,1,149,16,1,0,167
San Francisco,158,0,6,370,0,0,7,383
San Francisco,159,0,10,217,0,20,22,269
San Francisco,160,0,49,215,3,5,15,287
San Francisco,161,0,38,301,1,12,34,386
San Francisco,162,0,52,309,18,59,46,484
San Francisco,163,0,30,295,4,5,36,370
San Francisco,164,0,3516,388,26,68,45,4043
San Francisco,165,0,62,787,3,151,60,1063
San Francisco,166,0,36,753,12,18,103,922
San Francisco,167,0,39,340,6,11,78,474
San Francisco,168,0,94,438,17,84,99,732
San Francisco,169,0,140,662,29,26,95,952
San Francisco,170,0,352,1163,56,107,120,1798
San Francisco,171,13,31,150,56,113,19,382
San Francisco,172,5,43,274,8,98,82,510
San Francisco,173,0,87,62,2,50,25,226
San Francisco,174,0,61,228,7,3,70,369
San Francisco,175,0,136,959,23,103,58,1279
San Francisco,176,0,58,321,9,62,36,486
San Francisco,177,0,233,771,50,179,63,1296
San Francisco,178,0,114,352,4,13,45,528
San Francisco,179,0,42,423,15,4,56,540
San Francisco,180,0,16,353,13,53,45,480
San Francisco,181,9,27,463,40,56,84,679
San Francisco,182,0,17,339,8,30,94,488
San Francisco,183,0,47,1047,17,93,54,1258
San Francisco,184,0,143,506,14,103,88,854
San Francisco,185,0,231,1250,39,63,83,1666
San Francisco,186,3,178,931,33,62,124,1331
San Francisco,187,0,418,188,10,182,57,855
San Francisco,188,0,145,4727,6,784,28,5690
San Francisco,189,0,161,461,8,4,63,697
San Francisco,190,0,31,685,4,2,11,733
San Mateo,191,0,78,277,2,36,33,426
San Mateo,192,0,119,678,3,576,17,1393
San Mateo,193,0,206,1291,139,88,450,2174
San Mateo,194,0,54,1585,72,73,68,1852
San Mateo,195,0,21,190,5,0,29,245
San Mateo,196,0,35,195,0,0,28,258
San Mateo,197,0,71,233,0,128,8,440
San Mateo,198,0,15,853,24,6,2,900
San Mateo,199,0,103,693,3,1043,23,1865
San Mateo,200,47,252,1207,99,2304,69,3978
San Mateo,201,1,83,478,155,192,110,1019
San Mateo,202,0,7,310,17,0,39,373
San Mateo,203,6,306,1266,53,237,345,2213
San Mateo,204,0,49,353,26,122,97,647
San Mateo,205,0,37,203,3,1,15,259
San Mateo,206,0,42,83,2,0,24,151
San Mateo,207,0,33,251,396,43,7,730
San Mateo,208,39,2420,828,2524,414,595,6820
San Mateo,209,0,53,288,33,3,40,417
San Mateo,210,0,43,174,145,67,115,544
San Mateo,211,0,347,634,226,222,160,1589
San Mateo,212,265,11088,4260,19126,968,2567,38274
San Mateo,213,0,77,743,14,112,76,1022
San Mateo,214,0,71,328,18,78,264,759
San Mateo,215,0,138,252,2,62,4,458
San Mateo,216,0,14,3013,19,105,51,3202
San Mateo,217,0,43,251,4,44,42,384
San Mateo,218,0,300,1101,23,238,73,1735
San Mateo,219,0,8,200,0,77,16,301
San Mateo,220,0,17,237,0,4,22,280
San Mateo,221,0,31,130,5,76,27,269
San Mateo,222,0,63,439,62,134,38,736
San Mateo,223,0,137,441,56,111,342,1087
San Mateo,224,0,10,168,1,10,66,255
San Mateo,225,0,74,549,33,159,93,908
San Mateo,226,4,94,412,1,238,67,816
San Mateo,227,7,42,163,79,1,45,337
San Mateo,228,0,0,11,0,0,0,11
San Mateo,229,0,24,654,11,9,23,721
San Mateo,230,0,61,800,80,450,14,1405
San Mateo,231,0,23,155,16,2,19,215
San Mateo,232,0,72,204,4,4,14,298
San Mateo,233,0,56,206,11,79,69,421
San Mateo,234,0,1917,1091,222,1167,2689,7086
San Mateo,235,0,14,405,47,1,305,772
San Mateo,236,0,122,461,27,103,68,781
San Mateo,237,0,99,1002,7,171,35,1314
San Mateo,238,0,62,311,237,41,63,714
San Mateo,239,0,769,1065,7239,281,46,9400
San Mateo,240,0,366,1821,195,271,107,2760
San Mateo,241,0,40,261,8,0,81,390
San Mateo,242,0,16,142,1,0,13,172
San Mateo,243,0,26,70,3,3,12,114
San Mateo,244,0,140,432,23,198,152,945
San Mateo,245,0,19,276,3,0,23,321
San Mateo,246,0,766,2773,68,152,40,3799
San Mateo,247,0,37,194,11,8,120,370
San Mateo,248,0,6231,2623,2892,313,1027,13086
San Mateo,249,1,1138,930,1230,299,603,4201
San Mateo,250,0,34,328,15,93,143,613
San Mateo,251,0,733,1275,85,936,964,3993
San Mateo,252,22,298,687,86,2,232,1327
San Mateo,253,0,40,40,3,6,25,114
San Mateo,254,4,90,363,8,0,50,515
San Mateo,255,0,113,205,3,30,29,380
San Mateo,256,0,567,743,11,11,95,1427
San Mateo,257,0,1735,3035,197,481,681,6129
San Mateo,258,0,131,592,31,21,94,869
San Mateo,259,0,82,961,180,109,109,1441
San Mateo,260,0,324,431,182,146,168,1251
San Mateo,261,0,44,312,32,13,64,465
San Mateo,262,0,107,272,15,72,151,617
San Mateo,263,0,6,157,60,2,57,282
San Mateo,264,0,319,266,66,90,58,799
San Mateo,265,0,3307,561,351,625,2198,7042
San Mateo,266,0,8086,1871,2161,602,2077,14797
San Mateo,267,0,51,340,11,0,62,464
San Mateo,268,0,13,298,42,4,16,373
San Mateo,269,0,109,259,14,61,9,452
San Mateo,270,0,22,50,8,3,13,96
San Mateo,271,0,86,189,471,50,6,802
San Mateo,272,0,28,95,12,13,11,159
San Mateo,273,0,28,45,4,0,8,85
San Mateo,274,0,1067,149,17,76,28,1337
San Mateo,275,0,545,282,100,210,303,1440
San Mateo,276,0,48,142,53,23,23,289
San Mateo,277,0,59,410,44,19,67,599
San Mateo,278,0,1688,801,66,585,2559,5699
San Mateo,279,0,1902,1022,277,824,2115,6140
San Mateo,280,0,882,798,132,333,167,2312
San Mateo,281,0,478,1070,114,182,393,2237
San Mateo,282,4,2759,426,149,23,96,3457
San Mateo,283,0,6,259,17,34,17,333
San Mateo,284,0,383,1743,31,1131,84,3372
San Mateo,285,0,6,400,2,15,57,480
San Mateo,286,0,200,702,122,203,76,1303
San Mateo,287,0,174,508,8,25,185,900
San Mateo,288,0,75,835,32,92,38,1072
San Mateo,289,0,84,252,20,53,8,417
San Mateo,290,0,17,38,9,0,48,112
San Mateo,291,0,169,773,305,111,47,1405
San Mateo,292,0,48,150,0,14,28,240
San Mateo,293,18,71,170,147,30,73,509
San Mateo,294,8,85,609,78,95,151,1026
San Mateo,295,100,66,407,131,232,96,1032
San Mateo,296,237,776,1894,147,300,273,3627
San Mateo,297,440,87,371,43,44,86,1071
San Mateo,298,117,300,987,62,71,28,1565
San Mateo,299,22,184,528,6,155,236,1131
San Mateo,300,0,235,669,76,0,36,1016
San Mateo,301,0,147,348,10,61,162,728
San Mateo,302,1,137,70,16,4,37,265
San Mateo,303,0,72,380,2,5,47,506
San Mateo,304,10,60,868,14,0,38,990
San Mateo,305,0,16,91,0,0,7,114
San Mateo,306,0,76,88,7,0,18,189
San Mateo,307,0,128,303,59,5,23,518
San Mateo,308,7,38,170,83,0,73,371
San Mateo,309,0,1143,1831,118,433,184,3709
San Mateo,310,106,3298,1653,1853,1109,2028,10047
San Mateo,311,0,4362,2231,2169,108,4426,13296
San Mateo,312,0,123,144,153,0,171,591
San Mateo,313,17,2301,1774,729,448,2157,7426
San Mateo,314,0,799,3037,949,239,605,5629
San Mateo,315,2,3066,4572,376,882,6180,15078
San Mateo,316,0,90,97,6,24,63,280
San Mateo,317,0,138,1031,122,145,86,1522
San Mateo,318,0,79,241,0,8,93,421
San Mateo,319,0,51,143,2,9,58,263
San Mateo,320,0,99,351,9,3,77,539
San Mateo,321,0,183,313,25,113,49,683
San Mateo,322,5,233,265,17,40,18,578
San Mateo,323,0,109,337,305,406,48,1205
San Mateo,324,0,62,355,0,166,19,602
San Mateo,325,0,72,107,4,231,62,476
San Mateo,326,0,157,327,97,483,197,1261
San Mateo,327,0,103,386,88,153,20,750
San Mateo,328,0,227,174,35,26,53,515
San Mateo,329,0,773,672,389,134,576,2544
San Mateo,330,0,100,196,19,32,154,501
San Mateo,331,16,2605,726,2300,106,30516,36269
San Mateo,332,36,2561,1606,505,7,682,5397
San Mateo,333,0,86,684,9,479,58,1316
San Mateo,334,0,140,347,34,65,103,689
San Mateo,335,8,1236,215,19,296,4,1778
San Mateo,336,0,171,140,34,147,9,501
San Mateo,337,0,36,1065,7,0,153,1261
San Mateo,338,0,36,43,0,3,19,101
San Mateo,339,0,44,581,0,0,78,703
San Mateo,340,0,1380,758,214,23,2362,4737
San Mateo,341,0,1185,2265,35,726,317,4528
San Mateo,342,9,104,1285,24,4,16,1442
San Mateo,343,0,96,414,0,1,9,520
San Mateo,344,0,45,137,23,2,20,227
San Mateo,345,0,360,315,9,28,14,726
San Mateo,346,7,4083,738,656,117,359,5960
Santa Clara,347,141,223,1422,140,20,65,2011
Santa Clara,348,0,2703,150,354,0,5065,8272
Santa Clara,349,0,4260,3670,2578,10,633,11151
Santa Clara,350,0,560,93,340,117,6,1116
Santa Clara,351,5,1865,2138,78,159,414,4659
Santa Clara,352,1,10,59,0,0,75,145
Santa Clara,353,0,42,99,15,52,21,229
Santa Clara,354,0,471,14934,1,36,0,15442
Santa Clara,355,5,357,20213,30,1559,55,22219
Santa Clara,356,0,5833,3965,463,694,9319,20274
Santa Clara,357,0,156,360,29,6,99,650
Santa Clara,358,0,362,254,53,11,125,805
Santa Clara,359,0,182,228,31,16,65,522
Santa Clara,360,0,211,179,10,18,16,434
Santa Clara,361,0,150,390,37,112,103,792
Santa Clara,362,0,430,704,1640,55,37,2866
Santa Clara,363,0,28,418,0,29,20,495
Santa Clara,364,0,20,232,3,48,0,303
Santa Clara,365,0,157,290,273,58,161,939
Santa Clara,366,0,965,901,1844,125,635,4470
Santa Clara,367,0,2157,770,81,92,113,3213
Santa Clara,368,2,164,294,18,4,21,503
Santa Clara,369,0,178,569,17,5,44,813
Santa Clara,370,1,1066,1036,69,260,359,2791
Santa Clara,371,2,399,1081,14,233,93,1822
Santa Clara,372,0,327,1144,92,732,246,2541
Santa Clara,373,0,1620,420,19,180,542,2781
Santa Clara,374,0,870,755,662,553,772,3612
Santa Clara,375,0,82,272,0,2,9,365
Santa Clara,376,22,1055,466,562,87,379,2571
Santa Clara,377,0,658,147,243,22,1724,2794
Santa Clara,378,0,3422,1984,67,128,1026,6627
Santa Clara,379,5,32,372,3,14,37,463
Santa Clara,380,0,24,148,6,47,53,278
Santa Clara,381,0,175,481,131,197,263,1247
Santa Clara,382,0,53,207,4,17,2,283
Santa Clara,383,0,160,3248,53,104,184,3749
Santa Clara,384,6,153,482,2,30,19,692
Santa Clara,385,0,126,44,0,3,11,184
Santa Clara,386,0,51,67,16,0,7,141
Santa Clara,387,0,45,324,60,159,75,663
Santa Clara,388,0,181,1351,49,18,145,1744
Santa Clara,389,0,133,915,50,280,58,1436
Santa Clara,390,0,118,192,207,19,30,566
Santa Clara,391,0,121,1694,12,408,113,2348
Santa Clara,392,0,62,288,4,34,9,397
Santa Clara,393,0,28,336,326,56,65,811
Santa Clara,394,1,103,624,32,18,199,977
Santa Clara,395,0,3947,691,841,15,3912,9406
Santa Clara,396,0,887,324,705,1,798,2715
Santa Clara,397,0,1088,112,444,63,587,2294
Santa Clara,398,0,493,213,218,242,291,1457
Santa Clara,399,0,3837,169,643,142,2310,7101
Santa Clara,400,0,72,210,8,8,27,325
Santa Clara,401,6,4155,3713,3746,200,22954,34774
Santa Clara,402,0,1002,162,3809,0,1030,6003
Santa Clara,403,1,5473,495,6584,3,17369,29925
Santa Clara,404,0,668,376,1606,14,2072,4736
Santa Clara,405,0,959,699,1211,574,173,3616
Santa Clara,406,26,2637,838,6368,151,1221,11241
Santa Clara,407,0,1787,1398,4608,627,2436,10856
Santa Clara,408,0,7911,442,2524,179,984,12040
Santa Clara,409,0,5125,1415,5929,46,552,13067
Santa Clara,410,0,2803,273,7517,12,371,10976
Santa Clara,411,0,0,0,608,0,0,608
Santa Clara,412,2,2864,1015,7696,170,150,11897
Santa Clara,413,0,101,391,1262,142,22,1918
Santa Clara,414,0,1291,965,3830,287,2039,8412
Santa Clara,415,0,6063,3942,3095,222,1218,14540
Santa Clara,416,0,2162,379,419,20,478,3458
Santa Clara,417,0,674,49,3143,13,324,4203
Santa Clara,418,0,555,252,1920,71,250,3048
Santa Clara,419,0,38,181,18,6,8,251
Santa Clara,420,0,9,188,3,28,9,237
Santa Clara,421,0,220,164,58,18,30,490
Santa Clara,422,0,421,183,173,9,799,1585
Santa Clara,423,2,33,192,27,71,6,331
Santa Clara,424,0,114,410,39,35,21,619
Santa Clara,425,0,99,194,5,59,287,644
Santa Clara,426,0,49,131,944,184,19,1327
Santa Clara,427,0,6423,1049,2789,316,796,11373
Santa Clara,428,0,3653,1168,1859,505,711,7896
Santa Clara,429,0,2163,552,6175,13,3092,11995
Santa Clara,430,0,6061,874,8208,226,1080,16449
Santa Clara,431,0,728,310,1444,92,857,3431
Santa Clara,432,0,2614,622,3528,421,2093,9278
Santa Clara,433,0,353,563,347,45,894,2202
Santa Clara,434,0,366,1006,2091,627,683,4773
Santa Clara,435,0,7205,2223,2321,218,2401,14368
Santa Clara,436,0,412,871,67,274,20,1644
Santa Clara,437,0,20,189,4,132,10,355
Santa Clara,438,0,41,366,7,33,14,461
Santa Clara,439,27,57,538,17,196,22,857
Santa Clara,440,0,60,639,10,33,46,788
Santa Clara,441,0,176,567,0,118,24,885
Santa Clara,442,0,23,303,4,39,19,388
Santa Clara,443,0,24,142,2,13,61,242
Santa Clara,444,0,121,600,151,50,75,997
Santa Clara,445,0,51,395,28,95,12,581
Santa Clara,446,0,47,119,46,69,4,285
Santa Clara,447,0,62,282,3,79,12,438
Santa Clara,448,0,397,701,10,343,24,1475
Santa Clara,449,0,93,922,6,282,23,1326
Santa Clara,450,0,1767,1117,354,410,274,3922
Santa Clara,451,0,62,895,3,286,44,1290
Santa Clara,452,0,24,985,14,145,11,1179
Santa Clara,453,0,161,705,6,279,23,1174
Santa Clara,454,0,45,804,58,7,65,979
Santa Clara,455,0,54,404,10,113,10,591
Santa Clara,456,0,127,245,53,12,19,456
Santa Clara,457,0,59,111,3,0,13,186
Santa Clara,458,0,58,168,8,7,5,246
Santa Clara,459,0,82,592,11,131,37,853
Santa Clara,460,4,183,5066,34587,113,109,40062
Santa Clara,461,0,160,188,4,6,30,388
Santa Clara,462,0,140,696,4,303,36,1179
Santa Clara,463,0,115,85,14,30,42,286
Santa Clara,464,0,45,197,12,0,4,258
Santa Clara,465,0,195,1020,68,692,36,2011
Santa Clara,466,0,122,1057,47,3000,29,4255
Santa Clara,467,0,2385,2127,100,637,1270,6519
Santa Clara,468,0,123,592,4,113,63,895
Santa Clara,469,4,251,521,21,74,44,915
Santa Clara,470,0,68,482,127,68,68,813
Santa Clara,471,2,96,877,51,445,35,1506
Santa Clara,472,0,340,657,108,17,104,1226
Santa Clara,473,0,65,390,58,36,6,555
Santa Clara,474,0,11,158,3,8,32,212
Santa Clara,475,0,103,687,110,668,45,1613
Santa Clara,476,0,219,1344,9,302,52,1926
Santa Clara,477,2,41,740,3,64,105,955
Santa Clara,478,0,685,504,66,947,28,2230
Santa Clara,479,0,582,764,160,5,37,1548
Santa Clara,480,0,16,280,13,18,0,327
Santa Clara,481,0,50,306,2,79,7,444
Santa Clara,482,0,40,84,11,6,16,157
Santa Clara,483,0,314,425,7,138,65,949
Santa Clara,484,0,1065,1166,223,180,328,2962
Santa Clara,485,0,530,1097,183,335,45,2190
Santa Clara,486,0,314,436,46,440,9,1245
Santa Clara,487,0,90,512,7,79,29,717
Santa Clara,488,0,155,538,31,6,40,770
Santa Clara,489,0,65,307,7,5,5,389
Santa Clara,490,0,739,1545,464,272,180,3200
Santa Clara,491,0,48,241,5,223,1,518
Santa Clara,492,0,220,250,23,163,64,720
Santa Clara,493,0,144,336,2,9,25,516
Santa Clara,494,0,304,485,43,46,26,904
Santa Clara,495,15,77,240,74,3,33,442
Santa Clara,496,0,213,860,27,18,126,1244
Santa Clara,497,42,123,1468,45,18,102,1798
Santa Clara,498,0,147,610,14,144,62,977
Santa Clara,499,0,95,834,27,313,32,1301
Santa Clara,500,0,13,167,6,3,42,231
Santa Clara,501,0,2,112,0,32,44,190
Santa Clara,502,0,47,361,8,282,9,707
Santa Clara,503,6,125,1199,12,136,51,1529
Santa Clara,504,0,1258,2210,1590,613,2142,7813
Santa Clara,505,0,20,185,7,15,56,283
Santa Clara,506,0,173,1043,352,35,32,1635
Santa Clara,507,2,92,344,9,63,29,539
Santa Clara,508,0,2175,437,1165,1,489,4267
Santa Clara,509,0,470,576,143,175,282,1646
Santa Clara,510,4,27,143,29,0,17,220
Santa Clara,511,14,572,2783,238,332,770,4709
Santa Clara,512,1,61,137,21,0,75,295
Santa Clara,513,6,42,199,2,6,23,278
Santa Clara,514,1,137,748,22,192,113,1213
Santa Clara,515,0,51,331,27,15,49,473
Santa Clara,516,0,23,128,4,1,3,159
Santa Clara,517,0,42,675,25,126,102,970
Santa Clara,518,0,355,1963,57,528,94,2997
Santa Clara,519,0,299,3964,1659,64,110,6096
Santa Clara,520,0,138,467,23,70,55,753
Santa Clara,521,0,198,1475,181,268,401,2523
Santa Clara,522,0,111,459,9,68,226,873
Santa Clara,523,0,110,399,21,658,82,1270
Santa Clara,524,0,102,55,17,11,41,226
Santa Clara,525,0,68,477,45,14,25,629
Santa Clara,526,8,68,518,8,22,38,662
Santa Clara,527,0,367,674,10,123,75,1249
Santa Clara,528,15,263,747,41,106,101,1273
Santa Clara,529,3,129,412,36,237,86,903
Santa Clara,530,0,2828,2141,369,903,1087,7328
Santa Clara,531,0,632,1013,27,2699,29,4400
Santa Clara,532,0,56,531,18,112,30,747
Santa Clara,533,0,306,6600,6,43,41,6996
Santa Clara,534,0,266,454,329,85,56,1190
Santa Clara,535,0,128,805,44,179,16,1172
Santa Clara,536,0,62,357,20,145,45,629
Santa Clara,537,4,544,954,755,320,405,2982
Santa Clara,538,68,315,214,7,45,31,680
Santa Clara,539,0,589,2022,475,534,943,4563
Santa Clara,540,34,790,1961,191,159,111,3246
Santa Clara,541,0,115,1326,46,176,37,1700
Santa Clara,542,2,437,1017,73,4,550,2083
Santa Clara,543,33,458,2651,82,96,769,4089
Santa Clara,544,0,68,327,55,63,56,569
Santa Clara,545,0,265,833,14,29,16,1157
Santa Clara,546,0,1545,10298,324,42,13262,25471
Santa Clara,547,0,1879,720,489,152,2333,5573
Santa Clara,548,0,69,561,68,57,31,786
Santa Clara,549,3,1184,877,99,93,262,2518
Santa Clara,550,0,143,277,2,32,46,500
Santa Clara,551,0,102,495,252,101,168,1118
Santa Clara,552,0,29,131,0,1,119,280
Santa Clara,553,0,13,168,32,21,17,251
Santa Clara,554,0,79,353,2,49,44,527
Santa Clara,555,0,47,580,63,43,13,746
Santa Clara,556,0,3,320,0,1,0,324
Santa Clara,557,0,435,5100,113,115,3099,8862
Santa Clara,558,10,8745,2631,252,150,7081,18869
Santa Clara,559,0,63,399,24,25,63,574
Santa Clara,560,0,1131,969,156,38,50,2344
Santa Clara,561,7,142,393,261,66,94,963
Santa Clara,562,0,25,208,6,55,78,372
Santa Clara,563,7,1574,2839,4855,1414,3529,14218
Santa Clara,564,0,110,712,21,626,75,1544
Santa Clara,565,0,348,306,170,9,143,976
Santa Clara,566,0,61,381,106,86,297,931
Santa Clara,567,0,117,614,449,240,281,1701
Santa Clara,568,0,23,393,79,86,85,666
Santa Clara,569,0,16,180,7,3,18,224
Santa Clara,570,0,58,153,0,92,8,311
Santa Clara,571,1,3,120,4,3,34,165
Santa Clara,572,0,17,504,9,1,9,540
Santa Clara,573,0,5,164,12,48,9,238
Santa Clara,574,0,29,338,6,17,27,417
Santa Clara,575,0,19,471,55,84,29,658
Santa Clara,576,0,48,230,52,45,80,455
Santa Clara,577,0,5,361,2,3,2,373
Santa Clara,578,0,60,446,13,65,26,610
Santa Clara,579,0,24,947,209,564,471,2215
Santa Clara,580,0,34,228,114,68,112,556
Santa Clara,581,0,18,292,2,63,10,385
Santa Clara,582,0,90,1337,42,364,38,1871
Santa Clara,583,0,208,1663,38,1058,41,3008
Santa Clara,584,0,36,360,29,52,24,501
Santa Clara,585,0,37,322,7,92,6,464
Santa Clara,586,0,12,392,14,231,40,689
Santa Clara,587,0,5,332,0,0,0,337
Santa Clara,588,0,20,303,2,25,12,362
Santa Clara,589,0,42,337,42,50,46,517
Santa Clara,590,0,27,200,33,184,2,446
Santa Clara,591,0,68,536,19,61,68,752
Santa Clara,592,30,15,248,80,32,50,455
Santa Clara,593,0,100,181,1106,128,1284,2799
Santa Clara,594,0,42,274,11,13,105,445
Santa Clara,595,0,104,2810,0,87,10,3011
Santa Clara,596,0,19,527,9,101,4,660
Santa Clara,597,0,72,480,248,3,58,861
Santa Clara,598,0,139,367,21,88,30,645
Santa Clara,599,0,15,137,12,0,12,176
Santa Clara,600,0,11,201,4,10,4,230
Santa Clara,601,0,568,490,43,45,66,1212
Santa Clara,602,0,761,290,784,239,1432,3506
Santa Clara,603,8,740,754,1161,489,982,4134
Santa Clara,604,0,480,1848,2433,74,1109,5944
Santa Clara,605,0,1474,1365,6186,773,860,10658
Santa Clara,606,5,412,848,395,48,117,1825
Santa Clara,607,0,211,1618,95,2065,739,4728
Santa Clara,608,0,1367,1026,3557,220,1536,7706
Santa Clara,609,0,254,587,80,167,567,1655
Santa Clara,610,0,40,205,92,28,57,422
Santa Clara,611,0,116,913,66,56,77,1228
Santa Clara,612,0,287,619,599,70,30,1605
Santa Clara,613,0,67,393,56,87,7,610
Santa Clara,614,6,25,432,7,32,2,504
Santa Clara,615,0,25,306,9,7,23,370
Santa Clara,616,0,13,588,2,10,3,616
Santa Clara,617,0,13,307,8,59,8,395
Santa Clara,618,0,10,56,13,0,8,87
Santa Clara,619,0,21,272,2,0,4,299
Santa Clara,620,0,112,700,24,60,6,902
Santa Clara,621,5,18,347,17,171,15,573
Santa Clara,622,0,3,258,1,4,10,276
Santa Clara,623,0,7,219,8,3,28,265
Santa Clara,624,0,13,76,0,0,0,89
Santa Clara,625,0,37,547,6,88,12,690
Santa Clara,626,0,15,297,3,7,1,323
Santa Clara,627,0,62,421,4,160,75,722
Santa Clara,628,53,41,334,19,8,29,484
Santa Clara,629,0,25,315,5,8,72,425
Santa Clara,630,0,72,683,12,97,16,880
Santa Clara,631,0,2,773,8,7,18,808
Santa Clara,632,0,48,606,31,589,44,1318
Santa Clara,633,0,85,894,51,36,83,1149
Santa Clara,634,0,56,385,38,300,627,1406
Santa Clara,635,0,59,262,48,7,77,453
Santa Clara,636,0,55,369,4,215,48,691
Santa Clara,637,2,116,102,23,4,108,355
Santa Clara,638,0,48,206,2,19,36,311
Santa Clara,639,0,8,196,1,139,70,414
Santa Clara,640,0,7,278,0,8,34,327
Santa Clara,641,0,8,229,5,7,34,283
Santa Clara,642,0,31,132,2,0,40,205
Santa Clara,643,0,11,235,3,5,33,287
Santa Clara,644,0,28,416,23,184,13,664
Santa Clara,645,0,84,658,8,5,18,773
Santa Clara,646,0,7,214,0,2,1,224
Santa Clara,647,4,41,82,0,1,7,135
Santa Clara,648,0,48,207,4,12,6,277
Santa Clara,649,0,25,407,19,147,38,636
Santa Clara,650,0,75,515,7,67,8,672
Santa Clara,651,0,11,824,23,54,33,945
Santa Clara,652,0,56,347,12,61,101,577
Santa Clara,653,1,109,1231,45,130,37,1553
Santa Clara,654,0,65,293,1,4,44,407
Santa Clara,655,0,266,482,36,0,110,894
Santa Clara,656,0,1101,976,2367,87,726,5257
Santa Clara,657,0,117,342,28,66,25,578
Santa Clara,658,0,34,88,10,0,17,149
Santa Clara,659,0,187,323,29,38,5,582
Santa Clara,660,12,1118,1313,1719,366,498,5026
Santa Clara,661,0,508,4926,1665,602,55,7756
Santa Clara,662,0,29,120,0,2,30,181
Santa Clara,663,0,11,164,3,6,21,205
Santa Clara,664,0,29,263,13,5,27,337
Santa Clara,665,0,169,510,21,60,22,782
Santa Clara,666,0,84,159,9,0,59,311
Santa Clara,667,0,34,329,2,65,24,454
Santa Clara,668,0,22,202,134,3,20,381
Santa Clara,669,0,26,416,50,41,58,591
Santa Clara,670,0,27,536,12,14,73,662
Santa Clara,671,0,262,327,2,148,26,765
Santa Clara,672,0,55,187,28,31,11,312
Santa Clara,673,0,115,407,5,45,28,600
Santa Clara,674,0,75,650,8,147,31,911
Santa Clara,675,0,155,343,74,120,43,735
Santa Clara,676,0,224,1094,1144,294,226,2982
Santa Clara,677,0,192,1255,30,921,100,2498
Santa Clara,678,0,14,205,57,3,2,281
Santa Clara,679,2,38,597,56,423,27,1143
Santa Clara,680,0,94,402,14,767,96,1373
Santa Clara,681,0,116,521,28,165,43,873
Santa Clara,682,0,120,663,14,72,43,912
Santa Clara,683,0,34,113,2,118,7,274
Santa Clara,684,0,42,502,23,177,27,771
Santa Clara,685,0,49,277,22,20,40,408
Santa Clara,686,0,277,349,2,149,21,798
Santa Clara,687,0,104,704,30,1746,15,2599
Santa Clara,688,0,33,1803,23,126,20,2005
Santa Clara,689,0,47,154,5,55,24,285
Santa Clara,690,0,122,435,4,158,103,822
Santa Clara,691,0,17,196,10,75,23,321
Santa Clara,692,0,247,384,14,203,97,945
Santa Clara,693,0,25,303,5,23,1,357
Santa Clara,694,0,49,121,1,4,1,176
Santa Clara,695,0,120,194,1,0,74,389
Santa Clara,696,56,88,312,624,8,59,1147
Santa Clara,697,247,1211,173,143,28,113,1915
Santa Clara,698,46,75,755,52,406,91,1425
Santa Clara,699,253,139,109,40,71,44,656
Santa Clara,700,127,1133,1975,5461,899,1087,10682
Santa Clara,701,0,122,501,170,169,283,1245
Santa Clara,702,5,433,1719,135,242,452,2986
Santa Clara,703,14,93,140,11,9,64,331
Santa Clara,704,27,56,216,106,4,91,500
Santa Clara,705,86,97,1048,149,47,140,1567
Santa Clara,706,818,254,1562,1796,2090,564,7084
Santa Clara,707,35,383,1941,584,685,526,4154
Santa Clara,708,0,50,558,2,45,191,846
Santa Clara,709,2,169,775,49,257,168,1420
Santa Clara,710,17,476,502,3,127,35,1160
Santa Clara,711,15,111,229,25,14,152,546
Santa Clara,712,152,68,454,160,56,283,1173
Santa Clara,713,72,197,230,198,54,233,984
Santa Clara,714,16,2,98,13,118,5,252
Alameda,715,30,7031,1049,5527,891,2504,17032
Alameda,716,0,352,333,395,9,709,1798
Alameda,717,0,34,948,102,29,98,1211
Alameda,718,107,545,555,770,362,1324,3663
Alameda,719,12,42,194,49,20,34,351
Alameda,720,4,293,262,644,102,75,1380
Alameda,721,0,214,1179,50,1085,291,2819
Alameda,722,0,47,286,30,39,55,457
Alameda,723,0,187,1073,112,131,149,1652
Alameda,724,4,126,1650,34,413,71,2298
Alameda,725,0,62,250,145,58,87,602
Alameda,726,0,74,155,22,180,155,586
Alameda,727,8,12,195,0,0,13,228
Alameda,728,0,1088,1480,1888,1633,1154,7243
Alameda,729,9,608,2369,417,858,510,4771
Alameda,730,3,1553,2048,1049,1128,721,6502
Alameda,731,0,44,61,15,4,4,128
Alameda,732,0,443,1987,764,775,571,4540
Alameda,733,0,263,2592,186,1095,71,4207
Alameda,734,0,330,550,401,79,853,2213
Alameda,735,0,9,379,105,4,90,587
Alameda,736,0,2343,1343,211,1022,4755,9674
Alameda,737,0,673,691,1876,351,486,4077
Alameda,738,0,20,395,17,2,9,443
Alameda,739,0,1512,2248,774,404,1216,6154
Alameda,740,0,37,599,18,31,46,731
Alameda,741,0,93,520,21,175,27,836
Alameda,742,3,5927,5940,1711,1640,2059,17280
Alameda,743,125,815,747,591,136,948,3362
Alameda,744,0,48,1063,63,53,296,1523
Alameda,745,0,50,119,8,47,32,256
Alameda,746,36,299,738,154,111,117,1455
Alameda,747,3,36,219,4,6,21,289
Alameda,748,0,13,62,4,2,4,85
Alameda,749,0,160,268,805,39,18,1290
Alameda,750,0,1041,608,8830,868,419,11766
Alameda,751,0,2906,2273,15749,2760,3295,26983
Alameda,752,0,2170,2276,23702,802,1123,30073
Alameda,753,1,30,130,3,2,3,169
Alameda,754,12,64,969,75,25,7,1152
Alameda,755,0,294,599,151,34,378,1456
Alameda,756,9,372,339,254,58,531,1563
Alameda,757,0,5,129,8,11,12,165
Alameda,758,0,40,505,9,126,69,749
Alameda,759,0,37,123,53,44,10,267
Alameda,760,0,28,206,8,22,51,315
Alameda,761,0,883,1233,226,307,53,2702
Alameda,762,0,28,87,2,6,30,153
Alameda,763,0,1291,2136,7,23,57,3514
Alameda,764,0,46,918,50,584,42,1640
Alameda,765,0,48,513,16,146,16,739
Alameda,766,0,44,522,8,43,38,655
Alameda,767,0,701,1932,7188,931,216,10968
Alameda,768,24,2699,550,2458,328,235,6294
Alameda,769,0,859,350,403,6,147,1765
Alameda,770,0,123,857,125,230,51,1386
Alameda,771,0,191,693,5,324,47,1260
Alameda,772,0,12,67,18,53,58,208
Alameda,773,0,146,397,395,169,355,1462
Alameda,774,0,205,936,434,173,57,1805
Alameda,775,0,45,310,28,41,39,463
Alameda,776,0,206,620,37,6,17,886
Alameda,777,0,1191,2947,115,814,672,5739
Alameda,778,0,676,5065,19,17,122,5899
Alameda,779,0,39,102,31,4,13,189
Alameda,780,2,165,428,52,25,17,689
Alameda,781,0,45,162,37,4,24,272
Alameda,782,0,41,340,37,3,29,450
Alameda,783,0,9,40,95,0,3,147
Alameda,784,0,53,386,64,156,12,671
Alameda,785,0,22,359,37,31,11,460
Alameda,786,0,12,116,2,29,19,178
Alameda,787,0,54,455,40,115,23,687
Alameda,788,0,44,249,14,5,0,312
Alameda,789,0,19,171,17,9,40,256
Alameda,790,0,21,275,27,0,9,332
Alameda,791,3,184,633,47,125,8,1000
Alameda,792,0,5,84,2,0,5,96
Alameda,793,0,48,275,32,77,16,448
Alameda,794,0,47,69,30,25,0,171
Alameda,795,3,136,378,759,17,136,1429
Alameda,796,23,327,1887,2267,1197,267,5968
Alameda,797,0,2183,545,2709,234,596,6267
Alameda,798,0,119,409,1420,8,33,1989
Alameda,799,0,8,106,28,3,9,154
Alameda,800,0,29,1083,43,98,276,1529
Alameda,801,0,261,784,261,326,123,1755
Alameda,802,0,10,175,14,5,25,229
Alameda,803,2,15,499,3,16,0,535
Alameda,804,0,30,338,7,30,58,463
Alameda,805,0,40,248,5,39,65,397
Alameda,806,20,429,984,5226,602,968,8229
Alameda,807,0,13,91,46,52,19,221
Alameda,808,0,0,120,0,0,1,121
Alameda,809,0,197,212,1326,6,502,2243
Alameda,810,14,3597,2167,10591,2567,2519,21455
Alameda,811,0,143,1608,408,369,255,2783
Alameda,812,0,430,816,6,384,25,1661
Alameda,813,0,11,1146,15,0,1,1173
Alameda,814,0,2,205,19,62,8,296
Alameda,815,0,14,150,5,18,1,188
Alameda,816,0,3,399,2,119,0,523
Alameda,817,0,37,272,23,20,14,366
Alameda,818,0,5,510,3,3,34,555
Alameda,819,0,20,98,21,33,24,196
Alameda,820,2,47,610,143,56,8,866
Alameda,821,0,19,1766,9,29,21,1844
Alameda,822,0,12,203,6,3,31,255
Alameda,823,0,31,326,1,6,164,528
Alameda,824,0,175,416,34,457,91,1173
Alameda,825,0,17,102,8,7,29,163
Alameda,826,0,42,255,85,131,144,657
Alameda,827,0,64,1125,13,161,399,1762
Alameda,828,0,242,740,40,419,389,1830
Alameda,829,0,44,344,25,4,282,699
Alameda,830,0,2,283,4,159,31,479
Alameda,831,0,9,394,35,48,5,491
Alameda,832,0,44,465,13,33,16,571
Alameda,833,0,7,133,2,0,8,150
Alameda,834,0,53,218,678,31,52,1032
Alameda,835,0,28,290,12,72,59,461
Alameda,836,0,10,91,63,367,76,607
Alameda,837,0,41,479,3,30,312,865
Alameda,838,0,80,483,1,171,18,753
Alameda,839,0,304,1547,51,290,447,2639
Alameda,840,0,98,544,32,226,83,983
Alameda,841,0,21,460,13,25,42,561
Alameda,842,0,42,237,11,187,18,495
Alameda,843,0,36,214,7,11,6,274
Alameda,844,12,257,537,32,88,97,1023
Alameda,845,0,20,606,15,10,17,668
Alameda,846,0,76,490,69,116,32,783
Alameda,847,0,247,501,30,35,79,892
Alameda,848,0,181,2521,33,516,73,3324
Alameda,849,0,30,272,1,78,24,405
Alameda,850,0,41,65,2,1,26,135
Alameda,851,0,27,160,0,0,7,194
Alameda,852,0,12,252,10,47,31,352
Alameda,853,0,26,1300,5,15,25,1371
Alameda,854,0,12,307,11,61,15,406
Alameda,855,0,11,497,20,19,26,573
Alameda,856,0,41,748,16,529,101,1435
Alameda,857,0,29,756,11,142,25,963
Alameda,858,0,45,525,37,470,27,1104
Alameda,859,0,24,221,9,36,12,302
Alameda,860,0,205,976,2299,108,904,4492
Alameda,861,0,266,4635,235,42,64,5242
Alameda,862,0,777,980,1358,1312,1145,5572
Alameda,863,0,60,376,33,322,52,843
Alameda,864,0,123,1907,830,333,45,3238
Alameda,865,1,8,379,4,0,34,426
Alameda,866,0,14,468,2,7,27,518
Alameda,867,0,13,130,9,60,21,233
Alameda,868,0,37,241,5,7,25,315
Alameda,869,0,45,663,31,107,156,1002
Alameda,870,0,33,186,128,61,332,740
Alameda,871,5,787,2349,134,388,108,3771
Alameda,872,0,474,477,120,607,487,2165
Alameda,873,0,911,1024,4852,1678,1674,10139
Alameda,874,0,346,207,3193,0,14,3760
Alameda,875,121,2518,4079,6818,799,1458,15793
Alameda,876,0,0,65,34,0,45,144
Alameda,877,0,36,242,18,199,0,495
Alameda,878,0,94,423,182,36,27,762
Alameda,879,0,31,122,129,39,78,399
Alameda,880,0,0,248,6,4,42,300
Alameda,881,0,2,116,2,6,20,146
Alameda,882,0,9,384,1,117,5,516
Alameda,883,0,16,1022,0,5,12,1055
Alameda,884,0,40,275,12,8,24,359
Alameda,885,0,496,755,40,11,9,1311
Alameda,886,0,89,217,0,20,17,343
Alameda,887,0,271,393,1,17,0,682
Alameda,888,0,0,193,5,5,14,217
Alameda,889,0,7,173,0,2,1,183
Alameda,890,0,43,250,0,12,58,363
Alameda,891,0,18,166,0,9,14,207
Alameda,892,0,46,135,402,10,75,668
Alameda,893,4,79,136,90,34,145,488
Alameda,894,0,100,294,329,0,61,784
Alameda,895,0,388,1454,573,12,151,2578
Alameda,896,169,171,134,1753,341,227,2795
Alameda,897,0,73,174,12,172,5,436
Alameda,898,0,23,260,86,15,3,387
Alameda,899,0,13,550,11,16,11,601
Alameda,900,0,62,512,6,155,16,751
Alameda,901,0,10,132,0,1,3,146
Alameda,902,0,9,619,2,42,9,681
Alameda,903,0,16,144,2,14,13,189
Alameda,904,0,12,344,6,8,27,397
Alameda,905,0,16,293,2,15,19,345
Alameda,906,0,20,1823,26,133,23,2025
Alameda,907,0,47,139,55,19,49,309
Alameda,908,0,29,181,0,38,5,253
Alameda,909,0,26,288,3,10,30,357
Alameda,910,0,46,587,45,6,14,698
Alameda,911,0,41,549,0,122,22,734
Alameda,912,0,47,233,9,13,31,333
Alameda,913,0,298,574,62,273,47,1254
Alameda,914,0,87,172,141,5,11,416
Alameda,915,0,107,255,5,15,38,420
Alameda,916,0,95,799,31,325,21,1271
Alameda,917,2,78,224,2,91,144,541
Alameda,918,3,74,609,16,6,38,746
Alameda,919,0,8,38,18,0,3,67
Alameda,920,0,14,296,90,11,9,420
Alameda,921,0,48,248,13,7,13,329
Alameda,922,0,80,321,94,14,29,538
Alameda,923,1,72,332,25,242,29,701
Alameda,924,0,12,309,0,114,15,450
Alameda,925,0,168,519,7,95,24,813
Alameda,926,2,403,1886,571,506,270,3638
Alameda,927,0,52,650,6,26,3,737
Alameda,928,0,32,297,0,0,15,344
Alameda,929,0,2,360,16,10,17,405
Alameda,930,0,8,593,0,4,16,621
Alameda,931,0,14,2955,11,3,5,2988
Alameda,932,0,0,147,12,3,6,168
Alameda,933,0,9,499,54,26,26,614
Alameda,934,0,55,699,13,79,11,857
Alameda,935,0,0,175,0,2,0,177
Alameda,936,0,9,152,0,1,9,171
Alameda,937,0,21,247,17,188,55,528
Alameda,938,3,113,81,12,2,7,218
Alameda,939,13,216,636,57,153,54,1129
Alameda,940,0,73,360,22,59,12,526
Alameda,941,0,30,378,5,34,60,507
Alameda,942,0,186,831,17,83,45,1162
Alameda,943,0,30,377,35,15,10,467
Alameda,944,0,48,397,0,107,6,558
Alameda,945,0,1392,1489,2986,4,6762,12633
Alameda,946,0,209,1588,342,115,542,2796
Alameda,947,31,444,1765,590,339,381,3550
Alameda,948,0,107,455,61,76,544,1243
Alameda,949,25,27,647,149,196,47,1091
Alameda,950,0,142,812,12,184,42,1192
Alameda,951,0,66,341,42,31,23,503
Alameda,952,0,606,732,3446,19,1489,6292
Alameda,953,0,77,374,44,113,22,630
Alameda,954,0,66,951,13,740,4,1774
Alameda,955,0,14,1685,23,67,419,2208
Alameda,956,0,30,326,1,75,18,450
Alameda,957,0,28,727,5,0,4,764
Alameda,958,0,15,190,11,24,0,240
Alameda,959,0,46,337,4,168,16,571
Alameda,960,0,700,857,366,114,601,2638
Alameda,961,0,812,616,313,260,18,2019
Alameda,962,10,11,558,6,24,6,615
Alameda,963,0,37,425,19,10,223,714
Alameda,964,0,105,243,495,101,113,1057
Alameda,965,5,31,62,2398,18,77,2591
Alameda,966,0,63,503,455,5,75,1101
Alameda,967,9,632,1541,525,358,438,3503
Alameda,968,0,1105,3393,6593,221,1533,12845
Alameda,969,0,3595,2677,1198,291,1172,8933
Alameda,970,0,806,1637,83,57,3513,6096
Alameda,971,0,7801,4018,654,102,3526,16101
Alameda,972,0,426,1139,91,640,146,2442
Alameda,973,0,72,7365,26,28,34,7525
Alameda,974,0,139,1244,48,349,47,1827
Alameda,975,0,33,464,0,64,18,579
Alameda,976,0,197,823,88,236,147,1491
Alameda,977,0,149,2361,58,35,188,2791
Alameda,978,0,24,320,50,38,83,515
Alameda,979,0,272,4103,69,444,83,4971
Alameda,980,0,12,69,0,22,5,108
Alameda,981,0,0,228,0,6,0,234
Alameda,982,0,112,307,7,0,19,445
Alameda,983,0,4,203,0,10,12,229
Alameda,984,0,39,245,192,3,72,551
Alameda,985,0,1,223,94,19,3,340
Alameda,986,0,20,130,37,19,6,212
Alameda,987,0,40,128,10,2,3,183
Alameda,988,0,238,153,1618,1012,433,3454
Alameda,989,0,37,228,384,23,244,916
Alameda,990,0,49,172,240,22,86,569
Alameda,991,27,5280,4176,2820,1246,2471,16020
Alameda,992,0,27,126,47,7,110,317
Alameda,993,0,64,437,473,26,180,1180
Alameda,994,0,6,152,0,6,8,172
Alameda,995,0,27,448,33,18,10,536
Alameda,996,0,333,260,35,42,32,702
Alameda,997,0,25,46,33,8,134,246
Alameda,998,0,98,1021,74,203,91,1487
Alameda,999,0,114,574,0,351,23,1062
Alameda,1000,0,93,518,83,41,69,804
Alameda,1001,0,24,227,0,47,9,307
Alameda,1002,0,146,482,1,38,75,742
Alameda,1003,0,48,2559,9,223,14,2853
Alameda,1004,3,79,246,13,71,96,508
Alameda,1005,0,42,121,2,4,20,189
Alameda,1006,0,62,636,59,56,11,824
Alameda,1007,0,3,246,0,0,17,266
Alameda,1008,0,116,1264,17,300,36,1733
Alameda,1009,0,39,389,19,144,2,593
Alameda,1010,0,190,689,44,57,306,1286
Alameda,1011,0,189,641,9,389,49,1277
Alameda,1012,0,61,376,42,4,44,527
Alameda,1013,0,25,142,20,11,20,218
Alameda,1014,127,2278,3281,3323,1620,1368,11997
Alameda,1015,0,72,620,5,142,16,855
Alameda,1016,0,107,475,57,82,29,750
Alameda,1017,0,62,606,1,26,10,705
Alameda,1018,9,1443,3328,188,343,1032,6343
Alameda,1019,0,92,208,4,24,40,368
Alameda,1020,0,55,260,3,1,8,327
Alameda,1021,0,244,14018,22,78,144,14506
Alameda,1022,0,2511,188,98,100,3,2900
Alameda,1023,2,21,696,42,119,55,935
Alameda,1024,0,14,154,15,68,10,261
Alameda,1025,0,17,385,32,55,48,537
Alameda,1026,0,10,238,7,80,15,350
Alameda,1027,0,146,712,22,267,39,1186
Alameda,1028,0,42,64,3,0,35,144
Alameda,1029,0,595,87,7,3,79,771
Alameda,1030,0,7,132,3,7,4,153
Alameda,1031,0,43,131,4,23,19,220
Alameda,1032,0,6,115,0,1,11,133
Alameda,1033,0,182,569,63,139,28,981
Alameda,1034,0,42,196,1,152,19,410
Alameda,1035,0,40,397,0,19,21,477
Alameda,1036,0,50,430,5,32,48,565
Alameda,1037,0,31,246,30,103,6,416
Alameda,1038,9,48,437,0,271,145,910
Alameda,1039,0,52,481,43,142,139,857
Contra Costa,1040,0,6,190,2,50,5,253
Contra Costa,1041,0,172,516,16,435,2,1141
Contra Costa,1042,0,7,190,0,8,3,208
Contra Costa,1043,0,49,329,40,18,23,459
Contra Costa,1044,0,67,141,7,11,9,235
Contra Costa,1045,0,22,96,26,0,35,179
Contra Costa,1046,0,11,109,3,0,5,128
Contra Costa,1047,0,25,320,4,92,33,474
Contra Costa,1048,0,56,222,13,36,2,329
Contra Costa,1049,0,169,334,13,250,77,843
Contra Costa,1050,0,178,509,90,176,71,1024
Contra Costa,1051,0,122,988,8,631,250,1999
Contra Costa,1052,0,6,74,0,0,3,83
Contra Costa,1053,0,28,238,6,1,33,306
Contra Costa,1054,0,16,240,2,69,11,338
Contra Costa,1055,0,65,503,11,61,33,673
Contra Costa,1056,0,41,414,12,31,358,856
Contra Costa,1057,0,8,136,12,36,2,194
Contra Costa,1058,0,125,651,106,210,92,1184
Contra Costa,1059,41,1085,809,1442,1272,718,5367
Contra Costa,1060,4,72,444,330,16,72,938
Contra Costa,1061,0,19,505,37,125,86,772
Contra Costa,1062,39,954,508,2463,707,761,5432
Contra Costa,1063,0,17,1698,25,23,42,1805
Contra Costa,1064,0,7,150,9,32,43,241
Contra Costa,1065,0,15,378,49,42,30,514
Contra Costa,1066,0,100,1659,0,496,190,2445
Contra Costa,1067,0,21,277,39,50,71,458
Contra Costa,1068,0,190,265,396,58,363,1272
Contra Costa,1069,13,744,1200,2534,783,1611,6885
Contra Costa,1070,0,8,142,13,23,47,233
Contra Costa,1071,0,46,187,69,29,27,358
Contra Costa,1072,0,9,931,73,140,5,1158
Contra Costa,1073,1,9,269,10,8,14,311
Contra Costa,1074,0,122,967,30,834,110,2063
Contra Costa,1075,0,70,362,0,116,27,575
Contra Costa,1076,0,5,206,2,0,6,219
Contra Costa,1077,0,31,236,1,14,78,360
Contra Costa,1078,0,50,320,14,16,13,413
Contra Costa,1079,0,62,542,7,189,46,846
Contra Costa,1080,0,15,406,8,115,23,567
Contra Costa,1081,0,3,125,14,0,16,158
Contra Costa,1082,0,98,428,120,28,11,685
Contra Costa,1083,0,942,1460,650,184,254,3490
Contra Costa,1084,1,41,332,0,51,30,455
Contra Costa,1085,0,16,376,1,103,30,526
Contra Costa,1086,0,44,332,6,203,101,686
Contra Costa,1087,12,32,105,15,0,32,196
Contra Costa,1088,0,22,58,153,0,1,234
Contra Costa,1089,0,36,369,430,41,38,914
Contra Costa,1090,0,95,189,391,38,100,813
Contra Costa,1091,0,45,4186,40,150,20,4441
Contra Costa,1092,333,165,650,37,49,463,1697
Contra Costa,1093,0,62,249,8,7,3101,3427
Contra Costa,1094,0,73,203,87,23,2447,2833
Contra Costa,1095,0,410,163,859,129,1424,2985
Contra Costa,1096,0,456,586,528,627,965,3162
Contra Costa,1097,0,1921,1089,1995,521,3994,9520
Contra Costa,1098,0,107,258,30,247,43,685
Contra Costa,1099,0,435,290,44,34,95,898
Contra Costa,1100,6,43,639,12,244,60,1004
Contra Costa,1101,0,89,127,12,30,50,308
Contra Costa,1102,39,8,7,0,0,36,90
Contra Costa,1103,0,93,453,14,182,133,875
Contra Costa,1104,0,35,86,2,0,3,126
Contra Costa,1105,0,5,35,0,0,11,51
Contra Costa,1106,18,149,929,10,126,73,1305
Contra Costa,1107,0,64,242,0,14,15,335
Contra Costa,1108,0,47,303,29,468,45,892
Contra Costa,1109,0,27,1356,58,0,74,1515
Contra Costa,1110,27,199,598,19,321,22,1186
Contra Costa,1111,0,30,359,1,0,236,626
Contra Costa,1112,0,277,1097,25,55,65,1519
Contra Costa,1113,0,3992,2768,180,844,417,8201
Contra Costa,1114,0,32,151,14,131,27,355
Contra Costa,1115,0,27,163,35,162,65,452
Contra Costa,1116,0,1198,540,23,29,125,1915
Contra Costa,1117,0,78,113,1,2,25,219
Contra Costa,1118,0,376,1005,182,757,689,3009
Contra Costa,1119,0,68,471,35,170,117,861
Contra Costa,1120,0,63,320,9,233,34,659
Contra Costa,1121,0,3585,2971,242,1162,682,8642
Contra Costa,1122,4,2916,5055,1420,3388,1401,14184
Contra Costa,1123,0,337,820,52,706,185,2100
Contra Costa,1124,0,241,2570,4,117,236,3168
Contra Costa,1125,0,33,212,25,168,50,488
Contra Costa,1126,0,67,274,3,14,17,375
Contra Costa,1127,0,316,2451,11,57,70,2905
Contra Costa,1128,0,79,432,68,49,108,736
Contra Costa,1129,0,118,953,4,103,444,1622
Contra Costa,1130,0,68,196,8,7,16,295
Contra Costa,1131,6,109,80,12,9,67,283
Contra Costa,1132,9,94,532,9,11,52,707
Contra Costa,1133,0,291,358,79,114,185,1027
Contra Costa,1134,12,444,959,180,500,251,2346
Contra Costa,1135,0,183,467,8,17,35,710
Contra Costa,1136,0,969,1037,11,8,409,2434
Contra Costa,1137,5,1424,4520,610,1545,268,8372
Contra Costa,1138,0,163,563,14,18,112,870
Contra Costa,1139,5,11,119,10,2,4,151
Contra Costa,1140,0,210,931,6,240,12,1399
Contra Costa,1141,5,115,4532,89,144,24,4909
Contra Costa,1142,0,41,100,35,0,21,197
Contra Costa,1143,0,90,965,0,1,63,1119
Contra Costa,1144,2,329,438,47,61,63,940
Contra Costa,1145,6,6070,3743,615,1661,1114,13209
Contra Costa,1146,0,1125,7516,78,2162,140,11021
Contra Costa,1147,0,194,1015,11,170,166,1556
Contra Costa,1148,0,208,330,10,0,1,549
Contra Costa,1149,0,112,255,5,32,81,485
Contra Costa,1150,0,425,1329,37,552,163,2506
Contra Costa,1151,0,73,363,29,0,15,480
Contra Costa,1152,0,625,2507,146,635,240,4153
Contra Costa,1153,0,224,407,28,24,22,705
Contra Costa,1154,10,221,1029,66,188,184,1698
Contra Costa,1155,0,80,92,2,10,21,205
Contra Costa,1156,0,149,206,14,65,29,463
Contra Costa,1157,0,153,472,1,49,22,697
Contra Costa,1158,0,154,641,22,340,131,1288
Contra Costa,1159,0,29,740,6,17,11,803
Contra Costa,1160,11,136,413,16,0,65,641
Contra Costa,1161,2,1708,3096,226,968,815,6815
Contra Costa,1162,0,55,38,14,2,46,155
Contra Costa,1163,22,17,109,13,7,18,186
Contra Costa,1164,7,212,384,17,4,94,718
Contra Costa,1165,1,70,416,35,31,190,743
Contra Costa,1166,0,134,1352,38,54,77,1655
Contra Costa,1167,0,278,544,39,21,128,1010
Contra Costa,1168,16,7235,3295,1277,957,2935,15715
Contra Costa,1169,0,1028,751,89,770,575,3213
Contra Costa,1170,20,869,2320,180,625,628,4642
Contra Costa,1171,0,108,500,12,110,37,767
Contra Costa,1172,0,29,289,34,131,10,493
Contra Costa,1173,0,15,294,0,0,21,330
Contra Costa,1174,0,45,318,155,5,20,543
Contra Costa,1175,794,1310,978,418,96,59,3655
Contra Costa,1176,35,713,3027,163,528,282,4748
Contra Costa,1177,66,390,765,143,40,288,1692
Contra Costa,1178,32,591,5442,231,2031,686,9013
Contra Costa,1179,248,676,2999,490,795,1535,6743
Contra Costa,1180,13,89,676,87,60,279,1204
Contra Costa,1181,14,16,144,23,11,28,236
Contra Costa,1182,21,117,786,152,246,250,1572
Contra Costa,1183,0,156,166,829,97,301,1549
Contra Costa,1184,0,38,277,49,38,57,459
Contra Costa,1185,1,209,1399,100,958,254,2921
Contra Costa,1186,0,143,2193,26,460,171,2993
Contra Costa,1187,0,101,1219,9,297,40,1666
Contra Costa,1188,3,70,689,115,103,344,1324
Contra Costa,1189,0,496,2065,310,1500,366,4737
Contra Costa,1190,0,41,320,0,159,2,522
Contra Costa,1191,0,126,531,4,31,377,1069
Contra Costa,1192,0,7,197,1,0,15,220
Contra Costa,1193,0,59,446,17,210,16,748
Contra Costa,1194,0,29,255,3,17,20,324
Contra Costa,1195,0,110,711,19,128,151,1119
Contra Costa,1196,0,34,235,29,0,73,371
Contra Costa,1197,0,438,631,2,182,18,1271
Contra Costa,1198,0,12,1038,1,304,52,1407
Contra Costa,1199,0,169,1350,545,382,566,3012
Contra Costa,1200,0,45,306,2,9,54,416
Contra Costa,1201,0,61,163,64,16,18,322
Contra Costa,1202,0,36,154,36,118,11,355
Contra Costa,1203,0,20,704,3,3,332,1062
Contra Costa,1204,0,2,414,111,309,326,1162
Contra Costa,1205,2,76,246,613,1,197,1135
Contra Costa,1206,0,18,121,206,109,253,707
Contra Costa,1207,0,102,104,45,3,14,268
Contra Costa,1208,0,28,253,14,102,30,427
Contra Costa,1209,0,9,97,199,40,8,353
Contra Costa,1210,0,21,180,22,12,65,300
Solano,1211,98,0,529,3418,327,2148,6520
Solano,1212,0,0,816,40,40,366,1262
Solano,1213,0,0,347,0,140,32,519
Solano,1214,0,0,163,5,11,47,226
Solano,1215,0,0,328,2,216,11,557
Solano,1216,0,0,55,8,17,15,95
Solano,1217,56,0,767,53,9,205,1090
Solano,1218,0,0,73,7,2,6,88
Solano,1219,0,0,178,3,41,213,435
Solano,1220,0,0,244,82,118,25,469
Solano,1221,0,0,127,7,3,13,150
Solano,1222,0,0,435,54,0,10,499
Solano,1223,0,0,129,406,23,537,1095
Solano,1224,0,0,542,121,32,224,919
Solano,1225,13,0,53,8,37,125,236
Solano,1226,0,0,68,247,85,5,405
Solano,1227,0,0,137,23,38,13,211
Solano,1228,0,0,96,0,0,21,117
Solano,1229,0,0,424,6,137,15,582
Solano,1230,0,0,389,27,13,3,432
Solano,1231,0,0,293,27,60,15,395
Solano,1232,0,0,510,4,137,53,704
Solano,1233,0,0,197,1,16,4,218
Solano,1234,0,0,684,72,174,253,1183
Solano,1235,0,0,231,1,28,0,260
Solano,1236,0,0,942,2,43,4,991
Solano,1237,0,0,74,0,0,7,81
Solano,1238,0,0,882,320,0,287,1489
Solano,1239,0,0,52,0,0,12,64
Solano,1240,0,0,262,13,44,11,330
Solano,1241,0,0,2242,231,508,89,3070
Solano,1242,0,0,4001,6,66,6,4079
Solano,1243,0,0,1096,0,7,14,1117
Solano,1244,0,0,392,0,1,43,436
Solano,1245,0,0,91,36,12,7,146
Solano,1246,57,0,1250,62,1700,103,3172
Solano,1247,0,0,799,985,209,386,2379
Solano,1248,15,0,1449,136,601,526,2727
Solano,1249,18,0,1056,629,398,313,2414
Solano,1250,1,0,716,1673,699,551,3640
Solano,1251,0,0,634,127,279,361,1401
Solano,1252,0,0,706,83,44,182,1015
Solano,1253,0,0,69,1,10,25,105
Solano,1254,0,0,182,4,3,13,202
Solano,1255,43,0,333,0,33,3,412
Solano,1256,0,0,188,53,51,69,361
Solano,1257,0,0,244,0,5,2,251
Solano,1258,0,0,119,0,26,41,186
Solano,1259,0,0,522,412,142,26,1102
Solano,1260,0,0,93,4,10,12,119
Solano,1261,0,0,186,7,102,58,353
Solano,1262,0,0,692,59,43,2884,3678
Solano,1263,0,0,587,5,27,531,1150
Solano,1264,0,0,431,20,111,8,570
Solano,1265,0,0,2840,8,1046,31,3925
Solano,1266,0,0,569,25,191,30,815
Solano,1267,0,0,412,0,148,85,645
Solano,1268,8,0,1182,38,106,79,1413
Solano,1269,0,0,1329,8,697,84,2118
Solano,1270,0,0,925,1035,40,278,2278
Solano,1271,2,0,355,72,49,53,531
Solano,1272,0,0,1835,0,0,1098,2933
Solano,1273,0,0,348,28,131,53,560
Solano,1274,0,0,781,66,467,89,1403
Solano,1275,0,0,148,7,63,10,228
Solano,1276,0,0,270,10,111,11,402
Solano,1277,0,0,132,3,16,22,173
Solano,1278,0,0,206,0,91,26,323
Solano,1279,105,0,2301,2740,470,1690,7306
Solano,1280,9,0,2510,140,2053,107,4819
Solano,1281,0,0,605,164,496,34,1299
Solano,1282,5,0,1332,111,549,924,2921
Solano,1283,0,0,692,8,31,23,754
Solano,1284,0,0,1391,147,393,891,2822
Solano,1285,0,0,212,2,3,30,247
Solano,1286,516,0,46,21,8,276,867
Solano,1287,260,0,10,168,83,66,587
Solano,1288,179,0,696,56,360,213,1504
Solano,1289,72,0,1045,1180,573,336,3206
Solano,1290,317,0,686,156,257,248,1664
Napa,1291,62,63,887,297,620,42,1971
Napa,1292,134,805,1765,4323,211,1524,8762
Napa,1293,320,17,309,76,89,102,913
Napa,1294,30,61,2723,220,23,73,3130
Napa,1295,15,71,915,69,713,232,2015
Napa,1296,285,20,221,49,32,80,687
Napa,1297,156,83,1497,35,223,151,2145
Napa,1298,40,467,1568,799,572,126,3572
Napa,1299,51,241,1542,253,202,1936,4225
Napa,1300,2,78,384,241,26,76,807
Napa,1301,0,143,404,148,46,336,1077
Napa,1302,15,19,375,26,383,55,873
Napa,1303,2,10,80,8,2,21,123
Napa,1304,40,24,431,10,58,128,691
Napa,1305,93,187,1619,317,411,115,2742
Napa,1306,371,128,2830,215,628,153,4325
Napa,1307,32,22,532,103,18,49,756
Napa,1308,298,70,442,448,13,93,1364
Napa,1309,268,0,14,106,8,17,413
Napa,1310,12,31,1903,367,195,62,2570
Napa,1311,699,95,657,1408,10,144,3013
Napa,1312,203,9,73,33,0,40,358
Napa,1313,680,38,1317,1918,24,123,4100
Napa,1314,656,200,1518,1638,428,250,4690
Napa,1315,470,39,347,2202,50,657,3765
Napa,1316,202,8,20,262,27,29,548
Napa,1317,260,76,1441,393,146,157,2473
Sonoma,1318,164,102,724,304,97,68,1459
Sonoma,1319,48,134,391,97,109,188,967
Sonoma,1320,104,807,1275,233,296,230,2945
Sonoma,1321,48,117,194,117,16,178,670
Sonoma,1323,155,439,1995,245,515,413,3762
Sonoma,1324,408,624,271,1674,94,585,3656
Sonoma,1325,78,1321,1309,4235,413,414,7770
Sonoma,1326,11,107,293,3,22,59,495
Sonoma,1327,16,32,1230,49,8,310,1645
Sonoma,1328,283,35,256,62,11,219,866
Sonoma,1329,284,108,429,440,411,200,1872
Sonoma,1330,0,37,222,22,53,140,474
Sonoma,1331,2,201,613,351,480,243,1890
Sonoma,1332,14,589,2214,905,887,487,5096
Sonoma,1333,0,18,95,5,11,49,178
Sonoma,1334,0,23,186,32,11,57,309
Sonoma,1335,0,52,620,22,375,81,1150
Sonoma,1336,20,653,2309,1551,407,569,5509
Sonoma,1337,96,983,3605,1545,1007,1218,8454
Sonoma,1338,0,32,345,7,62,89,535
Sonoma,1339,0,29,236,62,294,44,665
Sonoma,1340,0,64,319,279,3,160,825
Sonoma,1341,18,18,228,21,5,47,337
Sonoma,1342,0,11,1353,24,28,22,1438
Sonoma,1343,0,9,380,1,16,20,426
Sonoma,1344,0,164,613,21,304,235,1337
Sonoma,1345,0,25,45,16,7,15,108
Sonoma,1346,0,406,1224,321,68,261,2280
Sonoma,1347,3,108,292,13,107,161,684
Sonoma,1348,79,385,1098,523,1917,430,4432
Sonoma,1349,6,124,712,56,307,67,1272
Sonoma,1350,6,174,531,28,288,152,1179
Sonoma,1351,0,29,313,1,0,63,406
Sonoma,1352,0,7,49,55,0,33,144
Sonoma,1353,40,15,232,252,83,14,636
Sonoma,1354,96,168,339,79,160,210,1052
Sonoma,1355,0,21,211,8,37,27,304
Sonoma,1356,0,51,544,38,338,52,1023
Sonoma,1357,0,39,274,11,62,32,418
Sonoma,1358,0,54,1503,3,209,63,1832
Sonoma,1359,0,75,3427,27,392,46,3967
Sonoma,1360,20,166,204,7,37,45,479
Sonoma,1361,3,1044,1322,142,705,1121,4337
Sonoma,1362,0,338,701,57,154,171,1421
Sonoma,1363,0,302,6609,0,190,1873,8974
Sonoma,1364,0,29,478,24,138,34,703
Sonoma,1365,0,99,776,21,49,1299,2244
Sonoma,1366,4,523,1918,2311,217,160,5133
Sonoma,1367,7,71,326,69,12,190,675
Sonoma,1368,137,1442,2889,4154,233,1111,9966
Sonoma,1369,13,172,1332,762,483,454,3216
Sonoma,1370,173,63,305,180,103,191,1015
Sonoma,1371,11,18,403,6,34,54,526
Sonoma,1372,3,7,175,4,14,40,243
Sonoma,1373,11,573,1063,242,191,311,2391
Sonoma,1374,9,687,1299,487,737,528,3747
Sonoma,1375,2,221,741,369,136,57,1526
Sonoma,1376,2,480,1015,154,193,227,2071
Sonoma,1377,10,266,542,26,328,92,1264
Sonoma,1378,0,83,814,299,222,143,1561
Sonoma,1379,0,15,166,0,59,42,282
Sonoma,1380,52,489,964,1178,1560,1403,5646
Sonoma,1381,86,687,1118,848,261,1095,4095
Sonoma,1382,207,68,739,207,29,136,1386
Sonoma,1383,314,74,220,403,60,163,1234
Sonoma,1384,21,398,1322,613,525,380,3259
Sonoma,1385,26,33,314,9,20,96,498
Sonoma,1386,77,219,697,172,305,119,1589
Sonoma,1387,96,88,157,36,2,168,547
Sonoma,1388,1,7,69,4,0,46,127
Sonoma,1389,59,55,760,50,66,94,1084
Sonoma,1390,69,33,239,27,26,49,443
Sonoma,1391,18,36,623,22,142,40,881
Sonoma,1392,97,26,154,327,23,74,701
Sonoma,1393,8,29,278,396,40,40,791
Sonoma,1394,182,321,510,370,0,139,1522
Sonoma,1395,82,540,1042,673,624,649,3610
Sonoma,1396,96,87,796,83,197,92,1351
Sonoma,1397,84,87,442,456,218,243,1530
Sonoma,1398,347,23,228,22,10,44,674
Sonoma,1399,29,305,2120,891,648,480,4473
Sonoma,1400,214,41,122,451,21,47,896
Sonoma,1401,1342,66,566,1146,33,122,3275
Sonoma,1402,61,109,695,822,233,219,2139
Sonoma,1403,59,55,311,64,44,70,603
Marin,1404,0,72,77,57,2,21,229
Marin,1405,0,178,901,50,889,269,2287
Marin,1406,2,389,316,198,13,1316,2234
Marin,1407,4,2197,1377,2083,178,445,6284
Marin,1408,0,98,441,49,205,79,872
Marin,1409,83,310,678,156,189,115,1531
Marin,1410,0,149,331,8,271,342,1101
Marin,1411,2,73,820,10,10,192,1107
Marin,1412,0,756,2057,214,471,698,4196
Marin,1413,0,321,375,120,55,27,898
Marin,1414,0,99,284,15,38,86,522
Marin,1415,278,140,713,242,107,218,1698
Marin,1416,26,11,220,20,4,47,328
Marin,1417,0,16,91,0,9,8,124
Marin,1418,4,41,273,25,10,52,405
Marin,1419,0,44,237,4,62,48,395
Marin,1420,2,62,465,10,81,218,838
Marin,1421,0,465,3809,68,465,186,4993
Marin,1422,0,246,1106,138,83,238,1811
Marin,1423,0,111,369,32,46,51,609
Marin,1424,0,1023,1638,329,116,469,3575
Marin,1425,0,513,951,17,51,2037,3569
Marin,1426,0,70,183,76,67,42,438
Marin,1427,0,530,1420,36,454,142,2582
Marin,1428,0,1472,1483,996,1940,1479,7370
Marin,1429,0,262,486,320,567,593,2228
Marin,1430,0,914,2589,108,500,916,5027
Marin,1431,0,180,472,55,81,108,896
Marin,1432,0,325,1142,72,215,268,2022
Marin,1433,0,92,204,9,4,34,343
Marin,1434,0,104,459,13,300,181,1057
Marin,1435,0,53,383,4,8,32,480
Marin,1436,0,148,1373,20,294,67,1902
Marin,1437,0,250,3023,50,194,32,3549
Marin,1438,0,1221,1224,283,978,336,4042
Marin,1439,0,1,17,0,0,1654,1672
Marin,1440,0,125,1187,62,102,141,1617
Marin,1441,0,332,1480,242,1010,286,3350
Marin,1442,6,205,686,65,292,86,1340
Marin,1443,1,198,1098,75,309,86,1767
Marin,1444,0,304,525,78,383,146,1436
Marin,1445,4,202,507,25,61,68,867
Marin,1446,0,199,642,34,53,170,1098
Marin,1447,0,120,130,2,69,73,394
Marin,1448,0,999,1555,286,667,451,3958
Marin,1449,0,8,250,0,84,14,356
Marin,1450,0,157,452,17,211,43,880
Marin,1451,0,376,462,15,44,80,977
Marin,1452,0,611,813,67,186,244,1921
Marin,1453,10,59,589,0,0,19,677
Marin,1454,52,65,249,15,37,49,467
