"TAZ1454","hispanic","white_nonh","black_nonh","asian_nonh","other_nonh","TOTPOP","COUNTY","County_Name"
1,9,19,0,33,3,64,1,"San Francisco"
2,45,96,0,164,15,320,1,"San Francisco"
3,71,151,0,257,24,503,1,"San Francisco"
4,14,24,7,37,3,85,1,"San Francisco"
5,134,227,69,356,24,810,1,"San Francisco"
6,797,1837,123,1056,136,3949,1,"San Francisco"
7,1201,1827,353,1417,212,5010,1,"San Francisco"
8,1928,1948,914,3407,429,8626,1,"San Francisco"
9,2110,3105,757,2474,604,9050,1,"San Francisco"
10,994,1110,428,1545,248,4325,1,"San Francisco"
11,451,1118,399,2054,133,4155,1,"San Francisco"
12,121,612,0,503,0,1236,1,"San Francisco"
13,1,7,0,6,0,14,1,"San Francisco"
14,26,135,0,110,0,271,1,"San Francisco"
15,37,185,0,152,0,374,1,"San Francisco"
16,371,2022,172,1793,92,4450,1,"San Francisco"
17,434,3929,134,2658,392,7547,1,"San Francisco"
18,149,767,193,445,147,1701,1,"San Francisco"
19,129,343,162,172,46,852,1,"San Francisco"
20,718,1353,485,1045,322,3923,1,"San Francisco"
21,381,1450,251,2634,90,4806,1,"San Francisco"
22,116,941,145,527,90,1819,1,"San Francisco"
23,173,342,100,137,140,892,1,"San Francisco"
24,9,66,0,434,19,528,1,"San Francisco"
25,7,196,37,3754,60,4054,1,"San Francisco"
26,38,160,1,1349,8,1556,1,"San Francisco"
27,44,595,67,2116,54,2876,1,"San Francisco"
28,163,1896,130,1092,94,3375,1,"San Francisco"
29,662,2678,112,1659,244,5355,1,"San Francisco"
30,2276,2923,812,1562,505,8078,1,"San Francisco"
31,434,1594,187,1435,264,3914,1,"San Francisco"
32,310,3104,259,1055,120,4848,1,"San Francisco"
33,284,2523,88,2070,33,4998,1,"San Francisco"
34,58,3075,67,1114,122,4436,1,"San Francisco"
35,542,2392,0,1812,181,4927,1,"San Francisco"
36,294,1062,4,4319,60,5739,1,"San Francisco"
37,122,1065,47,2022,39,3295,1,"San Francisco"
38,543,2481,1,1287,304,4616,1,"San Francisco"
39,405,2423,0,1446,104,4378,1,"San Francisco"
40,134,3595,34,486,97,4346,1,"San Francisco"
41,279,1867,135,1553,144,3978,1,"San Francisco"
42,871,713,439,314,236,2573,1,"San Francisco"
43,409,4310,70,592,39,5420,1,"San Francisco"
44,358,4867,99,715,307,6346,1,"San Francisco"
45,205,4067,2,571,195,5040,1,"San Francisco"
46,517,4859,122,1092,195,6785,1,"San Francisco"
47,102,1697,71,629,101,2600,1,"San Francisco"
48,234,2797,58,696,202,3987,1,"San Francisco"
49,169,2980,144,634,107,4034,1,"San Francisco"
50,550,3608,80,334,163,4735,1,"San Francisco"
51,197,2849,92,320,187,3645,1,"San Francisco"
52,397,3261,13,206,247,4124,1,"San Francisco"
53,3,177,2,33,17,232,1,"San Francisco"
54,285,2885,165,3369,356,7060,1,"San Francisco"
55,164,1619,21,1550,504,3858,1,"San Francisco"
56,3,48,16,30,2,99,1,"San Francisco"
57,103,1804,0,453,137,2497,1,"San Francisco"
58,293,1985,274,2609,237,5398,1,"San Francisco"
59,534,2794,58,4190,456,8032,1,"San Francisco"
60,302,1651,21,1960,117,4051,1,"San Francisco"
61,216,1728,0,1964,430,4338,1,"San Francisco"
62,379,3639,275,2472,356,7121,1,"San Francisco"
63,306,2252,53,2700,349,5660,1,"San Francisco"
64,577,2932,263,2666,661,7099,1,"San Francisco"
65,466,3055,12,1839,252,5624,1,"San Francisco"
66,277,2474,57,1678,133,4619,1,"San Francisco"
67,477,2508,106,1900,142,5133,1,"San Francisco"
68,311,1535,68,1111,206,3231,1,"San Francisco"
69,1086,4159,333,1999,729,8306,1,"San Francisco"
70,315,3600,97,1355,422,5789,1,"San Francisco"
71,290,3173,96,658,297,4514,1,"San Francisco"
72,244,1185,153,365,106,2053,1,"San Francisco"
73,241,2634,231,1089,100,4295,1,"San Francisco"
74,296,1946,116,1292,124,3774,1,"San Francisco"
75,238,1379,4,728,124,2473,1,"San Francisco"
76,228,1249,183,966,192,2818,1,"San Francisco"
77,488,1639,301,1780,139,4347,1,"San Francisco"
78,315,1173,1951,1640,478,5557,1,"San Francisco"
79,270,1918,143,815,95,3241,1,"San Francisco"
80,469,2471,642,720,283,4585,1,"San Francisco"
81,1276,4131,336,844,270,6857,1,"San Francisco"
82,337,2126,137,404,134,3138,1,"San Francisco"
83,269,3145,29,513,157,4113,1,"San Francisco"
84,550,3721,214,352,158,4995,1,"San Francisco"
85,413,2286,380,459,201,3739,1,"San Francisco"
86,727,3640,1540,1051,499,7457,1,"San Francisco"
87,629,3568,363,639,352,5551,1,"San Francisco"
88,420,4105,235,775,312,5847,1,"San Francisco"
89,484,5583,225,636,427,7355,1,"San Francisco"
90,421,2715,79,1126,441,4782,1,"San Francisco"
91,411,3231,74,944,260,4920,1,"San Francisco"
92,296,1129,245,645,194,2509,1,"San Francisco"
93,960,5228,155,1226,368,7937,1,"San Francisco"
94,181,2332,67,340,90,3010,1,"San Francisco"
95,384,2074,41,364,213,3076,1,"San Francisco"
96,236,1832,12,355,157,2592,1,"San Francisco"
97,472,2640,9,555,132,3808,1,"San Francisco"
98,447,2991,24,520,265,4247,1,"San Francisco"
99,950,2959,136,505,256,4806,1,"San Francisco"
100,2316,1576,84,677,133,4786,1,"San Francisco"
101,2241,2472,146,997,394,6250,1,"San Francisco"
102,760,3209,68,599,355,4991,1,"San Francisco"
103,324,3615,120,532,361,4952,1,"San Francisco"
104,417,2209,112,431,216,3385,1,"San Francisco"
105,1151,2953,414,1078,499,6095,1,"San Francisco"
106,2536,1919,346,881,275,5957,1,"San Francisco"
107,601,717,68,417,240,2043,1,"San Francisco"
108,131,365,59,378,36,969,1,"San Francisco"
109,1225,3070,547,3331,314,8487,1,"San Francisco"
110,404,856,183,1062,111,2616,1,"San Francisco"
111,187,1470,163,443,132,2395,1,"San Francisco"
112,340,1415,45,312,119,2231,1,"San Francisco"
113,1107,2615,681,1144,542,6089,1,"San Francisco"
114,290,2398,37,527,159,3411,1,"San Francisco"
115,802,644,68,281,90,1885,1,"San Francisco"
116,1980,2202,75,825,213,5295,1,"San Francisco"
117,2152,1756,90,554,94,4646,1,"San Francisco"
118,3332,1513,78,377,92,5392,1,"San Francisco"
119,1123,913,111,270,174,2591,1,"San Francisco"
120,1978,982,71,368,130,3529,1,"San Francisco"
121,702,2127,260,511,186,3786,1,"San Francisco"
122,1394,3616,107,587,284,5988,1,"San Francisco"
123,1101,2533,106,466,351,4557,1,"San Francisco"
124,1834,1587,88,452,209,4170,1,"San Francisco"
125,790,1248,106,997,108,3249,1,"San Francisco"
126,1871,1224,508,1253,191,5047,1,"San Francisco"
127,585,2793,125,430,129,4062,1,"San Francisco"
128,899,3236,192,496,292,5115,1,"San Francisco"
129,657,2473,279,697,266,4372,1,"San Francisco"
130,538,2195,403,1014,85,4235,1,"San Francisco"
131,797,3388,169,1931,569,6854,1,"San Francisco"
132,521,1833,58,1258,133,3803,1,"San Francisco"
133,1256,3056,161,1867,408,6748,1,"San Francisco"
134,3099,2046,100,3876,272,9393,1,"San Francisco"
135,2577,714,146,2207,292,5936,1,"San Francisco"
136,960,737,221,1202,148,3268,1,"San Francisco"
137,1050,933,105,3131,277,5496,1,"San Francisco"
138,2484,903,277,6130,173,9967,1,"San Francisco"
139,391,253,524,3872,129,5169,1,"San Francisco"
140,860,345,803,1864,44,3916,1,"San Francisco"
141,1229,273,752,672,19,2945,1,"San Francisco"
142,71,165,5,43,12,296,1,"San Francisco"
143,448,108,252,647,73,1528,1,"San Francisco"
144,739,183,2689,675,262,4548,1,"San Francisco"
145,401,133,1410,245,548,2737,1,"San Francisco"
146,89,82,230,108,4,513,1,"San Francisco"
147,2005,251,1332,562,346,4496,1,"San Francisco"
148,1175,154,856,592,655,3432,1,"San Francisco"
149,654,737,692,2502,223,4808,1,"San Francisco"
150,724,335,310,2023,37,3429,1,"San Francisco"
151,516,284,110,907,32,1849,1,"San Francisco"
152,823,1242,407,2275,122,4869,1,"San Francisco"
153,1601,431,406,2450,135,5023,1,"San Francisco"
154,946,186,73,2573,118,3896,1,"San Francisco"
155,686,128,307,2392,65,3578,1,"San Francisco"
156,826,112,359,1592,177,3066,1,"San Francisco"
157,1209,90,641,1307,199,3446,1,"San Francisco"
158,181,10,164,417,156,928,1,"San Francisco"
159,1360,675,92,2967,76,5170,1,"San Francisco"
160,2274,598,71,2295,92,5330,1,"San Francisco"
161,1948,512,93,2284,204,5041,1,"San Francisco"
162,1184,655,17,3155,57,5068,1,"San Francisco"
163,1524,619,14,2515,21,4693,1,"San Francisco"
164,1485,673,51,5236,328,7773,1,"San Francisco"
165,2002,581,81,4316,236,7216,1,"San Francisco"
166,1359,1698,958,6207,570,10792,1,"San Francisco"
167,1171,763,1028,3729,198,6889,1,"San Francisco"
168,1278,1624,1337,5723,643,10605,1,"San Francisco"
169,194,3212,173,2966,377,6922,1,"San Francisco"
170,687,3261,279,2252,186,6665,1,"San Francisco"
171,389,1304,16,694,125,2528,1,"San Francisco"
172,358,2658,150,2029,431,5626,1,"San Francisco"
173,295,1472,138,2063,135,4103,1,"San Francisco"
174,368,2484,118,2497,336,5803,1,"San Francisco"
175,626,1983,140,1260,336,4345,1,"San Francisco"
176,328,2135,28,1654,302,4447,1,"San Francisco"
177,937,3153,64,5464,625,10243,1,"San Francisco"
178,417,2426,1,3867,501,7212,1,"San Francisco"
179,592,2839,59,4922,603,9015,1,"San Francisco"
180,349,1918,124,1958,531,4880,1,"San Francisco"
181,354,2242,8,3372,211,6187,1,"San Francisco"
182,671,2403,129,3549,319,7071,1,"San Francisco"
183,454,1975,72,4647,349,7497,1,"San Francisco"
184,545,2533,98,6556,538,10270,1,"San Francisco"
185,444,2309,203,5255,386,8597,1,"San Francisco"
186,642,2617,60,4686,327,8332,1,"San Francisco"
187,136,1367,13,2315,121,3952,1,"San Francisco"
188,1139,1094,237,719,312,3501,1,"San Francisco"
189,1400,2860,684,2849,465,8258,1,"San Francisco"
190,163,899,77,401,71,1611,1,"San Francisco"
191,361,1444,13,1934,170,3922,2,"San Mateo"
192,1358,1009,637,3928,215,7147,2,"San Mateo"
193,1861,1546,120,3003,170,6700,2,"San Mateo"
194,1501,1083,104,4662,120,7470,2,"San Mateo"
195,902,1158,207,3661,545,6473,2,"San Mateo"
196,1366,948,553,3614,296,6777,2,"San Mateo"
197,570,596,68,4093,356,5683,2,"San Mateo"
198,1354,589,241,2803,188,5175,2,"San Mateo"
199,343,753,78,1174,242,2590,2,"San Mateo"
200,998,586,94,1151,108,2937,2,"San Mateo"
201,3436,881,285,3756,143,8501,2,"San Mateo"
202,2245,692,58,5050,180,8225,2,"San Mateo"
203,2569,323,187,2331,230,5640,2,"San Mateo"
204,2083,888,406,4270,120,7767,2,"San Mateo"
205,2529,708,312,4767,303,8619,2,"San Mateo"
206,680,562,272,2054,65,3633,2,"San Mateo"
207,1362,163,79,2352,397,4353,2,"San Mateo"
208,1067,2005,248,1560,578,5458,2,"San Mateo"
209,2902,1396,7,3266,354,7925,2,"San Mateo"
210,2075,352,67,647,245,3386,2,"San Mateo"
211,5722,1007,193,1036,533,8491,2,"San Mateo"
212,1999,490,71,1157,306,4023,2,"San Mateo"
213,1859,2649,122,2093,632,7355,2,"San Mateo"
214,1822,2050,45,2834,410,7161,2,"San Mateo"
215,2691,708,50,2545,214,6208,2,"San Mateo"
216,894,1131,110,1552,189,3876,2,"San Mateo"
217,1524,1183,34,1530,86,4357,2,"San Mateo"
218,521,656,32,2797,49,4055,2,"San Mateo"
219,949,700,75,5029,217,6970,2,"San Mateo"
220,1249,1614,251,2301,819,6234,2,"San Mateo"
221,1020,1463,169,1953,321,4926,2,"San Mateo"
222,809,1933,119,723,209,3793,2,"San Mateo"
223,788,2888,59,296,286,4317,2,"San Mateo"
224,667,2202,29,354,222,3474,2,"San Mateo"
225,644,2502,40,264,259,3709,2,"San Mateo"
226,745,4527,9,981,558,6820,2,"San Mateo"
227,1427,3503,39,578,291,5838,2,"San Mateo"
228,14,9,1,12,4,40,2,"San Mateo"
229,1207,1347,101,2461,567,5683,2,"San Mateo"
230,651,1004,330,6707,357,9049,2,"San Mateo"
231,668,849,218,3343,421,5499,2,"San Mateo"
232,1209,1933,66,1719,569,5496,2,"San Mateo"
233,1341,3349,38,2279,371,7378,2,"San Mateo"
234,351,984,154,1106,271,2866,2,"San Mateo"
235,689,1481,13,1017,81,3281,2,"San Mateo"
236,1412,3056,132,1214,51,5865,2,"San Mateo"
237,4068,1531,122,1744,839,8304,2,"San Mateo"
238,2151,1096,7,632,227,4113,2,"San Mateo"
239,0,0,0,0,0,0,2,"San Mateo"
240,1050,1131,23,2306,209,4719,2,"San Mateo"
241,354,1558,26,1599,205,3742,2,"San Mateo"
242,127,1196,9,1510,152,2994,2,"San Mateo"
243,179,1083,15,1330,121,2728,2,"San Mateo"
244,859,1572,43,2223,234,4931,2,"San Mateo"
245,378,1023,0,1898,104,3403,2,"San Mateo"
246,702,3710,162,2900,561,8035,2,"San Mateo"
247,344,2380,27,778,183,3712,2,"San Mateo"
248,456,1751,14,677,270,3168,2,"San Mateo"
249,740,3577,36,908,609,5870,2,"San Mateo"
250,496,2758,34,990,281,4559,2,"San Mateo"
251,699,3269,105,1236,204,5513,2,"San Mateo"
252,270,3737,44,1666,254,5971,2,"San Mateo"
253,212,1866,48,428,148,2702,2,"San Mateo"
254,293,3210,114,1693,207,5517,2,"San Mateo"
255,184,2442,29,563,177,3395,2,"San Mateo"
256,678,2866,116,1167,317,5144,2,"San Mateo"
257,1040,1962,71,911,182,4166,2,"San Mateo"
258,1454,2204,121,1172,508,5459,2,"San Mateo"
259,2198,2326,161,812,139,5636,2,"San Mateo"
260,4890,1253,533,1351,600,8627,2,"San Mateo"
261,2078,1283,120,801,541,4823,2,"San Mateo"
262,1571,1100,45,687,767,4170,2,"San Mateo"
263,1155,1078,112,478,338,3161,2,"San Mateo"
264,850,1343,45,863,392,3493,2,"San Mateo"
265,152,1651,13,1089,116,3021,2,"San Mateo"
266,557,2382,110,3882,259,7190,2,"San Mateo"
267,236,2000,45,1505,228,4014,2,"San Mateo"
268,95,1635,124,1785,154,3793,2,"San Mateo"
269,393,1585,195,2148,276,4597,2,"San Mateo"
270,193,1069,83,1660,191,3196,2,"San Mateo"
271,125,1700,67,1399,247,3538,2,"San Mateo"
272,137,1066,57,1557,114,2931,2,"San Mateo"
273,213,1555,26,1887,110,3791,2,"San Mateo"
274,1772,1817,179,1690,557,6015,2,"San Mateo"
275,815,1631,40,1950,219,4655,2,"San Mateo"
276,539,1333,17,853,115,2857,2,"San Mateo"
277,1154,2513,70,883,309,4929,2,"San Mateo"
278,1070,1557,165,1461,331,4584,2,"San Mateo"
279,1124,1503,70,781,158,3636,2,"San Mateo"
280,769,1947,6,628,178,3528,2,"San Mateo"
281,1115,1994,77,1161,269,4616,2,"San Mateo"
282,161,1502,1,674,160,2498,2,"San Mateo"
283,464,2255,0,785,201,3705,2,"San Mateo"
284,1186,1891,71,1304,122,4574,2,"San Mateo"
285,210,1912,18,761,155,3056,2,"San Mateo"
286,607,4338,104,1383,551,6983,2,"San Mateo"
287,259,1554,39,438,160,2450,2,"San Mateo"
288,953,3652,36,1811,352,6804,2,"San Mateo"
289,519,3785,47,1484,273,6108,2,"San Mateo"
290,302,1985,31,842,362,3522,2,"San Mateo"
291,35,1886,37,1152,203,3313,2,"San Mateo"
292,226,1260,33,675,215,2409,2,"San Mateo"
293,1429,4916,16,85,253,6699,2,"San Mateo"
294,1708,4536,0,312,169,6725,2,"San Mateo"
295,1851,2664,25,226,119,4885,2,"San Mateo"
296,2607,5763,0,411,504,9285,2,"San Mateo"
297,742,2896,27,32,207,3904,2,"San Mateo"
298,327,5560,22,427,572,6908,2,"San Mateo"
299,288,2599,0,161,73,3121,2,"San Mateo"
300,194,2439,2,161,102,2898,2,"San Mateo"
301,552,4940,0,471,355,6318,2,"San Mateo"
302,358,3727,57,203,260,4605,2,"San Mateo"
303,799,3184,79,521,160,4743,2,"San Mateo"
304,346,3879,21,696,251,5193,2,"San Mateo"
305,121,1416,0,326,126,1989,2,"San Mateo"
306,189,2394,7,648,177,3415,2,"San Mateo"
307,646,3302,1,793,175,4917,2,"San Mateo"
308,434,3484,13,415,179,4525,2,"San Mateo"
309,1092,5350,90,1158,463,8153,2,"San Mateo"
310,460,919,23,248,157,1807,2,"San Mateo"
311,442,2154,183,1732,214,4725,2,"San Mateo"
312,609,3493,34,3762,544,8442,2,"San Mateo"
313,1414,970,39,350,83,2856,2,"San Mateo"
314,4291,678,214,421,144,5748,2,"San Mateo"
315,1430,1001,142,521,144,3238,2,"San Mateo"
316,1047,978,53,99,68,2245,2,"San Mateo"
317,1480,3198,36,676,219,5609,2,"San Mateo"
318,300,2147,0,280,132,2859,2,"San Mateo"
319,649,2431,1,143,146,3370,2,"San Mateo"
320,2205,2958,211,499,282,6155,2,"San Mateo"
321,582,1917,11,184,72,2766,2,"San Mateo"
322,757,3704,11,548,279,5299,2,"San Mateo"
323,1769,2728,78,774,198,5547,2,"San Mateo"
324,2857,1183,153,441,90,4724,2,"San Mateo"
325,3794,2036,49,612,172,6663,2,"San Mateo"
326,2940,317,63,136,233,3689,2,"San Mateo"
327,5108,566,54,406,77,6211,2,"San Mateo"
328,1911,1705,33,263,65,3977,2,"San Mateo"
329,3794,727,32,339,289,5181,2,"San Mateo"
330,4012,1084,298,276,273,5943,2,"San Mateo"
331,3174,423,1153,175,585,5510,2,"San Mateo"
332,2651,136,640,75,728,4230,2,"San Mateo"
333,5539,1337,1149,658,1370,10053,2,"San Mateo"
334,5083,166,932,103,1055,7339,2,"San Mateo"
335,5475,1570,431,592,859,8927,2,"San Mateo"
336,541,3261,53,1045,296,5196,2,"San Mateo"
337,216,777,169,114,170,1446,2,"San Mateo"
338,172,1711,51,284,158,2376,2,"San Mateo"
339,130,1895,0,483,134,2642,2,"San Mateo"
340,424,3139,38,436,270,4307,2,"San Mateo"
341,204,3340,12,851,212,4619,2,"San Mateo"
342,242,3174,23,773,203,4415,2,"San Mateo"
343,116,1757,1,171,76,2121,2,"San Mateo"
344,208,2784,4,263,159,3418,2,"San Mateo"
345,209,3010,112,1005,234,4570,2,"San Mateo"
346,111,2491,2,832,166,3602,2,"San Mateo"
347,248,4820,38,2177,303,7586,3,"Santa Clara"
348,0,0,0,0,0,0,3,"Santa Clara"
349,22,508,10,189,37,766,3,"Santa Clara"
350,362,1852,51,413,253,2931,3,"Santa Clara"
351,188,3168,29,1199,592,5176,3,"Santa Clara"
352,128,398,57,237,94,914,3,"Santa Clara"
353,460,2021,62,2170,208,4921,3,"Santa Clara"
354,384,1195,172,713,282,2746,3,"Santa Clara"
355,794,3454,232,1581,397,6458,3,"Santa Clara"
356,631,5240,136,1406,493,7906,3,"Santa Clara"
357,151,3309,106,1194,230,4990,3,"Santa Clara"
358,321,3066,48,1870,190,5495,3,"Santa Clara"
359,289,2131,33,837,203,3493,3,"Santa Clara"
360,239,2941,33,2117,184,5514,3,"Santa Clara"
361,77,3278,51,2609,545,6560,3,"Santa Clara"
362,314,2854,45,2640,114,5967,3,"Santa Clara"
363,260,1180,0,966,47,2453,3,"Santa Clara"
364,144,1039,46,568,131,1928,3,"Santa Clara"
365,397,1509,164,1776,170,4016,3,"Santa Clara"
366,485,2371,166,2069,148,5239,3,"Santa Clara"
367,1226,3240,0,2032,141,6639,3,"Santa Clara"
368,245,2737,50,1331,155,4518,3,"Santa Clara"
369,128,2993,5,1320,328,4774,3,"Santa Clara"
370,149,2836,13,1153,142,4293,3,"Santa Clara"
371,143,1907,20,878,318,3266,3,"Santa Clara"
372,2070,2222,101,2478,114,6985,3,"Santa Clara"
373,425,2053,38,491,379,3386,3,"Santa Clara"
374,1213,1232,49,804,149,3447,3,"Santa Clara"
375,736,1551,143,928,155,3513,3,"Santa Clara"
376,787,1950,99,1531,263,4630,3,"Santa Clara"
377,423,2905,43,1385,278,5034,3,"Santa Clara"
378,314,1956,55,853,158,3336,3,"Santa Clara"
379,1840,1995,129,1233,270,5467,3,"Santa Clara"
380,1811,1725,95,1404,135,5170,3,"Santa Clara"
381,529,3025,0,1693,366,5613,3,"Santa Clara"
382,255,1511,142,925,186,3019,3,"Santa Clara"
383,93,1196,0,474,127,1890,3,"Santa Clara"
384,213,3015,0,1058,320,4606,3,"Santa Clara"
385,110,1897,5,614,177,2803,3,"Santa Clara"
386,117,1893,0,719,182,2911,3,"Santa Clara"
387,234,2174,24,1081,203,3716,3,"Santa Clara"
388,329,3625,25,2104,324,6407,3,"Santa Clara"
389,571,2725,33,1405,247,4981,3,"Santa Clara"
390,449,1669,52,788,163,3121,3,"Santa Clara"
391,1143,2630,129,3005,203,7110,3,"Santa Clara"
392,1204,1696,54,2067,75,5096,3,"Santa Clara"
393,1015,1614,48,1589,161,4427,3,"Santa Clara"
394,815,1531,0,1337,316,3999,3,"Santa Clara"
395,491,1251,94,2881,144,4861,3,"Santa Clara"
396,1,2,0,4,0,7,3,"Santa Clara"
397,84,745,21,734,102,1686,3,"Santa Clara"
398,584,1497,0,874,170,3125,3,"Santa Clara"
399,1,1,0,1,0,3,3,"Santa Clara"
400,888,1839,42,1602,194,4565,3,"Santa Clara"
401,226,460,20,176,23,905,3,"Santa Clara"
402,101,371,198,8,57,735,3,"Santa Clara"
403,12,5,1,5,0,23,3,"Santa Clara"
404,1101,454,82,439,36,2112,3,"Santa Clara"
405,20,8,1,8,1,38,3,"Santa Clara"
406,10,42,4,82,3,141,3,"Santa Clara"
407,10,59,3,140,4,216,3,"Santa Clara"
408,1,5,0,12,0,18,3,"Santa Clara"
409,0,0,0,0,0,0,3,"Santa Clara"
410,500,2494,189,5503,169,8855,3,"Santa Clara"
411,0,0,0,0,0,0,3,"Santa Clara"
412,3359,3707,746,6669,656,15137,3,"Santa Clara"
413,358,2622,240,6618,597,10435,3,"Santa Clara"
414,938,1073,208,1705,153,4077,3,"Santa Clara"
415,408,429,19,1113,53,2022,3,"Santa Clara"
416,919,1836,566,4688,172,8181,3,"Santa Clara"
417,0,0,0,0,0,0,3,"Santa Clara"
418,386,765,69,664,84,1968,3,"Santa Clara"
419,877,464,59,2093,40,3533,3,"Santa Clara"
420,895,639,52,1296,208,3090,3,"Santa Clara"
421,1007,3544,253,2217,149,7170,3,"Santa Clara"
422,1101,1444,76,3224,241,6086,3,"Santa Clara"
423,2127,990,113,1849,233,5312,3,"Santa Clara"
424,3677,2102,147,1760,334,8020,3,"Santa Clara"
425,1252,964,26,1421,114,3777,3,"Santa Clara"
426,1309,1325,168,2260,119,5181,3,"Santa Clara"
427,112,126,21,194,17,470,3,"Santa Clara"
428,144,345,0,690,20,1199,3,"Santa Clara"
429,0,0,0,0,0,0,3,"Santa Clara"
430,9,2,0,1,2,14,3,"Santa Clara"
431,3,4,1,4,1,13,3,"Santa Clara"
432,308,119,6,55,79,567,3,"Santa Clara"
433,1985,1570,268,1589,374,5786,3,"Santa Clara"
434,49,13,0,0,0,62,3,"Santa Clara"
435,1213,769,129,1310,152,3573,3,"Santa Clara"
436,1175,1810,183,916,211,4295,3,"Santa Clara"
437,1425,2060,231,2103,172,5991,3,"Santa Clara"
438,883,1379,183,1249,311,4005,3,"Santa Clara"
439,640,1187,43,1010,217,3097,3,"Santa Clara"
440,1727,1695,125,2913,456,6916,3,"Santa Clara"
441,736,1364,149,4083,234,6566,3,"Santa Clara"
442,828,1191,86,1241,99,3445,3,"Santa Clara"
443,1036,1156,348,2272,192,5004,3,"Santa Clara"
444,848,2128,200,2505,134,5815,3,"Santa Clara"
445,1121,2437,286,4518,420,8782,3,"Santa Clara"
446,979,2063,117,4206,383,7748,3,"Santa Clara"
447,252,2023,0,2165,131,4571,3,"Santa Clara"
448,1645,1512,134,5077,522,8890,3,"Santa Clara"
449,637,1793,27,4705,192,7354,3,"Santa Clara"
450,987,1972,124,1436,229,4748,3,"Santa Clara"
451,719,3079,0,2457,339,6594,3,"Santa Clara"
452,118,1454,7,1184,298,3061,3,"Santa Clara"
453,518,3221,33,3059,192,7023,3,"Santa Clara"
454,110,2168,50,1924,212,4464,3,"Santa Clara"
455,44,1383,23,994,92,2536,3,"Santa Clara"
456,682,2470,370,4395,513,8430,3,"Santa Clara"
457,265,1595,70,3180,211,5321,3,"Santa Clara"
458,323,1304,24,2388,164,4203,3,"Santa Clara"
459,898,2742,184,3722,511,8057,3,"Santa Clara"
460,112,750,0,1978,238,3078,3,"Santa Clara"
461,783,1607,116,1566,366,4438,3,"Santa Clara"
462,314,1662,70,2594,201,4841,3,"Santa Clara"
463,429,1710,113,1631,155,4038,3,"Santa Clara"
464,850,2283,192,1200,85,4610,3,"Santa Clara"
465,762,3779,190,1808,289,6828,3,"Santa Clara"
466,1131,2216,18,508,205,4078,3,"Santa Clara"
467,1414,2264,421,866,261,5226,3,"Santa Clara"
468,2144,2480,277,749,208,5858,3,"Santa Clara"
469,3069,1561,402,1844,535,7411,3,"Santa Clara"
470,1352,3432,18,1638,172,6612,3,"Santa Clara"
471,719,2392,501,1649,230,5491,3,"Santa Clara"
472,1118,1474,42,2131,271,5036,3,"Santa Clara"
473,2449,2099,876,1135,305,6864,3,"Santa Clara"
474,1055,1545,213,1203,256,4272,3,"Santa Clara"
475,871,1700,135,1643,207,4556,3,"Santa Clara"
476,466,2975,126,3126,334,7027,3,"Santa Clara"
477,446,1395,20,3842,117,5820,3,"Santa Clara"
478,885,852,253,4439,107,6536,3,"Santa Clara"
479,676,2638,240,5570,239,9363,3,"Santa Clara"
480,81,727,33,2187,187,3215,3,"Santa Clara"
481,152,1333,49,3285,131,4950,3,"Santa Clara"
482,56,1134,20,3217,49,4476,3,"Santa Clara"
483,304,1149,0,4677,164,6294,3,"Santa Clara"
484,217,1927,2,5485,214,7845,3,"Santa Clara"
485,236,1638,1,4810,128,6813,3,"Santa Clara"
486,214,758,55,4363,192,5582,3,"Santa Clara"
487,318,1885,96,3485,305,6089,3,"Santa Clara"
488,235,2984,15,4557,289,8080,3,"Santa Clara"
489,80,1621,0,4295,47,6043,3,"Santa Clara"
490,187,1088,0,2410,109,3794,3,"Santa Clara"
491,95,546,0,2542,119,3302,3,"Santa Clara"
492,54,1095,24,3959,176,5308,3,"Santa Clara"
493,111,1919,34,3468,214,5746,3,"Santa Clara"
494,103,1633,16,4099,60,5911,3,"Santa Clara"
495,147,3094,139,2115,134,5629,3,"Santa Clara"
496,169,1839,3,780,140,2931,3,"Santa Clara"
497,369,3061,0,2871,314,6615,3,"Santa Clara"
498,314,2374,25,1174,255,4142,3,"Santa Clara"
499,618,4040,10,2494,302,7464,3,"Santa Clara"
500,656,2089,0,990,196,3931,3,"Santa Clara"
501,507,2139,46,1024,300,4016,3,"Santa Clara"
502,926,2083,52,1163,265,4489,3,"Santa Clara"
503,1857,2887,125,1079,284,6232,3,"Santa Clara"
504,716,2615,309,419,238,4297,3,"Santa Clara"
505,1251,3389,145,1171,278,6234,3,"Santa Clara"
506,481,2159,197,841,225,3903,3,"Santa Clara"
507,214,3402,0,836,161,4613,3,"Santa Clara"
508,341,2003,16,458,139,2957,3,"Santa Clara"
509,519,2168,80,186,69,3022,3,"Santa Clara"
510,115,1874,0,483,49,2521,3,"Santa Clara"
511,392,5793,71,417,143,6816,3,"Santa Clara"
512,233,3975,17,135,141,4501,3,"Santa Clara"
513,97,2305,55,287,180,2924,3,"Santa Clara"
514,389,5934,36,1118,373,7850,3,"Santa Clara"
515,857,4398,21,1585,311,7172,3,"Santa Clara"
516,243,2372,14,817,162,3608,3,"Santa Clara"
517,794,3523,55,1089,207,5668,3,"Santa Clara"
518,701,4131,55,743,222,5852,3,"Santa Clara"
519,950,4111,210,1863,307,7441,3,"Santa Clara"
520,867,2437,40,639,332,4315,3,"Santa Clara"
521,1153,2406,244,848,260,4911,3,"Santa Clara"
522,1356,3288,164,1129,131,6068,3,"Santa Clara"
523,1485,4408,23,1244,434,7594,3,"Santa Clara"
524,1011,3193,147,621,338,5310,3,"Santa Clara"
525,520,2847,0,391,237,3995,3,"Santa Clara"
526,1005,4657,142,640,208,6652,3,"Santa Clara"
527,1413,4724,74,542,315,7068,3,"Santa Clara"
528,1595,3768,134,571,341,6409,3,"Santa Clara"
529,350,1957,0,348,132,2787,3,"Santa Clara"
530,1180,3639,255,949,457,6480,3,"Santa Clara"
531,508,1915,5,428,154,3010,3,"Santa Clara"
532,2184,2588,466,1440,550,7228,3,"Santa Clara"
533,4090,1781,333,974,286,7464,3,"Santa Clara"
534,956,2555,181,1026,317,5035,3,"Santa Clara"
535,2757,1563,270,541,427,5558,3,"Santa Clara"
536,3575,1032,229,451,212,5499,3,"Santa Clara"
537,1864,2061,228,1231,257,5641,3,"Santa Clara"
538,922,1500,220,616,185,3443,3,"Santa Clara"
539,222,74,53,80,25,454,3,"Santa Clara"
540,1102,2529,306,759,469,5165,3,"Santa Clara"
541,1066,3091,53,919,165,5294,3,"Santa Clara"
542,1037,1186,66,212,83,2584,3,"Santa Clara"
543,920,2454,213,1247,349,5183,3,"Santa Clara"
544,2035,2891,189,1417,476,7008,3,"Santa Clara"
545,942,2093,162,924,154,4275,3,"Santa Clara"
546,2355,1472,297,1156,252,5532,3,"Santa Clara"
547,4566,985,205,2031,169,7956,3,"Santa Clara"
548,4772,2302,417,1497,521,9509,3,"Santa Clara"
549,1925,1110,303,944,289,4571,3,"Santa Clara"
550,2538,881,163,548,254,4384,3,"Santa Clara"
551,4645,801,154,875,160,6635,3,"Santa Clara"
552,3367,304,23,1223,8,4925,3,"Santa Clara"
553,3568,477,88,734,27,4894,3,"Santa Clara"
554,1059,2342,209,730,233,4573,3,"Santa Clara"
555,3471,2022,219,1067,589,7368,3,"Santa Clara"
556,1365,1385,374,1703,401,5228,3,"Santa Clara"
557,701,1356,398,1555,200,4210,3,"Santa Clara"
558,1309,1431,257,811,48,3856,3,"Santa Clara"
559,2639,2099,70,309,411,5528,3,"Santa Clara"
560,4356,799,51,91,13,5310,3,"Santa Clara"
561,2151,661,166,843,39,3860,3,"Santa Clara"
562,4144,420,193,385,32,5174,3,"Santa Clara"
563,6355,2017,518,3039,403,12332,3,"Santa Clara"
564,2793,1853,151,2850,192,7839,3,"Santa Clara"
565,506,2297,140,1955,477,5375,3,"Santa Clara"
566,1158,2745,88,2019,321,6331,3,"Santa Clara"
567,3838,280,69,4506,267,8960,3,"Santa Clara"
568,5246,559,180,2789,396,9170,3,"Santa Clara"
569,3153,214,145,983,226,4721,3,"Santa Clara"
570,3825,188,0,1030,14,5057,3,"Santa Clara"
571,2899,320,128,1334,103,4784,3,"Santa Clara"
572,1573,346,67,2287,80,4353,3,"Santa Clara"
573,806,192,134,2967,325,4424,3,"Santa Clara"
574,1634,399,19,2816,114,4982,3,"Santa Clara"
575,1217,323,180,2604,78,4402,3,"Santa Clara"
576,1335,361,125,2626,224,4671,3,"Santa Clara"
577,2432,189,239,2575,104,5539,3,"Santa Clara"
578,4368,457,310,3482,177,8794,3,"Santa Clara"
579,573,140,0,1690,63,2466,3,"Santa Clara"
580,3490,96,19,1624,16,5245,3,"Santa Clara"
581,4053,68,66,1853,78,6118,3,"Santa Clara"
582,3011,398,254,3232,128,7023,3,"Santa Clara"
583,2580,211,93,3127,119,6130,3,"Santa Clara"
584,2552,127,109,1252,41,4081,3,"Santa Clara"
585,3334,80,32,672,485,4603,3,"Santa Clara"
586,4560,20,5,1547,155,6287,3,"Santa Clara"
587,1849,51,11,683,2,2596,3,"Santa Clara"
588,3812,208,91,2223,115,6449,3,"Santa Clara"
589,3783,334,177,2049,106,6449,3,"Santa Clara"
590,2915,80,126,1116,45,4282,3,"Santa Clara"
591,7278,416,106,1523,236,9559,3,"Santa Clara"
592,2779,268,249,1813,83,5192,3,"Santa Clara"
593,1606,698,0,660,164,3128,3,"Santa Clara"
594,3284,217,310,2178,182,6171,3,"Santa Clara"
595,3469,458,91,2810,203,7031,3,"Santa Clara"
596,585,159,36,2036,56,2872,3,"Santa Clara"
597,1841,148,66,4287,58,6400,3,"Santa Clara"
598,1300,1110,149,4650,201,7410,3,"Santa Clara"
599,945,615,140,3436,86,5222,3,"Santa Clara"
600,363,509,0,3846,230,4948,3,"Santa Clara"
601,617,746,237,5191,309,7100,3,"Santa Clara"
602,459,159,13,1331,0,1962,3,"Santa Clara"
603,183,48,6,156,2,395,3,"Santa Clara"
604,1489,390,48,1270,14,3211,3,"Santa Clara"
605,1393,1317,419,8268,312,11709,3,"Santa Clara"
606,802,868,14,5879,281,7844,3,"Santa Clara"
607,1129,589,306,3549,311,5884,3,"Santa Clara"
608,58,92,38,1313,67,1568,3,"Santa Clara"
609,346,577,68,4396,226,5613,3,"Santa Clara"
610,46,323,7,1358,53,1787,3,"Santa Clara"
611,1358,769,37,3856,364,6384,3,"Santa Clara"
612,983,436,218,4997,560,7194,3,"Santa Clara"
613,880,293,155,2517,26,3871,3,"Santa Clara"
614,546,455,151,4102,121,5375,3,"Santa Clara"
615,496,823,39,3175,110,4643,3,"Santa Clara"
616,1169,473,148,3205,108,5103,3,"Santa Clara"
617,1645,505,57,2891,321,5419,3,"Santa Clara"
618,805,696,64,1422,63,3050,3,"Santa Clara"
619,434,870,510,3855,125,5794,3,"Santa Clara"
620,652,333,286,2285,200,3756,3,"Santa Clara"
621,703,525,151,2982,127,4488,3,"Santa Clara"
622,1111,712,121,3299,301,5544,3,"Santa Clara"
623,1081,928,70,4269,265,6613,3,"Santa Clara"
624,321,477,34,2015,113,2960,3,"Santa Clara"
625,801,702,85,3865,91,5544,3,"Santa Clara"
626,1148,618,90,2986,140,4982,3,"Santa Clara"
627,958,739,92,3495,176,5460,3,"Santa Clara"
628,664,1204,75,2288,133,4364,3,"Santa Clara"
629,1599,2291,104,1254,112,5360,3,"Santa Clara"
630,3416,1478,152,3098,285,8429,3,"Santa Clara"
631,1101,540,60,3164,106,4971,3,"Santa Clara"
632,1861,880,74,2900,97,5812,3,"Santa Clara"
633,5564,973,104,2572,114,9327,3,"Santa Clara"
634,4870,308,104,1310,120,6712,3,"Santa Clara"
635,3340,545,60,775,114,4834,3,"Santa Clara"
636,4571,425,31,1047,31,6105,3,"Santa Clara"
637,1527,1761,9,1454,70,4821,3,"Santa Clara"
638,4739,421,277,714,602,6753,3,"Santa Clara"
639,4464,320,237,1119,140,6280,3,"Santa Clara"
640,1740,358,107,1571,61,3837,3,"Santa Clara"
641,2420,163,76,1409,33,4101,3,"Santa Clara"
642,1657,998,60,1055,129,3899,3,"Santa Clara"
643,1592,532,145,2019,113,4401,3,"Santa Clara"
644,721,213,177,3838,46,4995,3,"Santa Clara"
645,1681,545,290,2330,114,4960,3,"Santa Clara"
646,526,264,100,2684,77,3651,3,"Santa Clara"
647,1038,721,83,2486,298,4626,3,"Santa Clara"
648,709,471,299,5885,184,7548,3,"Santa Clara"
649,912,515,51,3142,18,4638,3,"Santa Clara"
650,3823,466,174,4199,212,8874,3,"Santa Clara"
651,2348,512,199,4111,255,7425,3,"Santa Clara"
652,1422,785,174,2645,159,5185,3,"Santa Clara"
653,1345,1220,104,9559,268,12496,3,"Santa Clara"
654,1378,4302,208,2787,304,8979,3,"Santa Clara"
655,1890,2997,227,7840,632,13586,3,"Santa Clara"
656,1637,1793,121,3097,344,6992,3,"Santa Clara"
657,2600,2025,480,3007,162,8274,3,"Santa Clara"
658,1485,1916,94,733,209,4437,3,"Santa Clara"
659,844,1430,24,448,240,2986,3,"Santa Clara"
660,1189,1529,98,728,132,3676,3,"Santa Clara"
661,2386,2639,320,976,298,6619,3,"Santa Clara"
662,1054,2271,65,732,336,4458,3,"Santa Clara"
663,767,1556,82,599,138,3142,3,"Santa Clara"
664,2134,3356,228,2446,578,8742,3,"Santa Clara"
665,2137,3321,132,1219,457,7266,3,"Santa Clara"
666,1687,1570,260,2069,254,5840,3,"Santa Clara"
667,2650,1502,623,988,249,6012,3,"Santa Clara"
668,2044,2181,128,1793,245,6391,3,"Santa Clara"
669,5726,979,388,2290,204,9587,3,"Santa Clara"
670,4469,1131,412,3091,201,9304,3,"Santa Clara"
671,2588,1839,96,2696,540,7759,3,"Santa Clara"
672,1672,1462,314,1212,449,5109,3,"Santa Clara"
673,1653,974,371,1129,183,4310,3,"Santa Clara"
674,1463,2720,179,1064,288,5714,3,"Santa Clara"
675,1582,2620,70,1032,361,5665,3,"Santa Clara"
676,2270,3483,297,1745,426,8221,3,"Santa Clara"
677,1186,1991,268,1334,174,4953,3,"Santa Clara"
678,633,1396,283,735,90,3137,3,"Santa Clara"
679,1256,1904,438,1014,343,4955,3,"Santa Clara"
680,1566,3543,216,1181,344,6850,3,"Santa Clara"
681,905,2159,152,441,46,3703,3,"Santa Clara"
682,870,3226,155,799,422,5472,3,"Santa Clara"
683,471,2367,55,564,327,3784,3,"Santa Clara"
684,1621,3896,95,1312,294,7218,3,"Santa Clara"
685,787,2198,83,1260,202,4530,3,"Santa Clara"
686,1475,2549,212,631,479,5346,3,"Santa Clara"
687,780,1838,0,589,177,3384,3,"Santa Clara"
688,2236,3881,267,1621,347,8352,3,"Santa Clara"
689,488,2893,7,874,116,4378,3,"Santa Clara"
690,479,3645,26,1321,389,5860,3,"Santa Clara"
691,110,2146,120,688,176,3240,3,"Santa Clara"
692,286,1528,11,1228,161,3214,3,"Santa Clara"
693,281,1823,83,1780,75,4042,3,"Santa Clara"
694,258,2175,144,2490,364,5431,3,"Santa Clara"
695,209,3756,0,3551,423,7939,3,"Santa Clara"
696,438,3285,441,1213,356,5733,3,"Santa Clara"
697,761,726,7,230,31,1755,3,"Santa Clara"
698,2254,4494,168,842,662,8420,3,"Santa Clara"
699,1295,3280,66,224,304,5169,3,"Santa Clara"
700,4494,4808,211,1428,432,11373,3,"Santa Clara"
701,1719,3974,27,737,231,6688,3,"Santa Clara"
702,5076,4161,148,812,259,10456,3,"Santa Clara"
703,902,2628,171,589,271,4561,3,"Santa Clara"
704,625,3019,59,455,80,4238,3,"Santa Clara"
705,5720,4173,229,749,271,11142,3,"Santa Clara"
706,1058,1079,18,318,71,2544,3,"Santa Clara"
707,8243,870,30,295,45,9483,3,"Santa Clara"
708,5829,2312,28,129,118,8416,3,"Santa Clara"
709,5583,1310,202,589,223,7907,3,"Santa Clara"
710,5308,2070,130,568,156,8232,3,"Santa Clara"
711,2737,4990,138,1025,280,9170,3,"Santa Clara"
712,2404,2345,8,156,171,5084,3,"Santa Clara"
713,2337,1970,33,434,482,5256,3,"Santa Clara"
714,219,404,24,59,113,819,3,"Santa Clara"
715,1180,4612,109,1034,500,7435,4,"Alameda"
716,681,3401,52,446,317,4897,4,"Alameda"
717,1491,3686,67,696,317,6257,4,"Alameda"
718,2454,5097,87,587,293,8518,4,"Alameda"
719,1462,4375,47,977,367,7228,4,"Alameda"
720,931,2894,46,766,138,4775,4,"Alameda"
721,1070,4249,183,608,228,6338,4,"Alameda"
722,3355,3543,247,703,218,8066,4,"Alameda"
723,386,3991,48,671,201,5297,4,"Alameda"
724,1169,4567,28,675,270,6709,4,"Alameda"
725,314,3262,12,384,186,4158,4,"Alameda"
726,1376,6405,91,935,354,9161,4,"Alameda"
727,624,2337,6,141,179,3287,4,"Alameda"
728,1623,4927,84,563,390,7587,4,"Alameda"
729,1560,5088,565,11493,955,19661,4,"Alameda"
730,1301,2397,985,3664,1051,9398,4,"Alameda"
731,447,2776,318,2450,261,6252,4,"Alameda"
732,1026,2858,199,1048,240,5371,4,"Alameda"
733,505,4064,97,1032,191,5889,4,"Alameda"
734,712,5118,212,2315,524,8881,4,"Alameda"
735,196,2131,43,1188,151,3709,4,"Alameda"
736,701,5565,289,3096,299,9950,4,"Alameda"
737,567,3088,58,1434,149,5296,4,"Alameda"
738,429,3783,40,1366,583,6201,4,"Alameda"
739,718,2914,319,1564,298,5813,4,"Alameda"
740,266,2413,38,910,298,3925,4,"Alameda"
741,481,3581,11,1213,207,5493,4,"Alameda"
742,924,4998,496,5372,632,12422,4,"Alameda"
743,738,4500,50,4164,337,9789,4,"Alameda"
744,926,2970,94,1051,173,5214,4,"Alameda"
745,613,2949,29,1226,171,4988,4,"Alameda"
746,498,4981,126,2799,338,8742,4,"Alameda"
747,38,784,0,2831,314,3967,4,"Alameda"
748,348,1058,163,2468,126,4163,4,"Alameda"
749,562,960,125,4701,283,6631,4,"Alameda"
750,34,95,40,1515,94,1778,4,"Alameda"
751,4,10,4,166,10,194,4,"Alameda"
752,14,40,17,640,40,751,4,"Alameda"
753,154,802,25,3639,163,4783,4,"Alameda"
754,59,351,83,3356,132,3981,4,"Alameda"
755,199,1534,104,7814,370,10021,4,"Alameda"
756,377,1417,112,4889,292,7087,4,"Alameda"
757,884,685,52,1093,97,2811,4,"Alameda"
758,1278,1476,78,3696,157,6685,4,"Alameda"
759,1571,2236,265,3306,625,8003,4,"Alameda"
760,1765,1533,135,2889,176,6498,4,"Alameda"
761,1620,2274,749,5832,550,11025,4,"Alameda"
762,1108,657,271,1603,301,3940,4,"Alameda"
763,1903,991,325,5417,374,9010,4,"Alameda"
764,1843,1633,290,2979,776,7521,4,"Alameda"
765,431,1069,74,1262,82,2918,4,"Alameda"
766,546,1120,121,1132,102,3021,4,"Alameda"
767,1909,2729,542,4210,509,9899,4,"Alameda"
768,3510,2030,453,2106,522,8621,4,"Alameda"
769,521,1154,297,10113,597,12682,4,"Alameda"
770,2569,1484,319,2072,517,6961,4,"Alameda"
771,2251,2972,76,2111,341,7751,4,"Alameda"
772,2209,1016,249,1174,333,4981,4,"Alameda"
773,2945,1347,611,2190,241,7334,4,"Alameda"
774,1762,1905,385,3854,411,8317,4,"Alameda"
775,2361,2965,330,3195,248,9099,4,"Alameda"
776,1004,2714,93,3738,193,7742,4,"Alameda"
777,552,1430,77,3915,203,6177,4,"Alameda"
778,1337,3191,225,9428,732,14913,4,"Alameda"
779,89,826,38,4092,157,5202,4,"Alameda"
780,49,597,6,2422,252,3326,4,"Alameda"
781,878,1829,71,1172,246,4196,4,"Alameda"
782,1441,2501,174,2354,441,6911,4,"Alameda"
783,238,613,92,1847,94,2884,4,"Alameda"
784,864,1545,145,3011,359,5924,4,"Alameda"
785,1539,1369,575,4100,488,8071,4,"Alameda"
786,1049,1360,269,1827,527,5032,4,"Alameda"
787,1022,1656,408,4373,645,8104,4,"Alameda"
788,416,1075,82,4387,310,6270,4,"Alameda"
789,800,486,277,2759,180,4502,4,"Alameda"
790,674,827,173,5354,579,7607,4,"Alameda"
791,289,380,350,2450,219,3688,4,"Alameda"
792,507,542,244,1921,229,3443,4,"Alameda"
793,690,524,353,3370,427,5364,4,"Alameda"
794,123,325,29,2878,257,3612,4,"Alameda"
795,618,485,123,1660,248,3134,4,"Alameda"
796,863,1179,415,5013,737,8207,4,"Alameda"
797,2678,1626,300,2406,324,7334,4,"Alameda"
798,772,929,180,2349,184,4414,4,"Alameda"
799,230,1021,138,3629,384,5402,4,"Alameda"
800,1615,1006,223,2932,223,5999,4,"Alameda"
801,1744,2100,744,6440,661,11689,4,"Alameda"
802,3980,266,422,1264,140,6072,4,"Alameda"
803,467,990,75,1029,80,2641,4,"Alameda"
804,1509,1161,84,1208,80,4042,4,"Alameda"
805,2653,1248,697,2300,416,7314,4,"Alameda"
806,2532,1702,693,4068,708,9703,4,"Alameda"
807,2770,474,337,1174,240,4995,4,"Alameda"
808,1382,214,343,1557,468,3964,4,"Alameda"
809,738,486,125,974,88,2411,4,"Alameda"
810,3042,1460,814,5422,1006,11744,4,"Alameda"
811,2204,1388,433,3257,469,7751,4,"Alameda"
812,1326,681,208,738,529,3482,4,"Alameda"
813,1110,463,360,909,368,3210,4,"Alameda"
814,1778,575,89,709,179,3330,4,"Alameda"
815,2991,528,199,679,79,4476,4,"Alameda"
816,1576,474,257,1011,305,3623,4,"Alameda"
817,5990,622,501,916,553,8582,4,"Alameda"
818,1548,779,477,1526,368,4698,4,"Alameda"
819,1570,194,135,398,157,2454,4,"Alameda"
820,2909,2941,1571,4259,1056,12736,4,"Alameda"
821,1361,2213,592,1131,361,5658,4,"Alameda"
822,564,1281,356,314,154,2669,4,"Alameda"
823,2140,2471,1004,1456,663,7734,4,"Alameda"
824,2258,915,596,833,396,4998,4,"Alameda"
825,3617,790,729,1208,556,6900,4,"Alameda"
826,2213,468,994,1070,337,5082,4,"Alameda"
827,2041,566,531,804,230,4172,4,"Alameda"
828,3891,1168,942,2106,266,8373,4,"Alameda"
829,1502,558,137,962,115,3274,4,"Alameda"
830,4373,942,334,848,339,6836,4,"Alameda"
831,2201,503,687,434,121,3946,4,"Alameda"
832,2743,1301,317,1525,257,6143,4,"Alameda"
833,1673,1541,28,1023,212,4477,4,"Alameda"
834,1693,1684,345,1404,320,5446,4,"Alameda"
835,3020,1096,56,1259,176,5607,4,"Alameda"
836,2621,978,511,673,223,5006,4,"Alameda"
837,6165,2028,1157,1177,315,10842,4,"Alameda"
838,1839,1129,392,412,247,4019,4,"Alameda"
839,1673,920,829,594,362,4378,4,"Alameda"
840,924,2857,826,911,201,5719,4,"Alameda"
841,1237,1181,1033,617,312,4380,4,"Alameda"
842,1254,1193,462,384,316,3609,4,"Alameda"
843,1064,1326,930,918,254,4492,4,"Alameda"
844,676,3640,468,3967,651,9402,4,"Alameda"
845,647,4154,155,1233,369,6558,4,"Alameda"
846,1004,2874,88,1151,328,5445,4,"Alameda"
847,963,929,90,761,171,2914,4,"Alameda"
848,1336,2142,592,761,207,5038,4,"Alameda"
849,576,2379,142,791,231,4119,4,"Alameda"
850,436,2026,282,801,155,3700,4,"Alameda"
851,363,1287,6,396,97,2149,4,"Alameda"
852,954,2517,906,1768,450,6595,4,"Alameda"
853,1059,1680,1140,1144,334,5357,4,"Alameda"
854,3417,554,2370,924,269,7534,4,"Alameda"
855,2794,693,901,751,147,5286,4,"Alameda"
856,3168,1300,690,2907,56,8121,4,"Alameda"
857,2260,463,342,537,196,3798,4,"Alameda"
858,1060,1214,489,2701,293,5757,4,"Alameda"
859,1342,1202,187,1758,98,4587,4,"Alameda"
860,890,1159,513,3619,274,6455,4,"Alameda"
861,1988,1852,484,3441,181,7946,4,"Alameda"
862,1489,1321,1487,2645,394,7336,4,"Alameda"
863,1583,574,196,1530,128,4011,4,"Alameda"
864,2501,1655,1700,1491,496,7843,4,"Alameda"
865,887,977,258,1461,169,3752,4,"Alameda"
866,897,1377,532,1034,257,4097,4,"Alameda"
867,802,1246,160,531,201,2940,4,"Alameda"
868,670,1512,469,701,251,3603,4,"Alameda"
869,1221,1561,927,531,274,4514,4,"Alameda"
870,1788,943,377,1174,315,4597,4,"Alameda"
871,2175,1767,1146,1511,479,7078,4,"Alameda"
872,3311,1556,969,3628,375,9839,4,"Alameda"
873,2376,1376,376,2201,166,6495,4,"Alameda"
874,0,0,0,0,0,0,4,"Alameda"
875,1978,69,1336,108,383,3874,4,"Alameda"
876,1164,41,720,126,152,2203,4,"Alameda"
877,1888,137,1304,184,96,3609,4,"Alameda"
878,3115,304,1522,95,118,5154,4,"Alameda"
879,1724,268,1397,337,73,3799,4,"Alameda"
880,2589,67,973,81,200,3910,4,"Alameda"
881,1466,228,1544,56,119,3413,4,"Alameda"
882,555,359,1807,88,219,3028,4,"Alameda"
883,325,1162,1484,151,509,3631,4,"Alameda"
884,392,874,1635,302,246,3449,4,"Alameda"
885,706,2334,1326,1445,522,6333,4,"Alameda"
886,1263,1273,1818,451,313,5118,4,"Alameda"
887,597,530,1842,193,488,3650,4,"Alameda"
888,3102,136,1848,147,137,5370,4,"Alameda"
889,1523,405,1210,0,175,3313,4,"Alameda"
890,3347,83,2275,139,331,6175,4,"Alameda"
891,2837,96,1194,179,146,4452,4,"Alameda"
892,2839,238,1273,466,30,4846,4,"Alameda"
893,2933,355,1113,80,149,4630,4,"Alameda"
894,1949,113,938,143,169,3312,4,"Alameda"
895,3262,245,2310,322,298,6437,4,"Alameda"
896,1381,380,206,383,105,2455,4,"Alameda"
897,2738,170,705,464,116,4193,4,"Alameda"
898,2222,267,1364,214,233,4300,4,"Alameda"
899,3738,409,3195,160,206,7708,4,"Alameda"
900,3805,237,2030,107,337,6516,4,"Alameda"
901,704,866,2362,217,541,4690,4,"Alameda"
902,376,813,662,560,209,2620,4,"Alameda"
903,569,1132,2042,262,243,4248,4,"Alameda"
904,2025,624,2662,745,432,6488,4,"Alameda"
905,3560,972,1112,1492,441,7577,4,"Alameda"
906,1912,659,915,2098,289,5873,4,"Alameda"
907,351,1217,443,598,345,2954,4,"Alameda"
908,676,1371,546,882,464,3939,4,"Alameda"
909,566,1209,321,1179,327,3602,4,"Alameda"
910,541,2386,638,1148,244,4957,4,"Alameda"
911,283,1349,384,515,145,2676,4,"Alameda"
912,122,3230,243,597,352,4544,4,"Alameda"
913,407,3654,365,695,432,5553,4,"Alameda"
914,342,3670,136,946,331,5425,4,"Alameda"
915,487,2296,158,406,284,3631,4,"Alameda"
916,206,2634,250,414,251,3755,4,"Alameda"
917,399,3789,122,979,457,5746,4,"Alameda"
918,203,4651,88,1120,240,6302,4,"Alameda"
919,127,1266,79,263,157,1892,4,"Alameda"
920,134,1491,118,285,57,2085,4,"Alameda"
921,365,1193,459,373,335,2725,4,"Alameda"
922,351,2353,368,439,408,3919,4,"Alameda"
923,2349,867,1801,2308,695,8020,4,"Alameda"
924,3453,409,1148,943,338,6291,4,"Alameda"
925,4702,457,550,992,156,6857,4,"Alameda"
926,2731,657,484,626,158,4656,4,"Alameda"
927,2650,467,528,356,397,4398,4,"Alameda"
928,1932,313,706,995,440,4386,4,"Alameda"
929,1478,464,617,1459,102,4120,4,"Alameda"
930,378,624,536,400,172,2110,4,"Alameda"
931,677,481,1226,1177,192,3753,4,"Alameda"
932,832,585,1042,1925,101,4485,4,"Alameda"
933,2687,453,1124,3128,288,7680,4,"Alameda"
934,1722,1352,1690,2815,586,8165,4,"Alameda"
935,476,811,558,2054,226,4125,4,"Alameda"
936,766,785,470,869,265,3155,4,"Alameda"
937,287,2095,322,409,229,3342,4,"Alameda"
938,133,2709,721,432,332,4327,4,"Alameda"
939,258,2230,203,478,195,3364,4,"Alameda"
940,246,2182,590,690,288,3996,4,"Alameda"
941,682,2018,1745,510,428,5383,4,"Alameda"
942,545,2197,1094,544,284,4664,4,"Alameda"
943,1021,1672,543,1540,529,5305,4,"Alameda"
944,575,1752,900,762,377,4366,4,"Alameda"
945,458,2078,1027,1922,308,5793,4,"Alameda"
946,518,1034,314,2637,287,4790,4,"Alameda"
947,514,649,428,1347,190,3128,4,"Alameda"
948,1105,1636,203,891,480,4315,4,"Alameda"
949,396,2347,172,530,195,3640,4,"Alameda"
950,649,2742,188,1039,235,4853,4,"Alameda"
951,629,3519,343,1613,404,6508,4,"Alameda"
952,663,2259,150,3159,781,7012,4,"Alameda"
953,593,3005,301,3138,410,7447,4,"Alameda"
954,606,1779,397,1200,232,4214,4,"Alameda"
955,425,1005,287,838,196,2751,4,"Alameda"
956,630,2483,295,1383,259,5050,4,"Alameda"
957,272,1306,228,1055,320,3181,4,"Alameda"
958,217,1277,319,1092,282,3187,4,"Alameda"
959,337,2385,183,1894,451,5250,4,"Alameda"
960,486,2032,341,1954,251,5064,4,"Alameda"
961,302,1077,334,1727,133,3573,4,"Alameda"
962,713,1326,1237,1898,529,5703,4,"Alameda"
963,711,2603,407,886,472,5079,4,"Alameda"
964,228,430,290,50,70,1068,4,"Alameda"
965,161,260,46,41,21,529,4,"Alameda"
966,9,46,23,5,0,83,4,"Alameda"
967,56,297,34,176,23,586,4,"Alameda"
968,51,162,107,2239,148,2707,4,"Alameda"
969,257,420,406,872,76,2031,4,"Alameda"
970,428,1362,1930,838,216,4774,4,"Alameda"
971,110,169,112,268,60,719,4,"Alameda"
972,783,2584,1415,1198,374,6354,4,"Alameda"
973,443,1606,175,294,236,2754,4,"Alameda"
974,384,3208,272,620,333,4817,4,"Alameda"
975,454,1218,386,210,110,2378,4,"Alameda"
976,437,2115,636,676,314,4178,4,"Alameda"
977,1309,2014,2419,275,724,6741,4,"Alameda"
978,913,884,1432,227,430,3886,4,"Alameda"
979,545,1211,1297,544,179,3776,4,"Alameda"
980,261,312,546,104,57,1280,4,"Alameda"
981,101,100,239,334,24,798,4,"Alameda"
982,213,134,1077,170,81,1675,4,"Alameda"
983,334,591,1432,313,132,2802,4,"Alameda"
984,25,26,247,58,23,379,4,"Alameda"
985,123,127,1222,289,114,1875,4,"Alameda"
986,469,486,755,313,70,2093,4,"Alameda"
987,362,514,813,71,164,1924,4,"Alameda"
988,809,917,727,253,86,2792,4,"Alameda"
989,272,533,949,179,172,2105,4,"Alameda"
990,417,1124,1094,208,195,3038,4,"Alameda"
991,940,4689,1494,3048,559,10730,4,"Alameda"
992,307,1078,811,159,168,2523,4,"Alameda"
993,514,1675,1337,578,231,4335,4,"Alameda"
994,518,701,707,159,124,2209,4,"Alameda"
995,646,1928,1042,413,280,4309,4,"Alameda"
996,906,1939,1785,231,299,5160,4,"Alameda"
997,131,684,375,145,190,1525,4,"Alameda"
998,367,3230,471,464,305,4837,4,"Alameda"
999,213,1646,20,225,183,2287,4,"Alameda"
1000,375,2588,339,485,305,4092,4,"Alameda"
1001,405,2063,920,215,246,3849,4,"Alameda"
1002,291,1139,259,188,52,1929,4,"Alameda"
1003,105,1041,40,144,88,1418,4,"Alameda"
1004,277,2310,36,266,119,3008,4,"Alameda"
1005,114,2078,85,485,240,3002,4,"Alameda"
1006,282,2525,108,802,219,3936,4,"Alameda"
1007,745,2255,126,1383,240,4749,4,"Alameda"
1008,1426,2579,423,3951,582,8961,4,"Alameda"
1009,433,2168,354,1801,452,5208,4,"Alameda"
1010,218,2038,104,279,161,2800,4,"Alameda"
1011,489,1706,457,373,184,3209,4,"Alameda"
1012,776,2559,779,737,545,5396,4,"Alameda"
1013,481,1511,1449,373,246,4060,4,"Alameda"
1014,257,1365,335,93,109,2159,4,"Alameda"
1015,986,950,646,197,345,3124,4,"Alameda"
1016,493,2081,628,767,338,4307,4,"Alameda"
1017,594,2692,158,906,302,4652,4,"Alameda"
1018,343,1932,605,1860,405,5145,4,"Alameda"
1019,195,584,94,613,74,1560,4,"Alameda"
1020,489,2714,118,1538,414,5273,4,"Alameda"
1021,322,1882,70,1125,156,3555,4,"Alameda"
1022,327,2293,190,858,214,3882,4,"Alameda"
1023,477,2078,220,546,283,3604,4,"Alameda"
1024,376,1335,371,366,169,2617,4,"Alameda"
1025,315,2443,225,578,397,3958,4,"Alameda"
1026,78,1555,61,327,188,2209,4,"Alameda"
1027,297,2437,10,646,225,3615,4,"Alameda"
1028,167,2749,60,494,71,3541,4,"Alameda"
1029,184,3077,122,359,136,3878,4,"Alameda"
1030,84,1597,27,262,72,2042,4,"Alameda"
1031,238,2743,23,418,228,3650,4,"Alameda"
1032,76,1256,59,186,91,1668,4,"Alameda"
1033,82,3167,42,365,280,3936,4,"Alameda"
1034,302,2436,19,414,168,3339,4,"Alameda"
1035,167,1437,70,524,216,2414,4,"Alameda"
1036,486,1454,247,839,140,3166,4,"Alameda"
1037,229,1233,156,531,340,2489,4,"Alameda"
1038,767,995,59,1117,348,3286,4,"Alameda"
1039,604,1692,253,1849,578,4976,4,"Alameda"
1040,305,414,136,789,55,1699,5,"Contra Costa"
1041,373,793,73,610,122,1971,5,"Contra Costa"
1042,133,1212,38,302,51,1736,5,"Contra Costa"
1043,231,1920,57,350,139,2697,5,"Contra Costa"
1044,145,1892,22,339,182,2580,5,"Contra Costa"
1045,320,1541,98,694,302,2955,5,"Contra Costa"
1046,204,1482,91,452,191,2420,5,"Contra Costa"
1047,210,1208,174,1110,251,2953,5,"Contra Costa"
1048,319,1279,95,879,149,2721,5,"Contra Costa"
1049,508,2038,538,1379,196,4659,5,"Contra Costa"
1050,2394,477,3424,997,384,7676,5,"Contra Costa"
1051,547,1281,317,1219,240,3604,5,"Contra Costa"
1052,71,585,49,391,61,1157,5,"Contra Costa"
1053,360,2119,299,699,504,3981,5,"Contra Costa"
1054,466,1308,336,569,104,2783,5,"Contra Costa"
1055,2590,1551,713,912,250,6016,5,"Contra Costa"
1056,2256,940,876,387,203,4662,5,"Contra Costa"
1057,3879,273,338,145,148,4783,5,"Contra Costa"
1058,3678,497,1922,245,343,6685,5,"Contra Costa"
1059,968,1961,1521,1316,387,6153,5,"Contra Costa"
1060,3928,190,1888,87,333,6426,5,"Contra Costa"
1061,4954,464,1145,387,198,7148,5,"Contra Costa"
1062,475,2117,159,320,125,3196,5,"Contra Costa"
1063,3727,132,1250,436,134,5679,5,"Contra Costa"
1064,3011,76,539,597,54,4277,5,"Contra Costa"
1065,3975,971,608,1363,553,7470,5,"Contra Costa"
1066,3293,935,1147,1583,64,7022,5,"Contra Costa"
1067,6788,543,427,603,323,8684,5,"Contra Costa"
1068,3706,247,941,516,331,5741,5,"Contra Costa"
1069,3534,2080,2695,2869,833,12011,5,"Contra Costa"
1070,2808,359,470,559,298,4494,5,"Contra Costa"
1071,4044,366,655,1000,159,6224,5,"Contra Costa"
1072,2731,630,885,1408,229,5883,5,"Contra Costa"
1073,1970,433,1745,689,211,5048,5,"Contra Costa"
1074,1769,2199,1285,1418,279,6950,5,"Contra Costa"
1075,905,715,532,318,222,2692,5,"Contra Costa"
1076,721,1712,341,346,224,3344,5,"Contra Costa"
1077,1404,1866,627,1175,461,5533,5,"Contra Costa"
1078,1471,1422,389,903,238,4423,5,"Contra Costa"
1079,2058,3237,691,2212,729,8927,5,"Contra Costa"
1080,2213,1505,857,923,438,5936,5,"Contra Costa"
1081,2274,1000,282,704,75,4335,5,"Contra Costa"
1082,1755,1608,661,1570,350,5944,5,"Contra Costa"
1083,2048,3173,2088,6418,1229,14956,5,"Contra Costa"
1084,1392,2459,411,1191,551,6004,5,"Contra Costa"
1085,687,842,480,2446,254,4709,5,"Contra Costa"
1086,1126,1250,1166,2839,123,6504,5,"Contra Costa"
1087,771,2023,764,2278,537,6373,5,"Contra Costa"
1088,1226,1222,524,1276,294,4542,5,"Contra Costa"
1089,2260,1593,924,870,448,6095,5,"Contra Costa"
1090,787,2182,50,21,161,3201,5,"Contra Costa"
1091,605,2505,17,368,208,3703,5,"Contra Costa"
1092,165,608,121,16,13,923,5,"Contra Costa"
1093,228,1642,79,289,234,2472,5,"Contra Costa"
1094,1809,5687,171,374,303,8344,5,"Contra Costa"
1095,1606,1974,127,128,408,4243,5,"Contra Costa"
1096,1352,5832,321,995,636,9136,5,"Contra Costa"
1097,768,1608,246,687,314,3623,5,"Contra Costa"
1098,2254,2337,1605,4155,669,11020,5,"Contra Costa"
1099,1615,5259,268,1185,399,8726,5,"Contra Costa"
1100,798,6467,59,734,587,8645,5,"Contra Costa"
1101,443,3432,56,185,209,4325,5,"Contra Costa"
1102,49,795,23,9,10,886,5,"Contra Costa"
1103,990,5431,40,961,756,8178,5,"Contra Costa"
1104,425,2140,217,1043,122,3947,5,"Contra Costa"
1105,52,697,7,67,104,927,5,"Contra Costa"
1106,1349,4786,489,808,424,7856,5,"Contra Costa"
1107,1123,2296,83,505,122,4129,5,"Contra Costa"
1108,1166,4331,46,228,265,6036,5,"Contra Costa"
1109,2133,4994,89,697,543,8456,5,"Contra Costa"
1110,1612,3591,470,816,398,6887,5,"Contra Costa"
1111,1659,2947,29,575,259,5469,5,"Contra Costa"
1112,2065,3242,112,466,211,6096,5,"Contra Costa"
1113,528,1084,137,476,154,2379,5,"Contra Costa"
1114,4337,1342,707,808,262,7456,5,"Contra Costa"
1115,3199,735,304,734,335,5307,5,"Contra Costa"
1116,903,1760,167,247,295,3372,5,"Contra Costa"
1117,931,1895,170,537,166,3699,5,"Contra Costa"
1118,2160,4118,214,1002,405,7899,5,"Contra Costa"
1119,2956,3926,373,888,505,8648,5,"Contra Costa"
1120,6731,1921,126,978,440,10196,5,"Contra Costa"
1121,1378,6528,360,2067,816,11149,5,"Contra Costa"
1122,3386,3375,5,489,608,7863,5,"Contra Costa"
1123,991,2660,153,1441,225,5470,5,"Contra Costa"
1124,1222,4159,366,522,302,6571,5,"Contra Costa"
1125,524,3325,80,363,197,4489,5,"Contra Costa"
1126,854,4719,116,744,464,6897,5,"Contra Costa"
1127,1114,3957,51,544,571,6237,5,"Contra Costa"
1128,663,3280,40,419,164,4566,5,"Contra Costa"
1129,765,4114,163,345,260,5647,5,"Contra Costa"
1130,213,2808,112,197,169,3499,5,"Contra Costa"
1131,471,4562,36,556,317,5942,5,"Contra Costa"
1132,212,3948,38,560,168,4926,5,"Contra Costa"
1133,812,5292,18,753,525,7400,5,"Contra Costa"
1134,358,4604,111,828,393,6294,5,"Contra Costa"
1135,829,3898,55,1084,186,6052,5,"Contra Costa"
1136,392,3235,87,1504,362,5580,5,"Contra Costa"
1137,353,2724,65,493,127,3762,5,"Contra Costa"
1138,537,4125,214,734,370,5980,5,"Contra Costa"
1139,234,2364,44,713,132,3487,5,"Contra Costa"
1140,357,2030,19,369,114,2889,5,"Contra Costa"
1141,442,4350,0,778,537,6107,5,"Contra Costa"
1142,195,3073,8,316,279,3871,5,"Contra Costa"
1143,569,3259,51,571,233,4683,5,"Contra Costa"
1144,603,3432,68,488,131,4722,5,"Contra Costa"
1145,874,4016,141,1603,501,7135,5,"Contra Costa"
1146,677,2037,103,561,145,3523,5,"Contra Costa"
1147,240,4915,301,422,328,6206,5,"Contra Costa"
1148,262,7029,29,592,118,8030,5,"Contra Costa"
1149,384,3959,74,677,273,5367,5,"Contra Costa"
1150,578,4105,122,589,222,5616,5,"Contra Costa"
1151,279,4880,8,655,399,6221,5,"Contra Costa"
1152,475,4385,356,703,501,6420,5,"Contra Costa"
1153,309,3341,77,562,165,4454,5,"Contra Costa"
1154,527,4793,91,992,537,6940,5,"Contra Costa"
1155,97,1510,0,322,184,2113,5,"Contra Costa"
1156,62,2873,117,757,222,4031,5,"Contra Costa"
1157,139,1745,7,482,167,2540,5,"Contra Costa"
1158,468,3796,14,1387,269,5934,5,"Contra Costa"
1159,306,2112,70,459,207,3154,5,"Contra Costa"
1160,418,4230,17,943,159,5767,5,"Contra Costa"
1161,732,9160,205,603,302,11002,5,"Contra Costa"
1162,27,971,82,13,149,1242,5,"Contra Costa"
1163,225,2606,0,535,91,3457,5,"Contra Costa"
1164,464,4350,44,589,243,5690,5,"Contra Costa"
1165,228,6535,52,388,134,7337,5,"Contra Costa"
1166,545,8916,12,1529,300,11302,5,"Contra Costa"
1167,498,8499,132,1488,286,10903,5,"Contra Costa"
1168,451,3710,250,2692,474,7577,5,"Contra Costa"
1169,725,4897,40,831,277,6770,5,"Contra Costa"
1170,559,4231,158,1847,470,7265,5,"Contra Costa"
1171,789,4411,75,2800,554,8629,5,"Contra Costa"
1172,1155,2810,466,1488,68,5987,5,"Contra Costa"
1173,430,2457,15,726,311,3939,5,"Contra Costa"
1174,507,2762,185,945,280,4679,5,"Contra Costa"
1175,961,4888,132,5497,452,11930,5,"Contra Costa"
1176,2765,16203,1165,22213,2333,44679,5,"Contra Costa"
1177,3762,14921,982,1679,1244,22588,5,"Contra Costa"
1178,9550,22442,3234,3746,3209,42181,5,"Contra Costa"
1179,6131,9632,1769,1941,1499,20972,5,"Contra Costa"
1180,5931,5418,1580,1217,1005,15151,5,"Contra Costa"
1181,902,3243,373,105,176,4799,5,"Contra Costa"
1182,3874,5343,815,415,564,11011,5,"Contra Costa"
1183,1100,1759,194,267,26,3346,5,"Contra Costa"
1184,998,1326,765,920,319,4328,5,"Contra Costa"
1185,5822,7303,2501,2457,1097,19180,5,"Contra Costa"
1186,5051,5564,4015,2799,1005,18434,5,"Contra Costa"
1187,2141,3404,1305,183,725,7758,5,"Contra Costa"
1188,3417,3141,1641,208,473,8880,5,"Contra Costa"
1189,2819,1796,1290,248,284,6437,5,"Contra Costa"
1190,1616,422,1512,125,455,4130,5,"Contra Costa"
1191,3434,1124,490,115,236,5399,5,"Contra Costa"
1192,1978,1405,519,226,99,4227,5,"Contra Costa"
1193,2535,1739,1770,723,271,7038,5,"Contra Costa"
1194,1372,2331,313,342,130,4488,5,"Contra Costa"
1195,4341,4486,4221,2684,1728,17460,5,"Contra Costa"
1196,2431,2457,870,1866,879,8503,5,"Contra Costa"
1197,1723,999,161,368,269,3520,5,"Contra Costa"
1198,1489,866,1009,355,326,4045,5,"Contra Costa"
1199,2821,1571,828,880,994,7094,5,"Contra Costa"
1200,3808,2283,956,1043,582,8672,5,"Contra Costa"
1201,2326,733,643,932,140,4774,5,"Contra Costa"
1202,1930,255,568,222,162,3137,5,"Contra Costa"
1203,2099,691,1200,937,506,5433,5,"Contra Costa"
1204,964,189,776,141,98,2168,5,"Contra Costa"
1205,1091,676,1308,268,208,3551,5,"Contra Costa"
1206,3796,722,1089,363,516,6486,5,"Contra Costa"
1207,3495,925,401,570,348,5739,5,"Contra Costa"
1208,5106,1192,1090,524,488,8400,5,"Contra Costa"
1209,3585,599,983,745,393,6305,5,"Contra Costa"
1210,5226,834,155,337,236,6788,5,"Contra Costa"
1211,724,2337,71,249,567,3948,6,"Solano"
1212,626,3230,267,108,185,4416,6,"Solano"
1213,410,2036,304,272,170,3192,6,"Solano"
1214,417,2248,295,343,133,3436,6,"Solano"
1215,854,2955,229,624,305,4967,6,"Solano"
1216,514,1948,160,532,188,3342,6,"Solano"
1217,639,2838,325,1069,478,5349,6,"Solano"
1218,531,1600,887,1867,319,5204,6,"Solano"
1219,1094,833,448,735,365,3475,6,"Solano"
1220,1161,2449,1231,2287,769,7897,6,"Solano"
1221,1917,1273,1197,504,462,5353,6,"Solano"
1222,586,990,969,390,301,3236,6,"Solano"
1223,1259,585,753,438,350,3385,6,"Solano"
1224,544,615,1123,299,166,2747,6,"Solano"
1225,837,910,482,359,108,2696,6,"Solano"
1226,944,538,1106,323,148,3059,6,"Solano"
1227,732,1106,453,193,238,2722,6,"Solano"
1228,769,928,255,125,168,2245,6,"Solano"
1229,990,1296,706,503,261,3756,6,"Solano"
1230,1100,1665,1352,2264,687,7068,6,"Solano"
1231,776,746,710,851,126,3209,6,"Solano"
1232,1759,653,494,437,150,3493,6,"Solano"
1233,538,1292,290,317,189,2626,6,"Solano"
1234,1945,902,1115,296,204,4462,6,"Solano"
1235,730,794,633,72,275,2504,6,"Solano"
1236,758,1185,889,380,287,3499,6,"Solano"
1237,347,488,774,739,248,2596,6,"Solano"
1238,163,233,146,142,66,750,6,"Solano"
1239,858,396,397,1437,151,3239,6,"Solano"
1240,2295,800,964,1387,116,5562,6,"Solano"
1241,903,409,599,612,88,2611,6,"Solano"
1242,1453,2428,751,728,295,5655,6,"Solano"
1243,981,1050,1246,1048,195,4520,6,"Solano"
1244,2436,802,1464,1118,387,6207,6,"Solano"
1245,1655,416,1840,1403,299,5613,6,"Solano"
1246,1295,1949,1544,5263,866,10917,6,"Solano"
1247,1811,3869,843,3971,748,11242,6,"Solano"
1248,1662,4251,675,1720,883,9191,6,"Solano"
1249,704,2574,192,1125,320,4915,6,"Solano"
1250,2498,1371,496,639,328,5332,6,"Solano"
1251,1318,1899,1268,1820,479,6784,6,"Solano"
1252,521,1925,485,246,329,3506,6,"Solano"
1253,775,1676,365,726,249,3791,6,"Solano"
1254,1302,1816,1459,935,583,6095,6,"Solano"
1255,1148,1486,1617,797,287,5335,6,"Solano"
1256,1672,1715,1251,499,570,5707,6,"Solano"
1257,2497,1395,1592,669,514,6667,6,"Solano"
1258,1725,823,1027,562,179,4316,6,"Solano"
1259,2879,990,899,479,318,5565,6,"Solano"
1260,2713,687,670,210,158,4438,6,"Solano"
1261,1470,864,564,941,183,4022,6,"Solano"
1262,467,549,356,124,210,1706,6,"Solano"
1263,1411,568,334,223,111,2647,6,"Solano"
1264,2864,1005,994,524,669,6056,6,"Solano"
1265,975,887,706,431,253,3252,6,"Solano"
1266,2159,991,675,532,113,4470,6,"Solano"
1267,853,1634,329,432,109,3357,6,"Solano"
1268,1609,4965,1378,1938,1027,10917,6,"Solano"
1269,2115,4089,1173,1761,660,9798,6,"Solano"
1270,3707,5494,2453,4654,1497,17805,6,"Solano"
1271,3380,7257,1817,1667,1229,15350,6,"Solano"
1272,0,0,0,0,0,0,6,"Solano"
1273,1099,2401,471,462,593,5026,6,"Solano"
1274,2140,3009,460,58,469,6136,6,"Solano"
1275,837,1776,343,377,170,3503,6,"Solano"
1276,587,2479,386,278,448,4178,6,"Solano"
1277,1455,3231,507,372,539,6104,6,"Solano"
1278,779,1881,130,126,108,3024,6,"Solano"
1279,1742,2961,645,713,246,6307,6,"Solano"
1280,1229,7721,481,626,428,10485,6,"Solano"
1281,1835,2466,587,629,533,6050,6,"Solano"
1282,4181,7087,630,1031,890,13819,6,"Solano"
1283,962,2508,394,151,61,4076,6,"Solano"
1284,1598,3219,130,87,228,5262,6,"Solano"
1285,582,3661,223,66,193,4725,6,"Solano"
1286,422,3325,39,177,165,4128,6,"Solano"
1287,790,1902,24,32,84,2832,6,"Solano"
1288,4466,6147,325,384,664,11986,6,"Solano"
1289,3835,3117,132,404,209,7697,6,"Solano"
1290,1658,6783,613,649,249,9952,6,"Solano"
1291,2600,2398,1230,4701,548,11477,7,"Napa"
1292,3176,2985,395,2617,810,9983,7,"Napa"
1293,2005,3110,24,101,255,5495,7,"Napa"
1294,25,73,28,8,8,142,7,"Napa"
1295,3835,3736,112,225,258,8166,7,"Napa"
1296,937,2864,29,69,153,4052,7,"Napa"
1297,4021,4241,77,569,173,9081,7,"Napa"
1298,782,734,8,24,15,1563,7,"Napa"
1299,1251,1499,86,53,116,3005,7,"Napa"
1300,1114,1193,17,0,76,2400,7,"Napa"
1301,1294,1837,31,65,0,3227,7,"Napa"
1302,4356,3155,21,32,255,7819,7,"Napa"
1303,165,2522,2,58,26,2773,7,"Napa"
1304,3613,4041,40,118,347,8159,7,"Napa"
1305,3064,1977,69,28,135,5273,7,"Napa"
1306,3640,5446,4,403,164,9657,7,"Napa"
1307,1482,4183,22,328,182,6197,7,"Napa"
1308,388,3297,20,154,103,3962,7,"Napa"
1309,1661,2906,0,344,86,4997,7,"Napa"
1310,296,2054,54,42,52,2498,7,"Napa"
1311,600,6160,76,84,268,7188,7,"Napa"
1312,364,1294,35,15,29,1737,7,"Napa"
1313,1197,3565,249,482,223,5716,7,"Napa"
1314,1821,3912,127,56,168,6084,7,"Napa"
1315,721,1281,4,64,38,2108,7,"Napa"
1316,291,936,0,72,60,1359,7,"Napa"
1317,2483,2552,0,171,25,5231,7,"Napa"
1318,256,4130,41,164,312,4903,8,"Sonoma"
1319,5488,3970,38,70,665,10231,8,"Sonoma"
1320,421,3503,24,405,171,4524,8,"Sonoma"
1321,2152,3872,36,0,45,6105,8,"Sonoma"
1322,404,4004,6,47,173,4634,8,"Sonoma"
1323,1319,6982,0,152,106,8559,8,"Sonoma"
1324,319,2168,0,0,21,2508,8,"Sonoma"
1325,1499,6297,122,574,268,8760,8,"Sonoma"
1326,678,3762,26,210,127,4803,8,"Sonoma"
1327,1060,3883,5,181,172,5301,8,"Sonoma"
1328,806,4628,110,117,183,5844,8,"Sonoma"
1329,610,3175,17,79,65,3946,8,"Sonoma"
1330,302,2815,17,7,146,3287,8,"Sonoma"
1331,1463,3016,48,64,434,5025,8,"Sonoma"
1332,1463,3059,53,58,240,4873,8,"Sonoma"
1333,1411,2807,0,239,122,4579,8,"Sonoma"
1334,811,2899,0,304,158,4172,8,"Sonoma"
1335,1754,4761,3,237,256,7011,8,"Sonoma"
1336,2733,9825,129,764,697,14148,8,"Sonoma"
1337,2061,4444,102,326,351,7284,8,"Sonoma"
1338,622,2121,166,65,237,3211,8,"Sonoma"
1339,769,3677,20,90,210,4766,8,"Sonoma"
1340,1005,4868,154,405,207,6639,8,"Sonoma"
1341,978,3902,74,195,153,5302,8,"Sonoma"
1342,1206,3863,158,429,243,5899,8,"Sonoma"
1343,1825,2301,65,250,356,4797,8,"Sonoma"
1344,2634,3072,68,308,82,6164,8,"Sonoma"
1345,717,2386,20,284,119,3526,8,"Sonoma"
1346,584,3118,86,102,654,4544,8,"Sonoma"
1347,1294,3736,85,244,305,5664,8,"Sonoma"
1348,5126,3350,463,280,625,9844,8,"Sonoma"
1349,3014,3507,79,815,397,7812,8,"Sonoma"
1350,872,5138,201,296,197,6704,8,"Sonoma"
1351,396,2690,28,152,162,3428,8,"Sonoma"
1352,182,2969,0,145,62,3358,8,"Sonoma"
1353,272,5349,0,129,88,5838,8,"Sonoma"
1354,585,6635,114,299,473,8106,8,"Sonoma"
1355,1072,2290,9,146,63,3580,8,"Sonoma"
1356,1415,4273,52,301,413,6454,8,"Sonoma"
1357,782,3196,121,128,143,4370,8,"Sonoma"
1358,1377,4235,0,415,453,6480,8,"Sonoma"
1359,780,3483,113,139,339,4854,8,"Sonoma"
1360,974,1942,77,99,240,3332,8,"Sonoma"
1361,429,1245,74,18,164,1930,8,"Sonoma"
1362,456,2630,87,49,262,3484,8,"Sonoma"
1363,365,1632,65,79,220,2361,8,"Sonoma"
1364,825,2388,106,85,315,3719,8,"Sonoma"
1365,511,3297,28,113,214,4163,8,"Sonoma"
1366,664,7854,158,1061,466,10203,8,"Sonoma"
1367,1394,3580,0,190,250,5414,8,"Sonoma"
1368,1481,3384,128,112,380,5485,8,"Sonoma"
1369,1652,3148,21,209,235,5265,8,"Sonoma"
1370,2832,6115,175,514,559,10195,8,"Sonoma"
1371,1180,3265,282,127,602,5456,8,"Sonoma"
1372,2992,1646,125,396,194,5353,8,"Sonoma"
1373,3495,2866,350,172,252,7135,8,"Sonoma"
1374,3174,3316,86,392,213,7181,8,"Sonoma"
1375,2759,4463,134,204,367,7927,8,"Sonoma"
1376,3524,2196,314,144,438,6616,8,"Sonoma"
1377,2557,3115,39,272,236,6219,8,"Sonoma"
1378,5307,2246,137,326,352,8368,8,"Sonoma"
1379,3516,1247,136,418,297,5614,8,"Sonoma"
1380,4017,2464,235,787,518,8021,8,"Sonoma"
1381,6392,4702,544,1180,634,13452,8,"Sonoma"
1382,2127,4463,22,292,400,7304,8,"Sonoma"
1383,964,4727,13,49,186,5939,8,"Sonoma"
1384,559,5524,84,110,252,6529,8,"Sonoma"
1385,240,3888,26,70,170,4394,8,"Sonoma"
1386,481,2932,12,136,173,3734,8,"Sonoma"
1387,511,4077,57,58,103,4806,8,"Sonoma"
1388,482,3473,20,85,234,4294,8,"Sonoma"
1389,72,2945,38,40,146,3241,8,"Sonoma"
1390,335,2752,53,42,163,3345,8,"Sonoma"
1391,454,3022,13,66,307,3862,8,"Sonoma"
1392,332,3807,12,124,160,4435,8,"Sonoma"
1393,534,3180,143,65,100,4022,8,"Sonoma"
1394,3880,5512,136,559,324,10411,8,"Sonoma"
1395,3493,4991,0,147,412,9043,8,"Sonoma"
1396,2383,7233,0,255,315,10186,8,"Sonoma"
1397,1190,3428,29,105,162,4914,8,"Sonoma"
1398,935,2986,0,19,89,4029,8,"Sonoma"
1399,1950,2169,0,40,53,4212,8,"Sonoma"
1400,688,2108,0,55,48,2899,8,"Sonoma"
1401,1305,2397,23,59,92,3876,8,"Sonoma"
1402,3040,5805,91,250,547,9733,8,"Sonoma"
1403,384,3115,17,29,108,3653,8,"Sonoma"
1404,69,2423,0,151,46,2689,9,"Marin"
1405,875,2056,0,143,13,3087,9,"Marin"
1406,52,1374,23,113,75,1637,9,"Marin"
1407,1331,3645,227,728,642,6573,9,"Marin"
1408,898,4098,118,291,354,5759,9,"Marin"
1409,1522,5219,251,562,321,7875,9,"Marin"
1410,1839,2670,140,602,364,5615,9,"Marin"
1411,1270,4566,123,578,463,7000,9,"Marin"
1412,3429,6928,298,595,804,12054,9,"Marin"
1413,136,2029,16,106,86,2373,9,"Marin"
1414,382,6441,118,375,466,7782,9,"Marin"
1415,457,2310,10,65,143,2985,9,"Marin"
1416,215,1492,10,10,73,1800,9,"Marin"
1417,0,491,0,0,6,497,9,"Marin"
1418,245,3390,5,0,160,3800,9,"Marin"
1419,404,2500,14,113,104,3135,9,"Marin"
1420,395,6426,19,264,165,7269,9,"Marin"
1421,1153,3960,28,931,548,6620,9,"Marin"
1422,569,5180,26,273,395,6443,9,"Marin"
1423,605,5825,10,541,122,7103,9,"Marin"
1424,768,2289,324,326,300,4007,9,"Marin"
1425,590,4079,67,513,520,5769,9,"Marin"
1426,89,4317,22,248,220,4896,9,"Marin"
1427,770,3979,387,477,208,5821,9,"Marin"
1428,9531,1220,119,832,593,12295,9,"Marin"
1429,1713,2671,67,211,168,4830,9,"Marin"
1430,1613,3882,264,84,171,6014,9,"Marin"
1431,1470,6203,110,268,500,8551,9,"Marin"
1432,216,3854,50,165,128,4413,9,"Marin"
1433,99,2867,32,75,112,3185,9,"Marin"
1434,344,4418,2,265,272,5301,9,"Marin"
1435,69,2088,63,66,44,2330,9,"Marin"
1436,181,4768,0,67,74,5090,9,"Marin"
1437,731,5349,157,359,201,6797,9,"Marin"
1438,419,4590,82,518,318,5927,9,"Marin"
1439,0,0,0,0,0,0,9,"Marin"
1440,278,5235,72,321,315,6221,9,"Marin"
1441,723,3963,79,246,345,5356,9,"Marin"
1442,391,5252,0,197,323,6163,9,"Marin"
1443,539,3478,9,301,68,4395,9,"Marin"
1444,362,3280,36,586,151,4415,9,"Marin"
1445,643,4186,0,290,397,5516,9,"Marin"
1446,411,4869,58,204,315,5857,9,"Marin"
1447,106,1892,0,77,85,2160,9,"Marin"
1448,610,6564,184,209,136,7703,9,"Marin"
1449,728,624,771,234,214,2571,9,"Marin"
1450,248,5560,34,449,293,6584,9,"Marin"
1451,239,3986,148,275,71,4719,9,"Marin"
1452,279,3800,0,172,289,4540,9,"Marin"
1453,29,532,0,4,10,575,9,"Marin"
1454,90,1840,8,38,119,2095,9,"Marin"
