"TAZ","TOTHH","TOTPOP","hh_own","hh_rent","hh_size_1","hh_size_2","hh_size_3","hh_size_4_plus","hh_wrks_0","hh_wrks_1","hh_wrks_2","hh_wrks_3_plus","hh_kids_no","hh_kids_yes","HHINCQ1","HHINCQ2","HHINCQ3","HHINCQ4","AGE0004","AGE0519","AGE2044","AGE4564","AGE65P","gq_tot_pop","gq_type_univ","gq_type_mil","gq_type_othnon"
1,48,108,6,42,26,14,3,5,14,23,8,3,42,6,24,11,5,8,4,8,48,24,24,11,2,0,9
2,150,337,19,131,80,45,10,15,43,74,25,8,132,18,78,34,14,24,13,25,149,76,74,33,5,0,28
3,264,400,8,256,152,81,19,12,76,130,44,14,231,33,117,33,55,59,11,14,190,120,65,39,6,0,33
4,157,260,14,143,99,39,12,7,45,78,26,8,138,19,56,25,42,34,1,12,124,80,43,24,3,0,21
5,478,800,56,422,303,119,30,26,138,235,80,25,419,59,185,77,103,113,5,42,361,253,139,81,12,0,69
6,2122,3455,102,2020,1387,576,93,66,209,1500,393,20,2029,93,653,552,298,619,45,235,2292,595,288,375,375,0,0
7,3336,5963,24,3312,2280,718,179,159,1268,1555,474,39,3205,131,2013,704,435,184,103,289,2954,1718,899,988,39,0,949
8,4993,10998,66,4927,3523,834,282,354,2211,1780,665,337,4238,755,3373,930,618,72,238,770,3762,3546,2682,2934,0,0,2934
9,6053,12069,142,5911,3359,1622,544,528,1627,3162,1028,236,5480,573,3091,1404,849,709,409,1023,6337,3001,1299,1280,172,0,1108
10,4022,8240,462,3560,2125,1223,330,344,1055,1741,965,261,3430,592,1187,853,804,1178,225,707,4865,1752,691,1123,327,0,796
11,2540,4935,182,2358,1634,502,189,215,492,1354,596,98,2241,299,1339,392,445,364,124,324,2085,1772,630,726,0,0,726
12,809,1313,210,599,422,283,66,38,208,357,244,0,765,44,103,25,97,584,30,65,705,286,227,21,0,0,21
13,51,96,23,28,22,20,5,4,13,22,16,0,48,3,19,1,2,29,4,6,46,28,12,2,0,0,2
14,392,734,165,227,172,152,36,32,97,172,122,1,370,22,143,12,15,222,33,46,358,210,87,13,0,0,13
15,273,542,14,259,129,93,26,25,7,104,141,21,249,24,34,80,76,83,23,55,307,110,47,28,0,0,28
16,5413,9764,1316,4097,2396,2078,570,369,456,2092,2710,155,5188,225,552,383,877,3601,394,478,6630,1752,510,151,0,0,151
17,4546,8144,1557,2989,2072,1778,441,255,718,2469,1258,101,4279,267,796,551,874,2325,286,333,5057,1796,672,281,92,0,189
18,1024,1910,358,666,498,363,100,63,100,538,316,70,921,103,93,247,239,445,58,63,1271,431,87,188,0,0,188
19,880,2023,166,714,360,370,82,68,86,462,272,60,791,89,231,76,85,488,55,116,1373,421,58,273,0,0,273
20,2228,4780,504,1724,1027,741,251,209,350,1151,614,113,1975,253,693,282,423,830,151,284,2813,1106,426,441,11,0,430
21,3612,5793,594,3018,2091,1133,227,161,1370,1572,585,85,3454,158,2028,255,551,778,94,156,2610,992,1941,219,10,0,209
22,1209,1957,93,1116,682,389,73,65,277,730,180,22,1092,117,106,165,253,685,48,74,1006,377,452,35,0,0,35
23,642,1277,319,323,273,238,66,65,147,387,96,12,580,62,182,93,85,282,63,130,385,331,368,23,0,0,23
24,489,865,50,439,258,131,57,43,234,156,94,5,382,107,398,41,0,50,21,69,153,243,379,11,0,0,11
25,1598,3586,38,1560,520,546,273,259,567,709,234,88,1211,387,1154,243,147,54,111,439,922,1014,1100,14,0,0,14
26,748,1589,21,727,315,215,100,118,180,372,158,38,656,92,454,138,118,38,36,153,556,432,412,9,0,0,9
27,1520,3068,165,1355,705,443,186,186,506,692,204,118,1355,165,879,267,165,209,75,253,1033,688,1019,39,0,0,39
28,1962,3441,452,1510,935,696,187,144,449,843,626,44,1796,166,377,347,416,822,94,128,1659,742,818,13,0,0,13
29,3235,5013,423,2812,1944,1000,186,105,595,1735,891,14,3022,213,962,866,678,729,79,152,3047,1056,679,97,79,0,18
30,3933,6991,208,3725,2333,1044,249,307,1259,2029,569,76,3549,384,2131,936,413,453,159,497,3580,1808,947,339,0,0,339
31,2717,4269,137,2580,1687,758,146,126,557,1427,679,54,2655,62,999,836,445,437,78,199,2531,949,512,134,14,0,120
32,3271,5494,310,2961,1804,1034,258,175,567,1621,905,178,3120,151,797,872,839,763,116,176,3062,1135,1005,47,0,0,47
33,2808,5442,458,2350,1260,967,329,252,657,972,1075,104,2572,236,940,464,518,886,169,240,3185,1013,835,23,0,0,23
34,2642,4670,513,2129,1238,986,257,161,460,1028,761,393,2518,124,565,306,607,1164,144,194,2708,818,806,0,0,0,0
35,2365,4573,545,1820,1023,854,274,214,464,791,874,236,2266,99,758,352,274,981,132,242,2357,888,954,0,0,0,0
36,2623,5564,167,2456,1009,925,414,275,937,1151,393,142,2294,329,1737,490,163,233,147,484,1864,1517,1552,93,0,0,93
37,1813,3554,161,1652,874,579,203,157,369,975,337,132,1641,172,855,359,272,327,69,216,1713,861,695,48,0,0,48
38,2366,4455,700,1666,988,887,295,196,496,1123,676,71,1958,408,512,349,285,1220,116,276,2274,998,791,14,0,0,14
39,2066,4084,526,1540,809,776,324,157,370,939,611,146,1833,233,411,327,435,893,118,231,2141,872,722,1,0,0,1
40,2594,4542,792,1802,1184,1011,236,163,391,1200,943,60,2401,193,359,271,681,1283,145,232,2414,893,858,25,0,0,25
41,2128,4004,386,1742,999,743,215,171,670,983,412,63,1780,348,1002,322,340,464,114,273,1887,846,884,88,0,0,88
42,643,2733,3,640,114,188,141,200,86,168,132,257,507,136,213,134,95,201,93,349,1291,749,251,637,0,68,569
43,3182,5635,644,2538,1548,1053,295,286,445,1591,1078,68,2745,437,397,359,794,1632,292,382,3334,1009,618,14,0,0,14
44,3674,6499,607,3067,1786,1312,370,206,400,1552,1452,270,3224,450,390,529,655,2100,222,268,4301,997,711,34,34,0,0
45,2463,4549,602,1861,1078,913,257,215,218,1359,638,248,2073,390,342,179,561,1381,194,276,2680,778,621,12,0,0,12
46,4040,7135,818,3222,1864,1554,379,243,658,2069,1066,247,3595,445,515,522,680,2323,312,307,4100,1357,1059,112,84,0,28
47,1718,2912,442,1276,916,556,115,131,243,1083,390,2,1594,124,262,287,359,810,106,208,1517,584,497,18,0,0,18
48,1998,3852,662,1336,822,735,222,219,291,1103,583,21,1743,255,284,150,548,1016,177,354,1968,791,562,12,0,0,12
49,2258,4464,859,1399,978,776,251,253,497,1168,539,54,2073,185,279,280,466,1233,195,496,1807,1100,866,18,9,0,9
50,2416,4643,699,1717,1082,829,255,250,291,1121,891,113,1919,497,219,258,290,1649,207,352,2516,890,678,40,0,0,40
51,2082,3769,521,1561,1003,733,187,159,257,930,852,43,1877,205,244,267,327,1244,169,272,2055,782,491,0,0,0,0
52,1354,3690,14,1340,334,323,298,399,136,430,577,211,860,494,68,219,187,880,199,623,1892,774,202,0,0,0,0
53,33,284,0,33,16,7,7,3,0,25,8,0,33,0,13,0,16,4,3,15,162,76,28,214,0,0,214
54,2792,6808,1372,1420,863,907,476,546,808,740,913,331,2136,656,725,583,488,996,255,751,2464,1842,1496,90,0,0,90
55,1534,3584,709,825,473,547,238,276,364,620,464,86,1269,265,363,373,274,524,132,395,1256,1005,796,0,0,0,0
56,50,110,27,23,16,19,8,7,12,20,15,3,41,9,5,11,7,27,2,8,22,22,56,0,0,0,0
57,943,2433,706,237,221,313,157,252,175,295,385,88,632,311,92,79,162,610,112,455,559,734,573,0,0,0,0
58,2448,5496,620,1828,821,835,409,383,601,935,732,180,1937,511,725,539,546,638,218,562,2271,1335,1110,54,0,0,54
59,3169,7914,1302,1867,878,1038,562,691,577,1104,1048,440,2400,769,639,587,642,1301,319,942,3028,2086,1539,21,0,0,21
60,1562,3823,634,928,468,497,240,357,350,559,543,110,1193,369,303,452,287,520,131,442,1448,985,817,6,0,0,6
61,1877,4435,577,1300,571,652,304,350,364,729,685,99,1414,463,504,383,371,619,186,453,1975,1024,797,0,0,0,0
62,3215,7386,980,2235,995,1106,564,550,631,1207,1256,121,2485,730,608,627,841,1139,351,905,3044,1778,1308,13,0,0,13
63,2162,5302,897,1265,593,724,421,424,329,678,1047,108,1555,607,285,303,596,978,250,612,2059,1300,1081,16,0,0,16
64,2854,6773,1016,1838,809,979,518,548,455,1102,1143,154,2162,692,608,543,427,1276,270,742,2982,1610,1169,14,0,0,14
65,2435,5539,698,1737,816,829,418,372,393,917,972,153,1932,503,285,561,349,1240,224,638,2433,1305,939,71,0,0,71
66,1998,4373,551,1447,661,716,284,337,356,573,709,360,1519,479,395,402,437,764,162,442,1986,990,793,0,0,0,0
67,2136,5048,618,1518,675,729,345,387,358,709,819,250,1587,549,296,391,422,1027,208,490,2489,1067,794,100,89,0,11
68,1462,3274,451,1011,467,523,262,210,417,570,317,158,1288,174,483,291,213,475,118,308,1575,667,606,31,0,0,31
69,2682,8184,816,1866,887,930,432,433,314,846,1091,431,2138,544,302,430,630,1320,269,1789,4237,1135,754,2257,2134,0,123
70,2884,6075,837,2047,995,1101,408,380,446,1103,1039,296,2370,514,477,406,595,1406,310,605,2962,1322,876,6,0,0,6
71,1936,4338,876,1060,693,612,247,384,444,930,462,100,1443,493,486,205,304,941,262,688,1511,1002,875,19,0,0,19
72,1102,2279,419,683,421,394,162,125,186,452,321,143,930,172,145,225,181,551,93,163,1249,433,341,27,0,0,27
73,2427,4089,518,1909,1273,770,195,189,721,903,519,284,2154,273,740,422,462,803,153,185,2028,785,938,0,0,0,0
74,2156,3697,169,1987,1213,624,158,161,1056,665,340,95,2089,67,926,210,401,619,85,194,1542,586,1290,54,0,0,54
75,1960,3067,562,1398,1138,618,116,88,535,925,444,56,1879,81,390,383,317,870,81,63,1641,482,800,16,0,0,16
76,1694,2969,402,1292,949,568,93,84,409,980,295,10,1694,0,514,270,513,397,55,85,1397,694,738,372,0,0,372
77,2128,4553,560,1568,814,762,340,212,446,888,592,202,1742,386,750,268,392,718,144,361,2296,770,982,236,0,0,236
78,2872,5660,206,2666,1354,881,288,349,1575,808,294,195,2618,254,1796,507,341,228,179,614,1991,1199,1677,40,0,0,40
79,2161,3558,294,1867,1229,642,163,127,197,1142,674,148,2094,67,338,461,269,1093,102,162,2178,766,350,67,1,0,66
80,1993,4296,353,1640,848,650,278,217,341,806,705,141,1750,243,527,334,380,752,152,342,2517,845,440,58,0,0,58
81,4190,8074,767,3423,1946,1433,457,354,415,1951,1466,358,3831,359,852,873,664,1801,295,478,4807,1794,700,224,0,0,224
82,1775,3419,485,1290,718,677,228,152,315,860,487,113,1573,202,452,327,184,812,94,200,1907,887,331,30,0,0,30
83,2106,3965,1012,1094,815,898,213,180,297,816,932,61,1840,266,260,158,275,1413,172,222,1709,1230,632,20,0,0,20
84,2317,4835,655,1662,858,910,288,261,175,589,1241,312,2032,285,237,242,356,1482,155,330,2862,1083,405,64,0,0,64
85,1854,3764,335,1519,712,720,256,166,147,757,707,243,1562,292,215,215,379,1045,118,175,2424,654,393,28,0,0,28
86,3290,6899,729,2561,1315,1138,413,424,533,1353,1201,203,2880,410,678,638,678,1296,273,644,3617,1447,918,105,0,0,105
87,2370,5125,582,1788,860,859,346,305,332,946,900,192,2034,336,399,325,498,1148,241,436,2870,941,637,144,24,0,120
88,2570,5483,490,2080,895,1003,353,319,228,1091,952,299,2348,222,414,368,529,1259,185,289,3575,949,485,91,19,0,72
89,3480,7687,1302,2178,1169,1308,488,515,440,1276,1538,226,2779,701,370,620,683,1807,404,802,3730,1776,975,138,0,0,138
90,2088,4592,606,1482,726,700,355,307,236,930,750,172,1827,261,253,470,776,589,208,304,2622,899,559,166,109,0,57
91,2307,5500,974,1333,731,865,325,386,477,1031,709,90,1865,442,437,261,309,1300,262,586,2672,1211,769,487,473,0,14
92,1021,2486,733,288,286,308,144,283,238,264,413,106,752,269,203,133,160,525,100,313,591,767,715,19,0,0,19
93,4197,7872,1496,2701,1655,1748,438,356,688,1828,1362,319,3835,362,690,780,903,1824,271,477,3651,2422,1051,6,0,0,6
94,1325,2653,586,739,460,544,203,118,203,497,550,75,1057,268,206,164,185,770,92,209,1173,801,378,14,0,0,14
95,1416,3015,764,652,474,549,197,196,243,565,561,47,1166,250,189,194,293,740,177,329,1221,839,449,10,0,0,10
96,1145,2562,618,527,342,398,183,222,119,498,497,31,868,277,83,208,239,615,176,301,1028,710,347,16,0,0,16
97,1604,3404,697,907,498,628,232,246,266,644,609,85,1322,282,239,195,230,940,202,308,1602,823,469,0,0,0,0
98,1896,4111,835,1061,595,724,300,277,248,832,703,113,1552,344,215,276,298,1107,205,413,1881,1011,601,0,0,0,0
99,2029,4213,500,1529,813,754,249,213,445,861,551,172,1767,262,428,315,401,885,172,260,2362,942,477,116,0,0,116
100,1821,4296,312,1509,662,596,250,313,214,747,691,169,1455,366,442,457,207,715,145,368,2317,1020,446,83,27,0,56
101,2950,6761,485,2465,1170,907,379,494,590,917,1041,402,2520,430,747,680,602,921,243,623,3672,1491,732,49,0,0,49
102,2705,5507,674,2031,1077,980,361,287,278,1009,1258,160,2370,335,418,343,560,1384,220,390,2971,1311,615,129,0,0,129
103,2721,5178,945,1776,1071,1108,309,233,614,899,928,280,2538,183,564,452,382,1323,170,299,2539,1487,683,32,0,0,32
104,1895,3624,458,1437,793,750,208,144,255,1065,504,71,1753,142,323,247,356,969,132,170,2057,874,391,23,0,0,23
105,3219,6363,543,2676,1469,1049,375,326,535,1152,1257,275,2850,369,779,521,521,1398,194,454,3314,1494,907,120,0,0,120
106,3214,6922,557,2657,1642,910,295,367,589,1107,1113,405,2995,219,885,536,711,1082,178,537,3539,1853,815,728,0,0,728
107,890,2841,216,674,308,304,122,156,61,441,325,63,734,156,190,151,187,362,80,218,1591,706,246,733,0,0,733
108,1256,2735,267,989,479,477,142,158,289,331,589,47,1113,143,454,145,91,566,105,326,1621,493,190,220,168,0,52
109,3516,7250,1118,2398,1185,1527,473,331,307,1384,1326,499,2911,605,751,395,283,2087,265,409,4750,1192,634,356,142,0,214
110,2989,7447,630,2359,863,1308,425,393,235,937,1768,49,2396,593,570,257,530,1632,527,609,5185,846,280,869,848,0,21
111,2376,5001,587,1789,887,1041,269,179,51,1060,1227,38,2063,313,117,202,523,1534,189,189,3777,693,153,575,551,0,24
112,1032,2194,406,626,332,405,144,151,113,440,351,128,876,156,185,126,129,592,90,178,1184,487,255,8,0,0,8
113,2477,5819,1086,1391,709,921,436,411,533,1049,777,118,2004,473,538,271,468,1200,283,766,2897,1306,567,22,0,0,22
114,1748,3796,879,869,541,685,269,253,222,610,797,119,1375,373,216,238,222,1072,225,307,1885,940,439,62,0,0,62
115,673,1834,180,493,173,238,119,143,50,312,217,94,543,130,101,204,79,289,72,152,869,509,232,131,0,0,131
116,1869,4956,715,1154,523,625,323,398,228,694,681,266,1411,458,335,340,324,870,194,584,2467,1207,504,186,0,0,186
117,1583,4356,494,1089,374,507,303,399,113,642,559,269,1110,473,248,221,406,708,191,505,2277,938,445,28,0,0,28
118,1427,4275,286,1141,310,424,265,428,163,423,613,228,957,470,455,303,296,373,175,604,2169,908,419,22,0,0,22
119,784,2283,292,492,141,253,174,216,109,209,322,144,617,167,163,90,126,405,80,258,1096,557,292,17,0,0,17
120,1123,3007,401,722,279,367,227,250,152,309,509,153,934,189,254,233,51,585,127,304,1484,733,359,35,0,0,35
121,1302,3364,847,455,300,459,249,294,164,534,542,62,919,383,148,362,282,510,210,369,1386,866,533,60,0,0,60
122,2092,5164,1277,815,494,782,422,394,455,661,805,171,1575,517,517,380,261,934,271,646,2004,1468,775,26,0,0,26
123,1743,4214,750,993,451,625,344,323,161,683,689,210,1376,367,211,315,443,774,223,457,1983,1072,479,23,0,0,23
124,1265,3331,564,701,350,377,238,300,107,436,657,65,800,465,214,302,177,572,175,489,1377,825,465,34,0,0,34
125,1036,2869,737,299,220,359,198,259,131,349,430,126,793,243,209,144,228,455,163,385,1037,828,456,6,0,0,6
126,1515,4488,781,734,293,483,300,439,202,482,582,249,851,664,333,232,238,712,244,688,1754,1126,676,0,0,0,0
127,1761,4091,1074,687,509,611,294,347,273,513,752,223,1424,337,146,225,312,1078,267,528,1494,1111,691,7,0,0,7
128,2467,5435,1000,1467,788,867,416,396,206,1013,1091,157,1913,554,226,366,542,1333,330,585,2569,1274,677,24,0,0,24
129,2099,4403,1252,847,749,730,303,317,282,988,737,92,1684,415,170,210,466,1253,227,477,1625,1257,817,0,0,0,0
130,1834,4222,1253,581,593,602,290,349,390,739,648,57,1293,541,449,293,312,780,191,613,1205,1221,992,0,0,0,0
131,2630,6760,2177,453,539,950,491,650,683,740,1093,114,1853,777,387,533,486,1224,380,1072,1814,2054,1440,0,0,0,0
132,1546,4192,1033,513,318,507,310,411,360,417,498,271,1144,402,315,255,300,676,179,607,1359,1217,830,0,0,0,0
133,2448,6305,1562,886,561,864,464,559,381,648,1062,357,1916,532,357,304,529,1258,325,723,2349,1734,1174,13,0,0,13
134,2480,8022,1509,971,438,695,460,887,330,888,643,619,1634,846,350,459,655,1016,326,1154,2871,2215,1456,46,0,0,46
135,1562,5553,790,772,250,369,301,642,173,519,507,363,1085,477,338,361,410,453,195,858,2061,1493,946,0,0,0,0
136,963,3027,678,285,189,239,184,351,142,248,362,211,752,211,194,180,194,395,108,372,1062,850,635,11,0,0,11
137,1566,5424,1072,494,261,424,279,602,152,395,724,295,1073,493,356,380,345,485,212,721,1903,1504,1084,20,0,0,20
138,2619,9267,1451,1168,433,601,483,1102,355,793,936,535,1963,656,537,699,675,708,361,1301,3242,2595,1768,32,0,0,32
139,1319,5412,898,421,205,275,227,612,285,256,294,484,836,483,325,469,318,207,238,809,1784,1551,1030,37,0,0,37
140,1188,4143,779,409,223,326,188,451,248,269,365,306,879,309,323,286,224,355,195,638,1458,1163,689,0,0,0,0
141,763,2732,260,503,187,214,102,260,118,258,214,173,477,286,158,219,174,212,152,511,1057,688,324,57,0,0,57
142,272,1183,32,240,95,102,45,30,90,80,90,12,199,73,98,57,43,74,38,83,594,384,84,564,0,0,564
143,436,1434,211,225,125,123,72,116,68,147,122,99,273,163,163,117,101,55,88,192,519,380,255,29,0,0,29
144,1495,4143,446,1049,407,411,324,353,378,702,293,122,1002,493,880,267,173,175,257,822,1496,1002,566,23,0,0,23
145,1365,4135,110,1255,375,339,236,415,402,676,166,121,748,617,1009,312,41,3,275,1213,1455,830,362,20,0,0,20
146,550,1340,322,228,149,188,99,114,69,269,197,15,357,193,99,108,154,189,98,183,645,295,119,0,0,0,0
147,1307,4987,697,610,238,324,282,463,230,268,451,358,863,444,320,300,304,383,300,924,1949,1227,587,184,0,0,184
148,1129,4110,397,732,221,228,261,419,245,489,133,262,601,528,503,137,254,235,237,869,1538,1001,465,22,0,0,22
149,1601,5044,930,671,325,469,300,507,253,519,566,263,1109,492,421,401,259,520,275,819,1955,1313,682,110,0,0,110
150,1370,4369,606,764,352,348,196,474,339,399,385,247,937,433,529,302,346,193,238,672,1543,1097,819,106,0,0,106
151,618,2030,302,316,168,114,93,243,177,108,237,96,466,152,270,82,116,150,95,270,754,568,343,18,0,0,18
152,1391,4454,1001,390,281,357,230,523,248,424,451,268,1069,322,250,258,325,558,190,551,1508,1262,943,37,0,0,37
153,1084,3988,749,335,159,242,228,455,150,279,350,305,778,306,219,308,235,322,184,575,1348,1174,707,0,0,0,0
154,1061,4015,616,445,156,210,209,486,191,336,377,157,871,190,292,282,255,232,156,577,1289,1216,777,11,0,0,11
155,1016,3954,608,408,124,227,206,459,156,351,261,248,604,412,223,338,211,244,189,651,1278,1070,766,12,0,0,12
156,740,3100,352,388,89,149,160,342,85,231,201,223,490,250,218,225,164,133,139,552,1106,866,437,0,0,0,0
157,709,2556,193,516,105,187,152,265,201,286,105,117,405,304,424,130,79,76,138,639,880,601,298,0,0,0,0
158,385,1052,77,308,105,107,57,116,169,104,57,55,282,103,263,54,17,51,48,233,334,226,211,1,0,0,1
159,1434,4760,939,495,228,340,311,555,354,356,492,232,1082,352,368,454,346,266,177,681,1617,1345,940,26,0,0,26
160,1361,4890,899,462,201,329,268,563,113,524,494,230,887,474,151,581,309,320,180,767,1725,1353,865,0,0,0,0
161,1163,4162,690,473,172,297,207,487,130,269,475,289,839,324,193,378,226,366,159,624,1475,1166,738,6,0,0,6
162,1316,4761,763,553,210,295,235,576,268,396,477,175,926,390,344,450,316,206,180,653,1636,1314,978,17,0,0,17
163,1227,4449,785,442,198,310,239,480,196,314,358,359,783,444,199,440,212,376,176,649,1521,1236,867,4,0,0,4
164,1958,7520,1180,778,288,447,366,857,232,535,606,585,1362,596,366,445,514,633,334,1123,2619,2110,1334,32,0,0,32
165,1938,6797,1076,862,324,467,340,807,225,570,740,403,1314,624,448,499,432,559,309,897,2490,1856,1245,0,0,0,0
166,2704,9107,1566,1138,491,710,435,1068,312,931,901,560,2038,666,739,611,565,789,339,1173,3631,2346,1618,35,0,0,35
167,1919,7260,1243,676,308,453,366,792,194,484,678,563,1135,784,411,445,467,596,337,1049,2895,1809,1170,60,0,0,60
168,3050,9459,2020,1030,628,835,529,1058,474,1209,835,532,2458,592,608,774,845,823,374,1171,3733,2477,1704,36,0,0,36
169,2294,6664,1990,304,377,744,469,704,363,868,787,276,1522,772,330,526,304,1134,274,1029,1802,1913,1646,18,11,0,7
170,2170,5894,1626,544,468,709,404,589,476,673,776,245,1538,632,290,351,385,1144,256,955,1624,1695,1364,41,0,0,41
171,913,2442,758,155,187,301,170,255,123,350,369,71,691,222,59,93,185,576,117,406,659,746,514,12,0,0,12
172,1953,5306,1446,507,388,669,350,546,701,535,539,178,1551,402,283,393,473,804,244,786,1567,1505,1204,0,0,0,0
173,1375,3633,971,404,283,449,264,379,257,432,489,197,1054,321,184,226,242,723,139,493,1170,1006,825,0,0,0,0
174,2431,6019,1296,1135,599,831,459,542,468,999,780,184,1887,544,522,340,385,1184,289,683,2503,1412,1132,14,0,0,14
175,2121,4507,454,1667,755,741,304,321,335,906,771,109,1766,355,254,481,494,892,183,350,2513,841,620,12,0,0,12
176,1868,3988,483,1385,645,684,272,267,374,832,534,128,1445,423,484,333,437,614,166,307,1975,898,642,55,43,0,12
177,3300,8701,1387,1913,876,971,652,801,508,1215,1186,391,2571,729,571,650,748,1331,355,931,3664,2067,1684,129,0,0,129
178,2382,6472,1433,949,502,755,465,660,433,939,654,356,1904,478,535,476,442,929,288,727,2370,1667,1420,16,0,0,16
179,2724,7803,1533,1191,517,809,542,856,514,862,908,440,1937,787,476,714,481,1053,336,949,2963,2077,1478,7,0,0,7
180,1765,4353,573,1192,510,571,302,382,219,711,552,283,1272,493,484,442,378,461,181,472,1954,1046,700,4,0,0,4
181,1907,5288,1109,798,413,570,386,538,327,592,712,276,1449,458,378,367,492,670,260,658,2028,1356,986,0,0,0,0
182,2397,6696,1470,927,540,757,478,622,505,861,660,371,1570,827,452,373,591,981,287,820,2400,1815,1374,17,0,0,17
183,2491,7360,1584,907,465,729,509,788,566,651,867,407,1798,693,632,311,623,925,327,967,2572,1937,1557,24,0,0,24
184,3038,8851,2052,986,551,887,622,978,653,984,867,534,2311,727,548,661,702,1127,354,1108,3039,2309,2041,8,0,0,8
185,2896,8224,1658,1238,627,855,541,873,684,902,704,606,2286,610,659,651,603,983,308,977,3050,2115,1774,7,0,0,7
186,2699,7891,1830,869,521,810,509,859,466,994,811,428,1958,741,334,628,541,1196,291,1100,2660,2092,1748,29,0,0,29
187,1432,4010,1147,285,280,423,277,452,361,411,473,187,950,482,303,243,224,662,130,664,1082,1198,936,0,0,0,0
188,542,1862,14,528,208,165,79,90,64,212,116,150,490,52,258,83,126,75,32,487,914,217,212,626,574,0,52
189,3173,7719,127,3046,945,1021,615,592,858,1511,424,380,2803,370,1332,635,582,624,353,1065,3550,1595,1156,0,0,0,0
190,1319,2358,239,1080,667,361,140,151,335,717,194,73,1052,267,348,406,330,235,83,207,1019,579,470,42,0,0,42
191,1430,4039,1068,362,271,455,301,403,346,382,542,160,1066,364,271,348,297,514,201,532,1356,1128,822,13,0,0,13
192,2635,7648,161,2474,514,744,588,789,229,977,872,557,1685,950,833,894,693,215,423,1228,3656,1624,717,10,0,0,10
193,2154,6801,1150,1004,361,558,423,812,227,644,908,375,1304,850,396,517,589,652,359,1060,2511,1802,1069,76,0,0,76
194,1990,7203,1193,797,326,510,372,782,366,510,631,483,1485,505,335,556,561,538,274,959,2490,1946,1534,194,0,0,194
195,1773,5598,1242,531,322,459,353,639,205,506,605,457,1313,460,227,348,492,706,247,790,1880,1596,1085,9,0,0,9
196,1907,6466,1452,455,293,496,362,756,210,476,859,362,1351,556,198,605,466,638,288,890,2373,1746,1169,7,0,0,7
197,1548,5897,1042,506,228,366,254,700,193,384,382,589,1149,399,343,265,316,624,220,817,2051,1606,1203,18,0,0,18
198,1679,5055,264,1415,369,415,336,559,156,510,696,317,1207,472,559,382,393,345,229,811,2091,1141,783,0,0,0,0
199,1147,2492,758,389,404,337,170,236,61,543,472,71,980,167,141,365,410,231,99,262,994,744,393,1,0,0,1
200,961,2853,655,306,220,225,155,361,126,363,320,152,703,258,208,315,247,191,129,431,861,847,585,26,26,0,0
201,2776,8611,783,1993,566,702,479,1029,427,729,1229,391,1669,1107,1103,581,726,366,413,1497,3350,2053,1298,36,0,0,36
202,2226,7648,1375,851,341,573,442,870,389,541,664,632,1600,626,414,646,518,648,362,1144,2932,1934,1276,20,0,0,20
203,1554,5464,733,821,232,397,264,661,167,583,378,426,1154,400,332,466,453,303,264,889,2101,1434,776,0,0,0,0
204,2163,7842,1014,1149,359,489,392,923,331,497,1012,323,1673,490,710,395,572,486,345,1159,3128,1924,1286,59,0,0,59
205,2401,8275,1684,717,412,586,403,1000,360,660,563,818,1832,569,441,440,808,712,383,1170,3020,2315,1387,13,0,0,13
206,1212,3817,919,293,199,340,262,411,325,221,392,274,898,314,273,180,265,494,159,548,1324,1114,672,0,0,0,0
207,1169,4356,660,509,166,252,224,527,135,287,416,331,752,417,325,278,267,299,205,763,1549,1160,679,0,0,0,0
208,2194,5474,1406,788,537,703,378,576,492,730,847,125,1652,542,431,425,392,946,318,781,1884,1631,860,14,0,0,14
209,2547,7790,1857,690,475,688,503,881,275,908,1029,335,1836,711,282,654,650,961,375,1133,2686,2174,1422,19,0,0,19
210,1052,3883,308,744,154,198,210,490,149,322,317,264,628,424,339,305,251,157,241,849,1537,868,388,0,0,0,0
211,2881,8786,430,2451,665,824,436,956,404,1166,833,478,1912,969,760,1147,411,563,469,1561,3675,2014,1067,83,0,0,83
212,1236,4228,686,550,192,299,231,514,97,415,350,374,787,449,297,145,286,508,180,787,1454,1189,618,25,0,0,25
213,2670,6924,1488,1182,797,766,476,631,647,632,1053,338,2099,571,574,608,691,797,329,952,2139,1861,1643,31,0,0,31
214,2037,6366,1569,468,340,582,407,708,280,533,967,257,1553,484,341,518,583,595,351,971,2050,1804,1190,62,0,0,62
215,2161,6188,839,1322,443,611,419,688,268,806,905,182,1517,644,419,589,599,554,317,984,2401,1589,897,12,0,0,12
216,1500,3770,861,639,434,482,247,337,171,547,678,104,1083,417,340,293,418,449,193,461,1517,990,609,7,0,0,7
217,1328,4239,1098,230,186,414,279,449,159,286,679,204,831,497,130,214,371,613,222,622,1397,1169,829,64,0,0,64
218,1353,4119,777,576,278,401,203,471,287,377,410,279,1020,333,397,346,226,384,201,547,1465,1051,855,18,0,0,18
219,1915,6899,1418,497,226,484,359,846,326,569,574,446,1399,516,347,382,460,726,313,912,2392,1700,1582,11,0,0,11
220,1879,5994,1123,756,299,555,339,686,175,613,754,337,1239,640,367,349,528,635,328,1068,2222,1550,826,20,0,0,20
221,1515,4707,1053,462,282,431,314,488,228,328,675,284,1004,511,285,222,374,634,226,750,1658,1245,828,0,0,0,0
222,1774,4429,927,847,473,619,314,368,248,664,578,284,1293,481,297,414,401,662,212,554,1760,1247,656,12,0,0,12
223,1935,4597,921,1014,557,718,315,345,189,886,706,154,1581,354,334,445,482,674,223,601,1686,1318,769,31,0,0,31
224,1273,3352,1060,213,225,446,251,351,144,541,419,169,901,372,170,195,223,685,170,552,876,1083,671,0,0,0,0
225,1434,3939,1083,351,239,479,285,431,271,578,459,126,1037,397,232,312,330,560,240,677,1160,1200,662,0,0,0,0
226,2413,6509,1909,504,433,834,491,655,426,730,955,302,1781,632,248,584,667,914,326,1091,1828,1939,1325,14,0,0,14
227,2102,5561,1637,465,471,681,412,538,660,529,710,203,1395,707,299,561,447,795,257,903,1429,1533,1439,0,0,0,0
228,73,251,59,14,6,16,21,30,8,22,27,16,46,27,4,2,26,41,8,39,95,77,32,1,0,0,1
229,1851,5652,1194,657,253,576,395,627,196,543,716,396,1162,689,189,243,457,962,255,915,2063,1537,882,24,0,0,24
230,2874,8871,1974,900,502,771,580,1021,445,778,1162,489,2010,864,536,523,569,1246,480,1262,3204,2327,1598,10,0,0,10
231,1494,5148,1240,254,182,421,312,579,197,443,478,376,1098,396,253,224,331,686,223,757,1723,1301,1144,72,0,0,72
232,1804,5649,1411,393,282,541,374,607,378,547,638,241,1248,556,391,398,395,620,248,864,1822,1574,1141,127,0,0,127
233,3223,7558,2237,986,997,1006,501,719,545,1381,1137,160,2379,844,507,827,846,1043,412,998,2543,2145,1460,7,0,0,7
234,1922,3565,476,1446,817,701,221,183,252,942,600,128,1571,351,519,419,481,503,138,245,1920,694,568,0,0,0,0
235,1161,3314,903,258,224,360,177,400,208,272,524,157,783,378,172,223,282,484,198,537,1075,930,574,13,0,0,13
236,2197,5668,1203,994,596,685,334,582,522,509,1012,154,1585,612,318,638,483,758,269,860,2058,1517,964,42,0,0,42
237,2614,8086,729,1885,509,695,528,882,221,884,793,716,1702,912,674,639,768,533,438,1464,3299,2009,876,31,0,0,31
238,1120,4197,646,474,183,233,214,490,123,182,476,339,608,512,122,304,315,379,219,772,1621,1078,507,0,0,0,0
239,0,0,0,0,0,0,0,0,0,0,0,0,0,0,0,0,0,0,0,0,0,0,0,0,0,0,0
240,1886,5153,687,1199,414,603,363,506,237,785,647,217,1308,578,472,318,514,582,294,802,1976,1316,765,42,0,0,42
241,1299,3627,972,327,296,363,221,419,303,426,405,165,798,501,270,204,298,527,166,644,913,1010,894,24,0,0,24
242,945,2808,831,114,151,272,190,332,250,156,378,161,657,288,147,154,208,436,134,524,709,805,636,0,0,0,0
243,977,2879,779,198,153,291,212,321,138,284,455,100,690,287,165,99,149,564,110,458,808,850,653,9,0,0,9
244,1890,5203,793,1097,413,540,362,575,375,446,834,235,1307,583,433,294,432,731,241,901,1681,1472,908,20,0,0,20
245,1272,3462,945,327,264,391,215,402,353,436,394,89,878,394,279,367,193,433,163,570,982,971,776,26,0,0,26
246,2918,8166,1768,1150,585,883,536,914,515,904,1260,239,1934,984,493,483,399,1543,391,1666,2168,2203,1738,129,0,0,129
247,1300,3843,987,313,196,351,245,508,292,440,506,62,869,431,182,163,292,663,207,941,910,1173,612,10,0,0,10
248,1394,3339,526,868,441,422,195,336,191,524,608,71,887,507,265,267,333,529,175,615,1212,920,417,76,0,0,76
249,2521,6234,1048,1473,705,851,386,579,241,1159,908,213,1808,713,349,367,693,1112,333,1155,2325,1598,823,14,0,0,14
250,1927,4979,1035,892,488,579,330,530,282,837,692,116,1138,789,295,296,410,926,288,1025,1539,1325,802,49,0,0,49
251,2738,5490,705,2033,1125,923,280,410,370,1363,910,95,2179,559,512,713,495,1018,292,722,2299,1335,842,5,0,0,5
252,1909,5882,1746,163,219,646,287,757,255,759,745,150,1004,905,202,150,171,1386,208,1424,1133,1754,1363,11,0,0,11
253,969,2570,731,238,168,381,154,266,228,281,377,83,673,296,125,86,268,490,78,504,638,791,559,0,0,0,0
254,1865,5744,1737,128,197,606,331,731,334,583,740,208,1176,689,80,253,222,1310,200,1310,1104,1816,1314,0,0,0,0
255,1277,3511,1066,211,222,440,205,410,282,442,470,83,806,471,154,118,250,755,165,800,759,1054,733,2,0,0,2
256,2470,4961,828,1642,993,892,274,311,614,1030,822,4,1979,491,639,442,307,1082,243,562,1963,1059,1134,10,0,0,10
257,1754,3939,774,980,740,531,204,279,526,592,547,89,1406,348,364,444,320,626,235,467,1496,870,871,149,0,0,149
258,2872,6507,731,2141,1062,953,376,481,415,1123,1151,183,2286,586,747,577,744,804,344,833,2881,1497,952,118,0,0,118
259,2202,5372,913,1289,777,613,342,470,292,1110,574,226,1641,561,546,544,539,573,345,829,2239,1245,714,17,0,0,17
260,2453,8379,815,1638,473,705,428,847,279,783,985,406,1509,944,754,528,440,731,506,1584,3707,1712,870,51,0,0,51
261,1390,4380,828,562,241,373,305,471,174,340,645,231,819,571,281,233,487,389,289,831,1671,1037,552,8,0,0,8
262,1194,3969,704,490,210,378,212,394,97,570,265,262,935,259,281,186,293,434,205,653,1518,1055,538,89,0,0,89
263,797,2934,621,176,91,213,159,334,128,225,236,208,503,294,155,101,239,302,157,467,1027,822,461,121,0,0,121
264,1030,3228,840,190,158,297,202,373,168,281,464,117,725,305,152,150,209,519,155,561,985,941,586,75,0,0,75
265,1809,3518,917,892,737,612,251,209,268,1050,468,23,1469,340,357,408,447,597,206,298,1521,833,660,0,0,0,0
266,3011,7059,1127,1884,828,1079,516,588,449,1224,1117,221,2017,994,575,338,510,1588,415,1032,2810,1420,1382,120,0,0,120
267,1305,3736,786,519,199,388,283,435,262,468,509,66,800,505,175,161,322,647,193,717,1184,972,670,48,0,0,48
268,1282,3630,768,514,222,357,277,426,181,401,575,125,790,492,47,226,250,759,190,746,1184,919,591,0,0,0,0
269,1594,4042,692,902,369,509,289,427,181,760,576,77,1102,492,192,232,375,795,223,700,1592,952,575,4,0,0,4
270,1272,3173,703,569,315,402,265,290,184,587,442,59,830,442,154,182,275,661,182,521,1191,709,570,0,0,0,0
271,2073,5578,1268,805,382,681,443,567,359,890,737,87,1277,796,284,284,460,1045,340,987,1983,1309,959,47,0,0,47
272,774,2314,616,158,104,251,153,266,141,206,365,62,496,278,43,131,141,459,107,478,564,667,498,3,0,0,3
273,1581,4245,849,732,272,553,320,436,189,600,735,57,977,604,215,242,403,721,264,726,1522,1119,614,0,0,0,0
274,2127,5656,739,1388,564,731,354,478,281,833,773,240,1733,394,367,381,547,832,328,808,2738,1147,635,0,0,0,0
275,1864,4765,725,1139,455,619,340,450,361,603,781,119,1377,487,489,283,378,714,301,706,2107,1104,547,12,0,0,12
276,1225,2819,592,633,354,444,164,263,229,320,590,86,966,259,223,211,382,409,147,346,1240,641,445,3,0,0,3
277,1738,4948,1084,654,318,534,378,508,186,505,747,300,1073,665,257,223,500,758,302,858,1830,1319,639,74,0,0,74
278,2522,6515,940,1582,536,950,509,527,147,1034,1283,58,1743,779,288,387,484,1363,541,953,3190,1341,490,176,0,0,176
279,1733,4521,864,869,384,598,319,432,208,878,603,44,1236,497,273,515,366,579,297,762,1807,1113,542,19,0,0,19
280,1339,3482,716,623,298,432,247,362,212,473,530,124,912,427,103,241,261,734,201,616,1142,1021,502,0,0,0,0
281,2037,4803,897,1140,662,626,307,442,387,706,840,104,1601,436,569,236,425,807,254,680,1714,1229,926,61,0,0,61
282,979,2576,741,238,245,282,147,305,189,328,373,89,638,341,146,170,181,482,150,519,632,748,527,0,0,0,0
283,1312,3567,1100,212,239,457,233,383,173,354,550,235,853,459,163,194,117,838,205,593,930,1044,795,47,0,0,47
284,1761,4913,361,1400,423,536,311,491,173,759,625,204,1272,489,352,422,434,553,342,782,2144,1050,595,21,0,0,21
285,1099,2974,944,155,202,359,233,305,173,369,433,124,734,365,118,112,130,739,196,480,830,889,579,1,0,0,1
286,2672,7336,1858,814,585,865,487,735,317,969,1271,115,1762,910,305,375,428,1564,387,1420,2448,1933,1148,370,322,0,48
287,985,2580,654,331,194,318,160,313,200,292,419,74,645,340,177,169,190,449,119,483,726,726,526,50,17,0,33
288,3027,7249,1147,1880,849,1063,435,680,562,1219,1204,42,1949,1078,592,539,603,1293,373,1227,2654,1788,1207,80,0,0,80
289,2131,6117,1911,220,301,658,425,747,268,579,1113,171,1131,1000,127,106,341,1557,304,1333,1469,1871,1140,0,0,0,0
290,1458,3659,873,585,335,518,261,344,304,580,465,109,1047,411,234,225,293,706,218,584,1092,1016,749,0,0,0,0
291,1218,3151,892,326,235,421,243,319,205,356,586,71,769,449,128,185,250,655,156,530,854,928,683,8,0,0,8
292,875,2430,733,142,141,293,139,302,132,313,342,88,584,291,85,133,135,522,126,482,556,734,532,0,0,0,0
293,2134,5928,1768,366,384,821,377,552,398,777,614,345,1658,476,210,552,452,920,264,988,1587,1803,1286,31,0,0,31
294,2396,6054,1814,582,495,924,430,547,279,1286,551,280,1877,519,310,257,500,1329,263,916,1529,2090,1256,11,0,0,11
295,1364,4148,930,434,252,450,243,419,212,405,635,112,990,374,128,301,386,549,231,750,1292,1162,713,13,0,0,13
296,3610,9212,2358,1252,1083,1236,444,847,708,1444,926,532,2671,939,766,569,837,1438,393,1518,2329,2694,2278,101,0,0,101
297,1667,4277,1000,667,478,607,246,336,199,577,665,226,1233,434,198,277,235,957,194,564,1273,1321,925,106,0,0,106
298,2620,6830,2094,526,532,966,412,710,720,1009,717,174,2113,507,242,268,479,1631,246,1289,1253,2057,1985,4,0,0,4
299,1151,3134,925,226,223,399,182,347,223,407,458,63,698,453,189,85,127,750,131,579,669,1004,751,0,0,0,0
300,958,2632,842,116,151,340,168,299,141,356,394,67,637,321,84,118,62,694,90,504,527,881,630,0,0,0,0
301,2196,6073,1794,402,371,756,403,666,337,674,999,186,1307,889,56,330,501,1309,389,1098,1637,1810,1139,42,0,0,42
302,1618,4411,1439,179,251,622,298,447,221,450,889,58,1014,604,100,193,130,1195,219,731,1053,1427,981,24,0,0,24
303,1678,4690,1347,331,279,583,301,515,324,562,660,132,1137,541,184,262,289,943,304,754,1391,1389,852,26,0,0,26
304,2106,5514,1829,277,410,783,387,526,322,863,772,149,1513,593,164,299,297,1346,257,940,1239,1797,1281,89,0,0,89
305,721,1993,625,96,114,251,148,208,111,244,315,51,446,275,78,56,82,505,126,391,507,584,385,2,0,0,2
306,1338,3591,1012,326,227,441,265,405,203,499,489,147,798,540,168,155,272,743,206,689,963,1083,650,10,0,0,10
307,1787,5205,1546,241,258,531,360,638,224,676,716,171,1046,741,171,251,251,1114,289,1132,1344,1548,892,2,0,0,2
308,1618,4540,1266,352,315,459,286,558,183,394,874,167,852,766,163,199,324,932,271,1044,1186,1385,654,8,0,0,8
309,3644,8395,1651,1993,1150,1176,540,778,472,1473,1443,256,2551,1093,490,630,864,1660,491,1361,3186,2115,1242,42,0,0,42
310,672,1817,452,220,148,177,155,192,73,227,321,51,458,214,104,114,76,378,129,320,618,551,199,19,0,0,19
311,1736,4104,1261,475,499,568,301,368,258,717,704,57,1111,625,229,226,385,896,218,688,1248,1202,748,17,0,0,17
312,3287,8677,2085,1202,640,1059,668,920,498,1438,1253,98,2212,1075,540,291,593,1863,430,1783,2829,2636,999,2,0,0,2
313,1635,4054,800,835,473,650,197,315,101,752,599,183,1122,513,322,364,296,653,167,472,1942,1090,383,152,0,0,152
314,1898,6206,413,1485,433,433,333,699,218,681,703,296,1276,622,623,655,347,273,353,1271,2583,1376,623,78,0,0,78
315,2370,4866,57,2313,812,1129,214,215,212,943,1143,72,2146,224,407,412,490,1061,182,348,3312,720,304,202,0,0,202
316,993,2635,386,607,233,347,172,241,99,329,451,114,714,279,227,209,242,315,143,422,1219,612,239,17,0,0,17
317,2236,5380,895,1341,641,796,346,453,232,1007,872,125,1604,632,265,438,612,921,289,786,2183,1418,704,27,0,0,27
318,1064,2934,788,276,214,310,201,339,139,374,485,66,602,462,128,144,120,672,157,660,791,882,444,1,0,0,1
319,1186,3359,991,195,179,410,242,355,232,352,511,91,871,315,179,108,224,675,185,588,875,1039,672,11,0,0,11
320,2219,5803,990,1229,541,724,427,527,254,793,934,238,1411,808,330,540,393,956,370,873,2254,1512,794,41,0,0,41
321,1054,3013,864,190,175,315,191,373,216,273,484,81,677,377,168,93,209,584,208,514,935,818,538,16,0,0,16
322,1952,4890,1389,563,467,662,336,487,347,725,727,153,1484,468,267,316,290,1079,295,766,1434,1415,980,2,0,0,2
323,1789,5271,656,1133,465,524,299,501,228,810,572,179,1160,629,425,488,342,534,299,806,2078,1135,953,288,0,0,288
324,1413,4061,195,1218,338,418,236,421,111,482,628,192,787,626,387,473,314,239,260,765,1826,852,358,6,0,0,6
325,2163,6203,671,1492,466,643,405,649,146,1010,750,257,1618,545,483,604,478,598,384,1124,2682,1430,583,22,0,0,22
326,855,2747,90,765,163,197,181,314,64,346,276,169,525,330,264,349,142,100,153,588,1300,555,151,38,0,0,38
327,1507,5540,388,1119,255,272,300,680,144,630,436,297,746,761,440,357,392,318,340,1264,2213,1268,455,134,0,0,134
328,1154,3370,775,379,255,351,205,343,198,372,396,188,836,318,202,155,255,542,173,579,1200,928,490,0,0,0,0
329,1277,4589,644,633,219,286,227,545,128,520,380,249,858,419,329,373,344,231,258,973,1760,1106,492,71,0,0,71
330,1627,5496,670,957,298,386,293,650,146,485,570,426,837,790,503,408,365,351,357,1126,2180,1266,567,23,0,0,23
331,1998,6437,678,1320,509,517,319,653,185,721,573,519,1366,632,423,468,427,680,399,1174,2998,1294,572,13,0,0,13
332,956,4463,577,379,79,169,150,558,78,293,291,294,542,414,168,263,288,237,238,964,1837,976,448,25,0,0,25
333,2663,10800,1321,1342,369,476,440,1378,112,737,1004,810,1713,950,368,621,596,1078,676,2317,4333,2481,993,76,0,0,76
334,1653,7369,758,895,228,302,257,866,208,356,617,472,962,691,378,590,333,352,431,1558,3047,1614,719,28,0,0,28
335,2764,8361,434,2330,707,531,399,1127,229,1644,518,373,1819,945,1039,664,476,585,535,2136,3537,1645,508,9,0,0,9
336,1627,4352,1020,607,354,492,292,489,188,743,575,121,999,628,192,191,295,949,247,907,1358,1224,616,0,0,0,0
337,567,1477,331,236,146,172,80,169,65,260,200,42,348,219,76,62,118,311,68,285,413,447,264,0,0,0,0
338,815,2466,652,163,142,205,129,339,75,279,376,85,474,341,68,113,124,510,162,635,644,704,321,65,0,0,65
339,895,2649,800,95,124,295,179,297,181,330,308,76,550,345,67,53,74,701,83,575,494,848,649,0,0,0,0
340,2018,4758,792,1226,561,694,304,459,260,968,653,137,1387,631,351,186,579,902,314,789,1981,1081,593,23,0,0,23
341,2122,4529,553,1569,782,685,298,357,366,836,881,39,1457,665,376,394,409,943,301,595,1936,947,750,8,0,0,8
342,1328,4453,1168,160,204,502,220,402,294,567,387,80,931,397,140,110,219,859,106,1016,1026,1128,1177,592,535,0,57
343,805,2334,676,129,119,281,131,274,139,363,297,6,468,337,80,64,122,539,101,524,466,752,491,13,0,0,13
344,1144,3360,1006,138,182,328,203,431,121,446,526,51,569,575,144,92,91,817,146,945,583,1095,591,0,0,0,0
345,1740,4626,1309,431,396,525,307,512,295,647,727,71,1012,728,153,225,212,1150,234,1052,1113,1333,894,10,0,0,10
346,1348,3359,913,435,328,484,209,327,318,487,445,98,958,390,174,152,199,823,119,670,933,810,827,0,0,0,0
347,2792,7669,2496,296,488,1065,462,777,757,793,1075,167,2162,630,299,394,301,1798,195,1260,1443,2369,2402,81,0,0,81
348,0,0,0,0,0,0,0,0,0,0,0,0,0,0,0,0,0,0,0,0,0,0,0,0,0,0,0
349,362,994,266,96,66,98,63,135,54,82,150,76,238,124,51,23,37,251,49,190,284,268,203,4,0,0,4
350,987,3590,882,105,174,371,145,297,195,411,297,84,728,259,57,108,78,744,91,554,1441,736,768,960,958,0,2
351,2074,4775,803,1271,699,677,311,387,372,648,927,127,1508,566,367,265,324,1118,198,825,1688,1147,917,23,0,0,23
352,419,2751,6,413,90,223,65,41,105,210,97,7,370,49,158,226,29,6,46,70,2479,152,4,1821,1818,0,3
353,1927,6228,29,1898,857,781,136,153,481,968,448,30,1704,223,1045,503,163,216,229,318,5402,264,15,2844,2839,0,5
354,953,5294,6,947,591,257,38,67,238,479,221,15,843,110,600,210,106,37,28,170,4835,247,14,3723,3717,0,6
355,2101,7028,155,1946,1018,611,224,248,440,1078,559,24,1650,451,392,463,446,800,244,550,4885,528,821,3144,3128,0,16
356,3867,7706,1211,2656,1735,1197,425,510,944,1644,1147,132,3188,679,1096,534,612,1625,302,992,2806,1722,1884,23,0,0,23
357,1700,4706,1301,399,294,583,321,502,190,731,608,171,1033,667,87,79,354,1180,188,1037,1052,1433,996,20,0,0,20
358,1882,5513,1562,320,246,596,352,688,419,686,704,73,1135,747,255,189,243,1195,174,1315,1106,1795,1123,0,0,0,0
359,1300,3649,923,377,208,445,255,392,189,428,625,58,723,577,96,63,145,996,124,749,923,1083,770,15,0,0,15
360,1993,5404,1142,851,400,615,367,611,388,737,717,151,1439,554,221,273,469,1030,224,1116,1641,1497,926,0,0,0,0
361,2425,6939,1364,1061,474,666,472,813,223,942,910,350,1187,1238,194,281,481,1469,329,1616,2149,1936,909,6,0,0,6
362,2138,5999,1533,605,439,602,389,708,378,715,967,78,1172,966,243,170,349,1376,251,1343,1452,1652,1301,6,0,0,6
363,1104,2781,559,545,303,321,182,298,179,350,358,217,621,483,230,87,158,629,80,576,774,757,594,0,0,0,0
364,692,1971,521,171,117,211,133,231,163,259,230,40,452,240,66,70,80,476,89,459,433,567,423,4,0,0,4
365,1801,3754,308,1493,748,500,258,295,186,937,548,130,1473,328,349,289,477,686,151,579,1803,869,352,0,0,0,0
366,2185,5487,810,1375,623,635,372,555,242,962,902,79,1628,557,288,395,320,1182,247,1095,2049,1393,703,20,0,0,20
367,2333,6286,1356,977,516,744,439,634,424,842,948,119,1616,717,371,331,497,1134,254,1300,1717,1808,1207,0,0,0,0
368,1422,4285,1235,187,147,476,268,531,360,556,390,116,1070,352,143,223,199,857,115,906,851,1333,1080,4,0,0,4
369,1957,5169,1436,521,480,580,283,614,585,453,861,58,1250,707,209,248,307,1193,165,1119,939,1491,1455,12,0,0,12
370,1757,4621,1259,498,392,563,272,530,387,656,665,49,1101,656,222,156,250,1129,197,1030,974,1389,1031,0,0,0,0
371,1322,3652,975,347,235,402,242,443,168,509,544,101,788,534,99,121,161,941,152,815,977,1109,599,7,0,0,7
372,2815,6651,817,1998,891,913,476,535,323,1522,854,116,2075,740,495,356,722,1242,399,1055,3401,1194,602,19,0,0,19
373,1234,3142,771,463,286,367,232,349,189,471,505,69,844,390,212,228,175,619,202,537,948,851,604,1,0,0,1
374,1290,3282,529,761,330,467,247,246,119,484,579,108,915,375,209,199,294,588,248,392,1696,711,235,40,0,0,40
375,1815,3550,491,1324,786,593,217,219,340,646,701,128,1452,363,470,191,307,847,204,317,1678,612,739,0,0,0,0
376,1807,4655,826,981,521,579,308,399,184,730,729,164,1331,476,298,270,314,925,280,667,1932,1089,687,64,0,0,64
377,2543,5324,990,1553,937,914,375,317,326,1193,851,173,2041,502,258,581,591,1113,286,502,2901,1067,568,28,0,0,28
378,1666,3601,425,1241,494,685,279,208,168,763,686,49,1320,346,230,242,302,892,224,363,1913,813,288,40,0,0,40
379,2373,5553,461,1912,778,795,360,440,218,1158,790,207,1879,494,446,532,421,974,315,737,3021,1091,389,19,0,0,19
380,2134,5095,208,1926,743,674,281,436,49,1194,772,119,1607,527,538,384,360,852,337,720,2965,793,280,67,0,0,67
381,2471,5991,1249,1222,753,704,399,615,281,1338,678,174,1711,760,494,244,521,1212,291,1166,2111,1628,795,0,0,0,0
382,1069,2908,630,439,232,306,177,354,101,436,519,13,638,431,83,206,185,595,195,606,920,793,394,6,0,0,6
383,712,2046,577,135,103,209,155,245,66,229,283,134,345,367,21,58,108,525,96,458,405,618,469,0,0,0,0
384,1560,4754,1387,173,183,457,305,615,335,588,510,127,953,607,114,160,197,1089,176,1147,972,1524,935,6,0,0,6
385,969,2906,866,103,113,318,189,349,185,467,255,62,595,374,87,115,111,656,90,689,561,906,660,0,0,0,0
386,1039,2914,940,99,158,375,173,333,205,416,383,35,645,394,196,89,115,639,92,636,516,961,709,0,0,0,0
387,1294,3820,1096,198,165,418,241,470,164,458,555,117,719,575,110,57,168,959,136,871,825,1265,723,17,0,0,17
388,2083,6269,1846,237,252,673,375,783,356,733,770,224,1272,811,141,182,347,1413,209,1526,1215,2010,1309,0,0,0,0
389,1910,5286,1355,555,383,585,327,615,409,655,692,154,1162,748,361,203,243,1103,233,1128,1335,1467,1123,13,0,0,13
390,1418,3230,580,838,440,503,215,260,249,490,630,49,1059,359,239,213,220,746,195,480,1457,736,362,0,0,0,0
391,3003,7106,920,2083,843,1071,514,575,422,1558,851,172,2102,901,389,487,720,1407,374,981,3458,1335,958,154,0,0,154
392,2327,5792,158,2169,518,882,495,432,133,1015,1038,141,1692,635,243,616,480,988,462,678,3573,822,257,1,0,0,1
393,1885,4672,505,1380,453,716,358,358,201,1045,505,134,1563,322,314,378,476,717,332,586,2300,954,500,1,0,0,1
394,1463,4169,818,645,295,463,282,423,178,443,642,200,981,482,254,152,261,796,265,710,1591,1042,561,178,0,0,178
395,2340,5084,731,1609,642,976,439,283,147,1194,834,165,1774,566,203,270,600,1267,384,387,3089,881,343,0,0,0,0
396,4,10,2,2,1,1,1,1,0,2,2,0,3,1,0,1,1,2,1,1,5,2,1,0,0,0,0
397,962,2568,643,319,159,331,231,241,49,435,383,95,650,312,52,72,166,672,236,386,1247,552,147,0,0,0,0
398,1336,3095,543,793,385,453,276,222,67,605,532,132,903,433,147,319,215,655,237,323,1714,598,223,0,0,0,0
399,16,40,9,7,4,5,4,3,1,7,6,2,11,5,4,4,3,5,3,6,19,7,5,0,0,0,0
400,1862,4590,676,1186,530,576,356,400,158,882,646,176,1314,548,270,322,296,974,316,669,2279,913,413,0,0,0,0
401,340,1031,222,118,75,104,94,67,51,176,80,33,263,77,140,92,53,55,24,128,446,281,152,100,0,0,100
402,190,685,4,186,20,34,44,92,4,88,97,1,55,135,14,70,39,67,69,203,285,104,24,0,0,0,0
403,2,8,1,1,0,1,0,1,0,1,1,0,1,1,0,1,0,1,0,1,4,2,1,0,0,0,0
404,586,2039,371,215,92,134,116,244,79,198,246,63,393,193,158,134,118,176,104,354,728,597,256,18,0,0,18
405,3,9,2,1,0,1,1,1,0,2,1,0,2,1,0,1,1,1,0,2,3,3,1,0,0,0,0
406,712,1645,176,536,171,265,148,128,10,411,261,30,527,185,44,56,137,475,160,145,1039,242,59,12,0,0,12
407,42,91,4,38,10,21,7,4,1,24,15,2,31,11,3,3,9,27,7,4,66,11,3,1,0,0,1
408,15,33,1,14,4,6,3,2,0,8,6,1,11,4,1,1,3,10,3,1,24,4,1,0,0,0,0
409,0,0,0,0,0,0,0,0,0,0,0,0,0,0,0,0,0,0,0,0,0,0,0,0,0,0,0
410,4829,10144,535,4294,1364,2145,844,476,66,2791,1768,204,3575,1254,444,470,1183,2732,907,488,7156,1320,273,76,0,0,76
411,0,0,0,0,0,0,0,0,0,0,0,0,0,0,0,0,0,0,0,0,0,0,0,0,0,0,0
412,8375,19592,1269,7106,2032,3637,1485,1221,334,3735,3352,954,6576,1799,863,1232,2373,3907,1364,1840,12793,2766,829,0,0,0,0
413,3930,9932,1145,2785,813,1372,845,900,249,1621,1892,168,2614,1316,643,408,734,2145,847,1565,5387,1631,502,15,0,0,15
414,977,3577,600,377,136,213,234,394,131,304,318,224,601,376,166,253,188,370,177,635,1262,866,637,56,22,0,34
415,729,2170,415,314,133,200,161,235,85,244,245,155,401,328,136,106,230,257,119,320,933,531,267,14,0,0,14
416,2821,7654,1057,1764,663,874,580,704,248,1077,1137,359,1894,927,352,310,655,1504,462,1072,3837,1619,664,15,0,0,15
417,0,0,0,0,0,0,0,0,0,0,0,0,0,0,0,0,0,0,0,0,0,0,0,0,0,0,0
418,593,1578,570,23,155,177,106,155,64,234,186,109,415,178,123,157,157,156,60,224,474,515,305,6,0,0,6
419,1174,3783,583,591,203,328,249,394,127,461,369,217,822,352,222,240,318,394,235,542,1669,853,484,15,0,0,15
420,743,2711,519,224,102,180,152,309,87,212,291,153,511,232,126,192,162,263,158,387,1075,702,389,9,0,0,9
421,3068,7454,2022,1046,806,1184,522,556,282,1483,1000,303,2636,432,525,739,801,1003,261,870,3033,2070,1220,0,0,0,0
422,3296,7624,1213,2083,928,1302,536,530,205,1516,1157,418,2582,714,291,525,658,1822,485,744,4233,1316,846,82,0,0,82
423,1675,4899,698,977,352,511,329,483,181,557,696,241,1145,530,401,338,379,557,270,753,2255,1112,509,0,0,0,0
424,2519,7202,1185,1334,561,721,529,708,187,907,1120,305,1649,870,481,657,526,855,408,1137,3129,1791,737,13,0,0,13
425,1412,3609,365,1047,372,503,243,294,90,482,649,191,1058,354,222,317,386,487,223,467,1967,670,282,0,0,0,0
426,1834,4448,661,1173,516,627,378,313,115,835,677,207,1365,469,204,334,322,974,276,513,2546,813,300,88,0,0,88
427,1231,2909,485,746,261,540,265,165,30,529,599,73,1019,212,89,67,299,776,215,208,2110,291,85,2,0,0,2
428,591,1391,230,361,125,262,127,77,14,253,290,34,491,100,42,31,145,373,103,96,1020,134,38,0,0,0,0
429,0,0,0,0,0,0,0,0,0,0,0,0,0,0,0,0,0,0,0,0,0,0,0,0,0,0,0
430,705,1604,43,662,237,286,82,100,75,297,245,88,528,177,93,146,127,339,82,202,984,259,77,0,0,0,0
431,14,31,1,13,5,5,2,2,1,6,5,2,11,3,2,3,2,7,2,4,19,5,1,0,0,0,0
432,218,495,13,205,73,89,25,31,23,92,76,27,164,54,29,45,39,105,25,62,304,80,24,0,0,0,0
433,2279,5739,602,1677,637,722,444,476,243,961,793,282,1712,567,586,460,414,819,321,841,2793,1172,612,35,33,0,2
434,36,115,17,19,14,15,3,4,6,17,11,2,29,7,23,13,0,0,11,20,44,35,5,2,0,0,2
435,2135,4501,549,1586,849,666,305,315,354,989,647,145,1694,441,591,488,458,598,239,514,2279,992,477,82,0,0,82
436,1595,4248,824,771,380,455,307,453,142,673,584,196,878,717,294,330,426,545,287,676,1551,1141,593,7,0,0,7
437,2190,6127,854,1336,479,619,428,664,146,894,793,357,1473,717,377,546,419,848,377,1040,2651,1456,603,0,0,0,0
438,1730,4743,1011,719,377,586,336,431,207,601,692,230,1052,678,268,306,344,812,265,694,1804,1185,795,11,0,0,11
439,1120,3108,645,475,221,370,203,326,178,350,333,259,839,281,279,148,192,501,194,501,1127,810,476,0,0,0,0
440,3405,8687,963,2442,761,1135,769,740,309,1758,1089,249,2323,1082,548,421,810,1626,677,1178,4556,1600,676,0,0,0,0
441,2649,6492,634,2015,674,998,461,516,309,957,1110,273,2150,499,500,362,554,1233,431,721,3546,1184,610,13,0,0,13
442,1068,3252,822,246,153,321,216,378,105,262,411,290,816,252,89,124,180,675,157,501,1122,920,552,13,0,0,13
443,2053,5678,637,1416,388,717,429,519,92,921,885,155,1562,491,212,373,575,893,327,802,2786,1200,563,0,0,0,0
444,2217,6053,1149,1068,482,692,451,592,258,894,746,319,1529,688,203,522,389,1103,360,891,2377,1525,900,1,0,0,1
445,3311,9122,1062,2249,636,1051,724,900,289,1464,1307,251,2153,1158,415,703,780,1413,659,1437,4355,1787,884,18,0,0,18
446,3488,8892,1365,2123,700,1245,806,737,211,1536,1377,364,2501,987,217,543,943,1785,653,978,5001,1462,798,0,0,0,0
447,1825,4539,894,931,435,630,383,377,229,944,544,108,1284,541,246,292,281,1006,313,561,1880,1055,730,0,0,0,0
448,3234,7651,484,2750,949,1133,595,557,340,1662,845,387,2230,1004,630,555,847,1202,519,903,4210,1169,850,28,0,0,28
449,2661,6836,698,1963,673,666,627,695,316,1098,1050,197,1720,941,348,502,552,1259,555,1198,3175,1203,705,0,0,0,0
450,2442,5461,598,1844,717,932,400,393,293,803,1146,200,1940,502,294,401,695,1052,381,598,2856,1063,563,11,0,0,11
451,2427,6884,1419,1008,462,686,450,829,407,988,817,215,1565,862,434,245,472,1276,481,1404,2369,1711,919,15,0,0,15
452,1058,2958,882,176,214,298,209,337,168,350,415,125,570,488,78,187,126,667,137,606,705,881,629,0,0,0,0
453,2564,7348,1598,966,468,640,518,938,265,1044,1007,248,1412,1152,260,282,611,1411,455,1623,2350,1925,995,25,0,0,25
454,1522,4417,1200,322,222,444,322,534,240,499,689,94,895,627,102,141,251,1028,138,938,1022,1407,912,0,0,0,0
455,905,2631,777,128,118,298,151,338,250,243,318,94,640,265,158,104,117,526,104,567,557,889,514,2,0,0,2
456,2972,8295,893,2079,554,803,624,991,427,1325,893,327,1739,1233,573,680,606,1113,432,1725,3042,2163,933,6,0,0,6
457,1734,5279,1098,636,223,454,377,680,240,514,914,66,831,903,150,237,241,1106,374,1227,1685,1256,737,0,0,0,0
458,1546,4633,938,608,207,410,364,565,245,579,556,166,694,852,214,194,161,977,296,1036,1567,1119,615,0,0,0,0
459,2837,8203,1631,1206,465,801,612,959,348,1114,1154,221,1920,917,350,389,568,1530,509,1591,3031,1944,1128,21,0,0,21
460,1497,4143,542,955,267,396,372,462,170,706,541,80,940,557,110,181,357,849,304,813,1760,887,379,27,0,0,27
461,1681,4829,1114,567,328,484,356,513,107,552,923,99,1079,602,183,299,433,766,260,840,1602,1339,788,17,0,0,17
462,1660,5052,1014,646,233,427,352,648,200,736,560,164,888,772,255,187,363,855,260,1146,1599,1430,617,29,0,0,29
463,1784,4556,996,788,364,587,406,427,257,743,566,218,1271,513,137,406,419,822,281,660,1855,1057,703,0,0,0,0
464,1881,4907,987,894,379,676,364,462,186,709,829,157,1320,561,273,269,512,827,344,696,2053,1147,667,20,0,0,20
465,3197,7517,1259,1938,960,1037,563,637,508,1323,1041,325,2424,773,760,722,499,1216,426,977,3115,1802,1197,40,0,0,40
466,1594,4040,1042,552,371,542,288,393,197,544,649,204,1185,409,236,347,288,723,221,610,1395,1207,607,9,0,0,9
467,2190,5096,677,1513,720,711,338,421,247,1142,658,143,1695,495,337,587,368,898,267,662,2189,1372,606,118,0,0,118
468,2216,5625,702,1514,564,714,395,543,460,849,816,91,1542,674,566,479,402,769,339,896,2199,1469,722,42,0,0,42
469,2539,7473,658,1881,541,653,468,877,323,1108,698,410,1360,1179,553,834,664,488,549,1592,3104,1588,640,0,0,0,0
470,2270,6210,1330,940,445,722,471,632,253,1039,757,221,1702,568,327,307,530,1106,367,980,2342,1681,840,18,0,0,18
471,2351,5571,629,1722,669,858,371,453,292,831,1010,218,1847,504,448,663,662,578,349,707,2486,1240,789,39,0,0,39
472,2148,5412,414,1734,580,663,393,512,163,1167,755,63,1386,762,405,617,520,606,347,917,2623,1118,407,0,0,0,0
473,2550,7392,503,2047,541,740,475,794,335,1192,841,182,1648,902,782,771,380,617,449,1436,2945,1812,750,16,0,0,16
474,1593,4320,684,909,351,481,243,518,136,659,527,271,1173,420,250,405,413,525,252,713,1693,1135,527,14,0,0,14
475,1681,4591,774,907,362,497,318,504,150,825,563,143,1146,535,265,504,262,650,273,869,1647,1207,595,0,0,0,0
476,2544,7302,1523,1021,436,743,513,852,333,993,985,233,1537,1007,216,527,619,1182,364,1448,2172,2084,1234,18,0,0,18
477,2125,6423,1256,869,325,517,479,804,289,849,731,256,1286,839,348,370,329,1078,323,1409,2018,1841,832,0,0,0,0
478,2640,7138,591,2049,550,679,650,761,299,1314,610,417,1584,1056,550,541,728,821,502,1441,3197,1437,561,10,0,0,10
479,2850,8827,1426,1424,395,661,688,1106,348,1108,1211,183,1604,1246,398,356,515,1581,410,2143,3014,2345,915,62,0,0,62
480,1095,3404,934,161,74,329,235,457,113,388,494,100,697,398,78,101,143,773,93,762,700,1224,625,0,0,0,0
481,1600,4888,1317,283,177,434,337,652,267,575,620,138,854,746,91,234,341,934,114,1070,1150,1686,868,0,0,0,0
482,1417,4508,1175,242,125,329,370,593,145,455,693,124,723,694,143,115,154,1005,127,992,1056,1625,708,0,0,0,0
483,2140,6188,1005,1135,393,475,487,785,272,1096,640,132,1355,785,518,280,442,900,273,1494,1953,1744,724,0,0,0,0
484,2875,8011,1541,1334,606,652,652,965,506,1285,914,170,1751,1124,442,445,526,1462,300,1851,2342,2267,1251,0,0,0,0
485,2249,6725,1288,961,327,525,485,912,271,982,795,201,1157,1092,237,174,293,1545,306,1672,2114,1742,891,15,0,0,15
486,1893,5824,651,1242,246,380,521,746,163,1107,446,177,826,1067,333,197,438,925,329,1502,2237,1223,533,0,0,0,0
487,1973,5248,764,1209,395,594,417,567,217,885,753,118,1221,752,267,175,444,1087,258,1069,1987,1348,586,17,0,0,17
488,2777,7779,1723,1054,533,759,503,982,562,915,1088,212,1597,1180,487,376,295,1619,260,1677,1955,2336,1551,17,0,0,17
489,2044,6107,1746,298,173,690,459,722,278,771,735,260,1190,854,227,172,324,1321,156,1203,1304,2090,1354,0,0,0,0
490,1396,4154,1065,331,187,364,304,541,242,514,486,154,904,492,182,198,228,788,140,864,1059,1341,750,0,0,0,0
491,1021,3191,671,350,96,275,229,421,60,417,488,56,514,507,59,126,150,686,98,769,896,1037,391,0,0,0,0
492,1819,5674,1330,489,166,422,493,738,150,725,774,170,848,971,151,215,253,1200,206,1325,1512,1864,767,0,0,0,0
493,1940,5718,1756,184,251,610,379,700,436,601,663,240,1230,710,250,290,282,1118,138,1159,1163,1961,1297,15,0,0,15
494,2024,5975,1815,209,225,615,456,728,467,765,571,221,1355,669,228,290,474,1032,133,1287,1167,2140,1248,0,0,0,0
495,2022,5838,1790,232,227,745,384,666,350,758,809,105,1262,760,158,315,270,1279,117,1158,1129,2061,1373,0,0,0,0
496,988,2766,818,170,164,322,193,309,202,309,352,125,772,216,148,58,143,639,87,532,508,880,759,0,0,0,0
497,2440,6708,1900,540,444,836,425,735,643,662,916,219,1531,909,358,205,199,1678,162,1255,1209,2143,1939,0,0,0,0
498,1477,4065,1227,250,273,438,304,462,217,532,615,113,1011,466,168,181,230,898,149,759,995,1375,787,0,0,0,0
499,2622,7714,1836,786,403,708,587,924,319,1080,1036,187,1327,1295,255,413,496,1458,402,1688,2292,2263,1069,13,0,0,13
500,1369,4082,1041,328,182,399,277,511,175,409,467,318,792,577,88,242,253,786,201,902,1179,1198,602,0,0,0,0
501,1380,4049,1092,288,205,401,273,501,155,569,589,67,799,581,147,190,210,833,208,789,1224,1183,645,0,0,0,0
502,1682,4537,734,948,363,483,370,466,335,502,610,235,1109,573,434,371,329,548,266,777,1673,1174,647,10,0,0,10
503,2880,6539,794,2086,1051,902,392,535,694,1047,960,179,2180,700,974,557,546,803,329,947,2398,1492,1373,0,0,0,0
504,2224,4749,1004,1220,763,828,305,328,257,1045,647,275,1521,703,384,539,518,783,282,562,2141,1259,505,8,0,0,8
505,2093,5961,1145,948,407,653,416,617,293,829,802,169,1157,936,334,523,380,856,312,1159,2011,1728,751,24,0,0,24
506,1459,3905,787,672,337,388,280,454,318,527,533,81,1034,425,300,225,305,629,190,787,1143,1147,638,24,0,0,24
507,1934,5003,1599,335,385,699,339,511,324,934,563,113,1182,752,231,254,417,1032,169,1000,1131,1519,1184,0,0,0,0
508,1158,2891,586,572,314,333,191,320,104,444,560,50,683,475,164,129,229,636,127,657,851,872,384,0,0,0,0
509,1350,3008,485,865,450,440,193,267,127,899,312,12,1017,333,218,266,282,584,124,561,997,954,372,21,0,0,21
510,962,2766,839,123,115,334,167,346,234,383,316,29,631,331,67,75,132,688,75,563,525,932,671,0,0,0,0
511,2947,6947,1864,1083,860,995,439,653,632,1407,803,105,2198,749,490,349,499,1609,245,1321,1504,2394,1483,14,0,0,14
512,1587,4185,1273,314,310,588,279,410,152,683,666,86,1089,498,148,251,336,852,187,747,1061,1393,797,22,0,0,22
513,1032,3012,889,143,148,384,184,316,196,476,262,98,713,319,155,77,96,704,73,648,571,1034,686,94,0,0,94
514,2754,7736,2113,641,529,789,478,958,599,948,1018,189,1642,1112,300,355,545,1554,236,1768,1577,2351,1804,0,0,0,0
515,2382,7346,1595,787,296,671,451,964,248,980,875,279,1279,1103,367,581,308,1126,337,1815,2247,2072,875,19,0,0,19
516,1348,3936,1109,239,216,356,260,516,144,404,699,101,736,612,94,216,245,793,189,1004,936,1222,585,0,0,0,0
517,1894,5426,1362,532,319,518,383,674,241,434,989,230,1013,881,303,210,350,1031,281,1269,1465,1609,802,8,0,0,8
518,2303,6411,1487,816,448,609,433,813,357,927,845,174,1453,850,271,328,378,1326,291,1532,1572,1975,1041,0,0,0,0
519,3187,8586,2086,1101,758,881,571,977,300,1606,1184,97,2146,1041,356,535,745,1551,478,1729,2741,2355,1283,36,0,0,36
520,1395,4407,1074,321,159,358,305,573,115,559,503,218,733,662,218,206,252,719,235,985,1289,1287,611,26,0,0,26
521,1978,5048,1014,964,554,623,330,471,312,657,800,209,1136,842,498,359,401,720,291,861,1767,1337,792,27,0,0,27
522,2215,6250,1356,859,413,659,425,718,206,627,1088,294,1345,870,432,405,460,918,334,1252,1967,1749,948,62,0,0,62
523,2702,7807,2197,505,459,843,559,841,403,733,1242,324,1450,1252,247,505,581,1369,450,1583,2255,2238,1281,50,0,0,50
524,1909,5333,1648,261,324,619,368,598,302,713,719,175,1198,711,249,246,342,1072,328,1049,1415,1554,987,16,0,0,16
525,1586,4339,1283,303,293,519,284,490,311,693,490,92,962,624,158,398,373,657,248,833,1130,1290,838,17,0,0,17
526,2395,6540,1889,506,458,776,457,704,235,858,1213,89,1409,986,276,232,425,1462,422,1265,1871,1965,1017,21,0,0,21
527,2861,7254,2067,794,696,1005,513,647,387,1198,998,278,2104,757,545,494,321,1501,434,1144,2209,2250,1217,91,0,0,91
528,2593,6333,1235,1358,681,889,424,599,262,1195,861,275,1808,785,353,582,685,973,332,1071,2188,1781,961,26,0,0,26
529,1227,2870,907,320,366,409,165,287,369,504,326,28,876,351,166,198,340,523,153,429,609,833,846,0,0,0,0
530,3287,7149,1205,2082,1106,1214,404,563,386,1699,985,217,2502,785,562,852,724,1149,362,945,3104,1844,894,2,0,0,2
531,1405,2897,775,630,533,463,197,212,262,712,321,110,1147,258,415,298,271,421,146,297,1076,839,539,44,0,0,44
532,3094,7241,564,2530,1028,1034,497,535,437,1154,1258,245,2425,669,932,868,554,740,384,973,3489,1526,869,93,0,0,93
533,2562,6964,607,1955,606,833,430,693,266,1114,815,367,1898,664,800,765,478,519,388,1205,3084,1551,736,41,0,0,41
534,1992,5006,1178,814,555,656,339,442,360,722,641,269,1627,365,573,285,418,716,252,664,1871,1288,931,36,22,0,14
535,2028,5010,754,1274,655,606,298,469,340,734,708,246,1555,473,484,502,529,513,261,753,2095,1304,597,0,0,0,0
536,1802,5166,389,1413,409,507,297,589,119,664,638,381,1172,630,356,569,365,512,320,1083,2372,1067,324,0,0,0,0
537,3265,7094,681,2584,1093,1227,444,501,228,1942,896,199,2761,504,659,636,839,1131,378,783,4065,1355,513,80,0,0,80
538,1215,3488,405,810,394,382,198,241,111,577,437,90,1000,215,221,389,228,377,176,360,1697,943,312,622,0,0,622
539,391,1277,158,233,118,132,63,78,36,186,140,29,322,69,78,74,87,152,57,134,567,398,121,270,0,0,270
540,2525,5548,766,1759,831,924,389,381,343,1109,819,254,1864,661,541,680,589,715,235,691,2597,1326,699,15,0,0,15
541,2113,5275,1412,701,509,760,381,463,299,1085,551,178,1757,356,251,297,540,1025,255,749,1582,1631,1058,11,0,0,11
542,990,2466,392,598,273,333,152,232,64,479,386,61,723,267,93,250,262,385,117,364,972,686,327,20,0,0,20
543,1458,5758,552,906,401,476,265,316,195,618,593,52,1230,228,393,315,229,521,243,1427,3150,673,265,2243,2215,0,28
544,2228,5725,673,1555,600,755,362,511,259,972,708,289,1953,275,562,572,554,540,329,806,2799,1229,562,50,50,0,0
545,1356,4057,354,1002,518,410,216,212,197,545,533,81,1118,238,382,257,312,405,163,1019,1857,566,452,998,935,0,63
546,2059,4720,561,1498,677,733,282,367,109,945,903,102,1597,462,237,593,398,831,210,441,2722,963,384,15,0,0,15
547,2885,7969,961,1924,703,964,472,746,310,954,1313,308,2155,730,677,338,695,1175,426,1187,4105,1613,638,87,0,0,87
548,3317,8742,1253,2064,1024,1028,488,777,495,1543,872,407,2558,759,894,692,842,889,471,1185,3791,2095,1200,67,0,0,67
549,2422,5468,337,2085,1054,640,314,414,574,1184,411,253,2045,377,1150,740,269,263,234,734,2560,1256,684,96,0,0,96
550,1337,4088,522,815,325,380,247,385,96,474,570,197,975,362,345,290,366,336,214,633,1736,984,521,51,0,0,51
551,1887,6458,543,1344,353,485,355,694,288,737,585,277,1275,612,631,614,381,261,382,1344,2591,1524,617,273,0,0,273
552,1245,4392,461,784,199,292,246,508,145,548,434,118,776,469,432,451,167,195,248,986,1770,1013,375,0,0,0,0
553,1225,4710,564,661,190,255,250,530,161,503,346,215,796,429,367,294,186,378,271,986,1992,1050,411,116,0,0,116
554,1156,3734,510,646,304,381,226,245,153,407,495,101,890,266,405,128,223,400,134,419,1733,994,454,570,249,0,321
555,2722,7169,484,2238,847,776,447,652,194,1304,817,407,2281,441,980,779,492,471,390,1002,4094,1269,414,157,0,0,157
556,627,4957,22,605,229,177,84,137,90,234,199,104,521,106,393,178,45,11,63,3211,1398,207,78,3457,3445,0,12
557,1988,4002,382,1606,934,588,227,239,337,1162,347,142,1902,86,776,359,405,448,152,290,2434,726,400,142,0,0,142
558,2384,4669,513,1871,1113,808,206,257,352,1139,764,129,2210,174,656,289,442,997,176,373,2638,1004,478,184,0,0,184
559,1670,4852,1007,663,322,491,290,567,150,745,594,181,1152,518,259,416,325,670,272,868,1794,1322,596,7,0,0,7
560,1554,5155,296,1258,354,407,221,572,186,654,400,314,898,656,528,318,308,400,296,1025,2417,1084,333,231,0,0,231
561,1598,4379,401,1197,462,405,264,467,279,709,430,180,1073,525,614,512,296,176,248,781,1855,1080,415,11,0,0,11
562,1324,4585,500,824,251,277,204,592,191,312,530,291,832,492,441,362,242,279,248,993,1836,1088,420,36,0,0,36
563,4502,12764,1325,3177,1327,1137,649,1389,816,2047,1087,552,3062,1440,2097,1157,832,416,678,2500,4641,3382,1563,604,0,0,604
564,2980,8414,1031,1949,615,826,590,949,216,1451,1017,296,1864,1116,699,661,789,831,471,1673,3400,2016,854,32,0,0,32
565,2181,5785,1087,1094,529,709,385,558,365,914,694,208,1607,574,623,447,562,549,320,824,2365,1465,811,0,0,0,0
566,3484,9008,2575,909,778,1173,716,817,264,1769,1039,412,2435,1049,719,601,655,1509,679,1185,3932,2181,1031,19,0,0,19
567,2250,7671,1077,1173,376,458,433,983,236,794,709,511,1351,899,716,716,558,260,377,1580,2507,2085,1122,29,0,0,29
568,2267,8473,1190,1077,364,463,400,1040,457,835,664,311,1207,1060,811,592,404,460,471,1711,3204,2178,909,20,0,0,20
569,1046,4406,555,491,81,197,198,570,94,311,339,302,488,558,311,317,239,179,248,966,1655,1132,405,0,0,0,0
570,1107,4384,350,757,174,215,177,541,161,433,239,274,548,559,464,359,182,102,251,979,1675,1077,402,18,0,0,18
571,847,3830,582,265,65,173,126,483,40,250,255,302,499,348,169,151,245,282,185,774,1395,998,478,0,0,0,0
572,926,4104,562,364,66,144,181,535,89,194,315,328,480,446,148,279,239,260,207,805,1456,1084,552,0,0,0,0
573,1020,4114,777,243,80,240,183,517,168,281,368,203,594,426,192,245,227,356,176,682,1330,1232,694,46,0,0,46
574,1340,4769,790,550,208,291,252,589,116,524,324,376,707,633,403,523,300,114,240,826,1579,1473,651,79,0,0,79
575,982,4117,755,227,90,215,206,471,126,304,222,330,641,341,200,244,230,308,183,705,1361,1172,696,44,0,0,44
576,1147,4730,855,292,110,243,218,576,162,347,435,203,776,371,188,421,296,242,213,850,1541,1383,743,50,0,0,50
577,1079,4727,757,322,75,191,210,603,45,275,444,315,645,434,125,350,377,227,203,890,1664,1283,687,35,0,0,35
578,2305,8134,665,1640,355,494,450,1006,194,971,747,393,1543,762,586,749,620,350,459,1675,3380,1847,773,6,0,0,6
579,763,2417,207,556,191,224,126,222,243,188,193,139,584,179,365,221,87,90,97,363,797,648,512,163,0,0,163
580,1102,4407,259,843,122,233,189,558,133,274,390,305,495,607,347,370,302,83,237,1180,1624,1002,364,98,0,0,98
581,1172,4956,415,757,117,220,168,667,119,567,238,248,498,674,503,323,140,206,282,1161,1786,1192,535,16,0,0,16
582,1796,6395,927,869,250,421,360,765,192,584,598,422,1125,671,594,417,443,342,284,1190,2070,1747,1104,37,0,0,37
583,1526,6333,927,599,190,316,239,781,189,325,661,351,932,594,515,411,252,348,290,1113,2148,1672,1110,15,0,0,15
584,904,4231,660,244,67,141,180,516,109,154,261,380,465,439,227,215,206,256,199,795,1491,1166,580,8,0,0,8
585,962,4797,612,350,75,141,152,594,127,246,299,290,573,389,244,307,260,151,262,1001,1809,1204,521,3,0,0,3
586,1116,5888,755,361,75,125,172,744,32,277,228,579,586,530,165,248,341,362,310,1262,2205,1430,681,0,0,0,0
587,378,2062,233,145,39,51,53,235,21,63,92,202,151,227,57,100,108,113,106,464,763,494,235,5,0,0,5
588,1231,6160,682,549,64,189,213,765,128,182,432,489,547,684,175,446,298,312,306,1388,2213,1562,691,39,0,0,39
589,1378,5908,623,755,169,261,231,717,113,410,384,471,780,598,396,407,289,286,326,1167,2140,1508,767,22,0,0,22
590,864,3927,376,488,47,134,150,533,77,217,237,333,419,445,267,304,159,134,230,942,1406,968,381,0,0,0,0
591,2140,8468,678,1462,313,365,389,1073,318,531,664,627,1018,1122,762,581,427,370,492,2048,3033,1886,1009,148,0,0,148
592,1291,4735,563,728,208,294,201,588,135,413,360,383,630,661,399,367,281,244,269,998,1747,1117,604,20,0,0,20
593,875,2993,284,591,129,216,155,375,69,263,306,237,445,430,209,263,176,227,190,588,1154,729,332,8,0,0,8
594,1392,5406,727,665,181,263,247,701,143,345,563,341,823,569,342,427,351,272,282,1135,1972,1433,584,67,0,0,67
595,2441,7042,577,1864,560,605,388,888,505,846,663,427,1642,799,1010,730,492,209,388,1355,2399,1591,1309,0,0,0,0
596,739,2686,403,336,99,176,132,332,85,228,203,223,530,209,214,159,198,168,101,425,921,762,477,24,0,0,24
597,2312,6878,640,1672,471,664,469,708,514,822,773,203,1621,691,1128,412,181,591,358,1197,2739,1541,1043,70,0,0,70
598,2362,7917,1558,804,316,616,472,958,367,674,965,356,1463,899,333,398,462,1169,506,1224,3199,1932,1056,58,0,0,58
599,1385,4902,991,394,158,316,302,609,136,366,516,367,821,564,147,270,321,647,242,759,1763,1378,760,17,0,0,17
600,1224,4312,892,332,130,348,243,503,132,246,538,308,787,437,99,261,371,493,205,580,1505,1196,826,26,0,0,26
601,2805,8308,1743,1062,422,837,706,840,291,1106,1172,236,2100,705,326,432,758,1289,516,1020,3588,2202,982,133,0,0,133
602,677,2342,551,126,89,183,155,250,62,236,212,167,369,308,124,272,155,126,91,383,756,792,320,145,0,0,145
603,308,897,213,95,60,94,75,79,28,107,97,76,168,140,48,38,39,183,42,99,359,296,101,66,0,0,66
604,1144,4188,886,258,167,283,237,457,105,397,359,283,624,520,292,207,326,319,205,726,1661,1186,410,253,0,0,253
605,3846,11190,1531,2315,604,1209,906,1127,288,1889,1108,561,2324,1522,467,620,1089,1670,710,1687,5261,2488,1044,46,0,0,46
606,3898,11257,1912,1986,565,1294,962,1077,254,1394,1735,515,2716,1182,315,458,872,2253,978,1377,6392,1759,751,15,0,0,15
607,2193,6441,1064,1129,318,562,591,722,142,910,859,282,1258,935,127,372,766,928,420,956,3291,1306,468,18,0,0,18
608,2105,5600,813,1292,330,731,536,508,165,880,970,90,1406,699,130,251,667,1057,548,730,3354,760,208,44,0,0,44
609,1531,5146,1244,287,154,384,340,653,270,409,583,269,941,590,294,232,322,683,203,891,1591,1502,959,0,0,0,0
610,657,1819,375,282,163,152,122,220,194,150,258,55,441,216,231,62,90,274,103,323,598,439,356,0,0,0,0
611,1678,5973,1066,612,202,389,353,734,171,528,584,395,922,756,253,326,389,710,316,1121,2023,1576,937,33,0,0,33
612,2331,7046,1204,1127,369,551,553,858,177,735,950,469,1368,963,431,320,612,968,456,1309,2779,1666,836,1,0,0,1
613,1007,3680,635,372,137,206,203,461,117,297,404,189,546,461,250,227,218,312,163,670,1210,1008,629,0,0,0,0
614,1328,4804,1047,281,117,315,260,636,139,376,557,256,727,601,225,202,211,690,234,924,1494,1397,755,4,0,0,4
615,1353,4526,964,389,102,373,330,548,198,367,466,322,907,446,265,277,232,579,155,763,1382,1393,833,20,0,0,20
616,1252,4701,675,577,120,243,274,615,66,413,356,417,693,559,153,355,369,375,275,904,1720,1246,556,0,0,0,0
617,1296,4852,637,659,139,271,278,608,145,400,446,305,787,509,280,278,393,345,256,968,1758,1300,570,3,0,0,3
618,743,2650,588,155,67,202,166,308,99,246,228,170,477,266,92,132,157,362,150,434,840,740,486,7,0,0,7
619,1513,5218,1245,268,159,325,359,670,262,407,528,316,928,585,289,229,248,747,285,978,1596,1511,848,16,0,0,16
620,1071,3758,747,324,126,177,246,522,92,362,455,162,552,519,151,146,212,562,224,760,1245,1013,516,11,0,0,11
621,1206,4282,715,491,173,298,265,470,148,343,404,311,934,272,277,134,387,408,222,719,1442,1225,674,28,0,0,28
622,1507,5350,1117,390,170,373,323,641,200,350,385,572,991,516,257,207,389,654,273,911,1829,1512,825,22,0,0,22
623,2051,7073,1513,538,216,440,457,938,238,441,828,544,1297,754,202,309,612,928,358,1325,2321,2062,1007,12,0,0,12
624,840,2866,689,151,91,213,169,367,126,266,276,172,567,273,124,103,224,389,163,413,921,804,565,38,0,0,38
625,1597,5419,999,598,215,420,356,606,152,553,551,341,1039,558,235,321,336,705,289,880,2079,1391,780,31,0,0,31
626,1202,4368,900,302,88,257,268,589,203,225,458,316,760,442,151,209,256,586,159,862,1375,1324,648,8,0,0,8
627,1739,5722,1209,530,231,449,369,690,183,762,592,202,1091,648,213,308,522,696,255,1046,1865,1674,882,56,0,0,56
628,1472,4603,1171,301,216,428,285,543,356,399,416,301,948,524,281,169,283,739,171,786,1298,1400,948,16,0,0,16
629,1658,5188,1277,381,276,541,292,549,208,300,735,415,1003,655,149,272,411,826,268,871,1618,1505,926,70,0,0,70
630,2265,8089,1374,891,302,533,391,1039,258,683,840,484,1516,749,405,576,651,633,429,1474,2786,2150,1250,39,0,0,39
631,1341,4617,880,461,136,370,276,559,163,353,494,331,702,639,176,243,356,566,251,812,1576,1248,730,5,0,0,5
632,1743,5700,1148,595,286,445,335,677,332,538,448,425,1246,497,486,375,428,454,292,873,2176,1441,918,49,0,0,49
633,2484,9312,1279,1205,321,511,423,1229,274,694,730,786,1341,1143,544,732,638,570,521,1983,3287,2326,1195,47,0,0,47
634,1536,6022,760,776,219,302,258,757,223,547,322,444,1094,442,545,442,289,260,337,1324,2231,1501,629,36,0,0,36
635,1052,4182,681,371,131,256,184,481,130,244,305,373,715,337,252,250,294,256,252,827,1532,1049,522,9,0,0,9
636,1347,5853,923,424,139,263,240,705,228,338,276,505,742,605,348,333,326,340,310,1210,2103,1570,660,25,0,0,25
637,1559,5085,1341,218,204,535,271,549,187,398,615,359,1039,520,78,300,413,768,224,759,1535,1531,1036,21,0,0,21
638,1290,6136,844,446,76,202,220,792,139,272,385,494,681,609,294,256,445,295,366,1318,2278,1493,681,24,0,0,24
639,1344,5921,792,552,104,217,232,791,112,366,491,375,685,659,282,441,341,280,361,1289,2200,1451,620,22,0,0,22
640,816,3622,603,213,50,138,142,486,94,235,230,257,486,330,122,267,187,240,155,642,1289,990,546,0,0,0,0
641,863,3897,625,238,65,136,166,496,86,221,176,380,434,429,149,208,238,268,215,768,1432,1021,461,0,0,0,0
642,1017,3464,799,218,148,275,194,400,112,481,313,111,729,288,90,181,261,485,158,560,1152,972,622,0,0,0,0
643,1047,4310,811,236,92,227,204,524,93,348,315,291,655,392,184,300,292,271,207,788,1376,1270,669,53,0,0,53
644,1059,4571,896,163,65,189,201,604,125,337,295,302,735,324,95,203,309,452,207,670,1531,1282,881,39,0,0,39
645,1208,4712,978,230,114,212,249,633,110,413,381,304,754,454,179,259,286,484,212,941,1481,1367,711,42,0,0,42
646,894,3577,730,164,54,196,158,486,96,271,332,195,550,344,113,188,205,388,149,730,1087,1018,593,12,0,0,12
647,1274,4600,1107,167,95,305,278,596,151,248,620,255,617,657,177,130,255,712,132,931,1310,1342,885,0,0,0,0
648,1704,6625,1481,223,70,282,326,1026,251,474,618,361,880,824,182,219,419,884,240,1615,1746,2239,785,0,0,0,0
649,1137,4449,868,269,90,185,252,610,111,334,380,312,651,486,130,182,309,516,169,933,1384,1325,638,34,11,0,23
650,1983,7722,1196,787,173,354,388,1068,151,484,779,569,1144,839,270,350,641,722,336,1486,2790,2140,970,19,0,0,19
651,1773,7149,1364,409,169,300,334,970,157,457,649,510,1046,727,351,362,535,525,307,1290,2425,2085,1042,71,0,0,71
652,1429,4951,1049,380,243,261,244,681,278,440,515,196,823,606,245,292,262,630,226,894,1543,1261,1027,24,0,0,24
653,3065,11272,2697,368,132,479,669,1785,135,1045,1622,263,1395,1670,81,250,349,2385,372,2981,2993,3766,1160,20,0,0,20
654,3905,8708,3418,487,1234,1505,392,774,1579,1028,877,421,3277,628,963,744,816,1382,176,1062,1287,2384,3799,8,0,0,8
655,3939,13473,3473,466,297,951,824,1867,353,1264,1752,570,2228,1711,248,372,714,2605,525,3013,3669,4558,1708,31,0,0,31
656,2030,6914,1704,326,186,509,445,890,110,554,1053,313,1245,785,188,266,514,1062,337,1492,2148,2092,845,32,0,0,32
657,2490,8199,1779,711,348,609,541,992,226,776,887,601,1380,1110,574,519,730,667,441,1474,3043,2341,900,61,0,0,61
658,1349,4186,1064,285,196,367,283,503,239,234,647,229,801,548,232,139,299,679,246,825,1265,1157,693,0,0,0,0
659,1038,3179,814,224,148,318,188,384,79,426,472,61,609,429,167,165,216,490,169,574,1113,906,417,16,0,0,16
660,1086,3487,879,207,149,328,192,417,218,288,470,110,670,416,230,119,312,425,186,652,1158,972,519,17,0,0,17
661,4495,12361,1983,2512,917,1362,983,1233,461,2047,1526,461,2739,1756,765,1070,1192,1468,988,2096,5438,2702,1137,59,0,0,59
662,1376,4447,1097,279,150,387,291,548,186,455,549,186,756,620,73,304,293,706,243,924,1395,1247,638,24,0,0,24
663,963,3096,827,136,99,293,197,374,162,285,397,119,558,405,97,159,222,485,192,602,927,900,475,0,0,0,0
664,2646,7626,1283,1363,498,712,580,856,146,1072,1214,214,1740,906,288,510,820,1028,433,1480,2799,2090,824,38,0,0,38
665,2432,7375,1874,558,449,709,485,789,280,790,918,444,1579,853,304,373,662,1093,476,1227,2576,2069,1027,58,0,0,58
666,1869,5873,1123,746,340,511,349,669,248,650,718,253,1220,649,525,569,510,265,303,1052,2115,1539,864,46,0,0,46
667,1921,5655,947,974,372,473,416,660,163,805,751,202,1140,781,298,724,570,329,352,1177,2347,1313,466,6,0,0,6
668,2042,6283,1647,395,357,598,390,697,178,734,778,352,1213,829,220,375,646,801,301,1027,2186,1848,921,29,0,0,29
669,2462,8999,1058,1404,352,473,481,1156,312,795,901,454,1354,1108,885,746,408,423,575,2073,3153,2252,946,43,0,0,43
670,2158,7849,1354,804,267,543,361,987,258,646,570,684,1398,760,538,385,570,665,412,1648,2637,2088,1064,28,0,0,28
671,2667,7464,499,2168,580,850,495,742,164,1064,1018,421,1790,877,369,941,676,681,489,1138,3635,1567,635,51,0,0,51
672,1466,4544,877,589,225,443,316,482,244,509,588,125,1066,400,244,343,424,455,248,754,1805,1100,637,46,0,0,46
673,1420,4212,994,426,242,400,287,491,142,446,612,220,998,422,249,324,356,491,231,746,1537,1136,562,3,0,0,3
674,1785,5548,1450,335,234,521,352,678,274,551,631,329,1040,745,217,349,393,826,285,1018,1781,1568,896,37,0,0,37
675,1674,5245,1294,380,243,501,360,570,217,426,623,408,1102,572,175,276,425,798,272,915,1708,1482,868,46,0,0,46
676,3044,8311,1634,1410,647,997,587,813,302,1209,1041,492,2001,1043,396,775,866,1007,438,1397,2991,2236,1249,64,0,0,64
677,1622,4356,633,989,438,456,261,467,272,508,612,230,1157,465,336,419,350,517,241,737,1691,1000,687,16,0,0,16
678,968,2949,762,206,185,278,155,350,196,239,370,163,652,316,128,139,147,554,148,494,858,815,634,32,0,0,32
679,1638,4698,890,748,303,491,357,487,210,629,674,125,1151,487,313,331,407,587,243,886,1620,1280,669,44,0,0,44
680,2181,6590,1690,491,302,676,475,728,304,640,1013,224,1361,820,293,333,471,1084,363,1183,2049,1866,1129,26,0,0,26
681,1246,3489,856,390,222,420,213,391,239,359,462,186,816,430,124,355,298,469,205,597,1021,967,699,43,0,0,43
682,1773,5218,1460,313,286,539,360,588,241,762,598,172,1186,587,218,237,480,838,312,973,1579,1526,828,20,0,0,20
683,1308,3849,1092,216,191,412,284,421,198,566,438,106,841,467,206,246,242,614,208,767,1126,1115,633,52,0,0,52
684,2365,6951,1667,698,390,640,476,859,320,797,992,256,1372,993,565,402,465,933,423,1524,2193,1942,869,13,0,0,13
685,1655,4848,989,666,295,411,387,562,162,617,690,186,935,720,290,401,362,602,289,1076,1656,1270,557,9,0,0,9
686,2017,5324,1047,970,506,573,384,554,317,771,778,151,1365,652,455,476,565,521,329,989,1902,1333,771,0,0,0,0
687,1482,3908,666,816,370,444,284,384,212,481,609,180,1038,444,249,364,305,564,223,745,1330,1064,546,2,0,0,2
688,2826,8234,1573,1253,539,703,511,1073,420,1192,965,249,1539,1287,620,516,548,1142,468,1859,2516,2219,1172,48,0,0,48
689,1413,4285,1300,113,169,431,275,538,180,394,590,249,791,622,102,175,150,986,178,992,963,1317,835,0,0,0,0
690,2006,5827,1737,269,276,640,414,676,412,488,812,294,1207,799,222,177,318,1289,261,1228,1316,1750,1272,23,0,0,23
691,1070,3187,990,80,136,351,209,374,202,308,448,112,769,301,109,89,142,730,85,752,603,1100,647,0,0,0,0
692,1119,3422,929,190,145,307,233,434,162,417,441,99,660,459,105,153,127,734,123,853,756,1090,600,0,0,0,0
693,1398,4267,1193,205,180,351,295,572,154,461,647,136,737,661,111,164,178,945,160,1012,961,1395,739,2,0,0,2
694,1732,5348,1526,206,157,522,364,689,178,691,675,188,922,810,188,119,248,1177,136,1282,1103,1867,960,13,0,0,13
695,2692,8378,2427,265,223,818,581,1070,440,1097,977,178,1693,999,274,227,483,1708,263,1875,1805,2851,1584,0,0,0,0
696,2074,5377,1496,578,461,697,359,557,317,896,685,176,1526,548,322,371,505,876,194,914,1439,1781,1049,34,0,0,34
697,504,1795,306,198,92,119,88,205,50,288,129,37,312,192,105,177,71,151,90,359,542,480,324,30,0,0,30
698,2814,8951,2466,348,329,857,522,1106,336,1181,887,410,1627,1187,172,463,506,1673,481,1985,2344,2762,1379,13,0,0,13
699,1709,4983,1434,275,235,581,368,525,245,466,684,314,1166,543,140,234,457,878,226,959,1313,1543,942,0,0,0,0
700,4488,12975,2916,1572,966,1203,809,1510,560,1807,1635,486,2574,1914,834,1035,1000,1619,753,2739,4142,3563,1778,25,0,0,25
701,2472,6841,1937,535,465,836,423,748,506,1070,734,162,1529,943,379,608,545,940,357,1286,1844,1959,1395,18,0,0,18
702,3427,10962,1773,1654,593,930,612,1292,334,1476,1197,420,2008,1419,639,1056,717,1015,758,2439,3808,2656,1301,347,0,0,347
703,1546,4783,1291,255,174,534,279,559,195,560,485,306,949,597,113,178,358,897,220,884,1264,1523,892,20,0,0,20
704,1648,4790,1383,265,233,638,224,553,248,669,458,273,1103,545,82,281,310,975,200,806,1188,1537,1059,0,0,0,0
705,4492,14260,3173,1319,756,1188,835,1713,657,1485,1726,624,2459,2033,871,968,1060,1593,923,3042,4563,3601,2131,62,0,0,62
706,1086,3531,592,494,222,315,157,392,168,476,257,185,798,288,221,246,254,365,165,712,1095,1023,536,55,0,0,55
707,2622,10141,753,1869,380,486,439,1317,180,1015,776,651,1292,1330,730,882,606,404,766,2624,3783,2092,876,231,0,0,231
708,2597,8174,1411,1186,543,653,447,954,494,940,706,457,1581,1016,732,628,658,579,474,1837,2579,1990,1294,3,0,0,3
709,2101,7537,1054,1047,250,437,405,1009,217,868,694,322,1073,1028,621,459,583,438,527,1949,2708,1736,617,27,0,0,27
710,2229,7643,1222,1007,298,520,414,997,217,733,918,361,1121,1108,354,679,650,546,424,1833,2616,1986,784,23,0,0,23
711,2945,9764,2575,370,288,857,555,1245,338,1377,798,432,1680,1265,241,410,1165,1129,503,2314,2707,2960,1280,2,0,0,2
712,1407,4804,1012,395,226,464,247,470,263,513,444,187,998,409,228,270,302,607,216,838,1417,1379,954,180,0,0,180
713,1528,5136,1126,402,218,519,228,563,240,537,603,148,993,535,264,347,385,532,220,927,1431,1549,1009,46,0,0,46
714,328,922,193,135,60,123,50,95,34,120,117,57,219,109,31,117,71,109,46,147,247,286,196,37,0,0,37
715,2803,8440,2083,720,415,797,579,1012,264,993,1240,306,1337,1466,286,420,608,1489,484,1799,2707,2516,934,7,0,0,7
716,1844,4934,1248,596,409,636,290,509,288,612,785,159,1289,555,407,268,369,800,233,890,1411,1474,926,39,0,0,39
717,2331,6611,1587,744,487,744,434,666,299,714,1054,264,1453,878,447,324,574,986,416,1242,2207,1806,940,145,0,0,145
718,2762,7866,1968,794,496,913,531,822,223,981,1091,467,1682,1080,212,536,778,1236,403,1554,2469,2318,1122,125,0,0,125
719,2704,7271,1921,783,601,804,515,784,345,1161,953,245,1783,921,599,707,777,621,480,1294,2581,2112,804,14,0,0,14
720,2092,5815,1753,339,352,695,462,583,194,819,908,171,1518,574,245,264,637,946,446,905,2264,1614,586,6,0,0,6
721,2306,6053,1448,858,509,795,425,577,323,842,860,281,1571,735,494,633,482,697,338,959,2066,1780,910,88,0,0,88
722,2824,8422,1450,1374,595,811,528,890,348,731,1197,548,1802,1022,574,801,724,725,557,1659,3303,2006,897,41,0,0,41
723,1908,5003,1346,562,378,725,302,503,131,776,873,128,1175,733,139,367,383,1019,213,932,1330,1685,843,65,0,0,65
724,2726,6479,1582,1144,904,877,388,557,432,1050,828,416,1909,817,389,587,648,1102,310,1001,1921,1606,1641,156,0,0,156
725,1351,3955,1296,55,118,539,242,452,160,472,475,244,871,480,87,102,259,903,115,831,748,1421,840,29,0,0,29
726,2967,8524,2317,650,435,952,552,1028,343,1080,1153,391,2007,960,444,513,730,1280,480,1768,2449,2413,1414,10,0,0,10
727,1101,3270,863,238,199,278,225,399,132,331,517,121,718,383,112,152,313,524,189,739,1069,842,431,17,0,0,17
728,2410,6768,1935,475,401,841,472,696,318,650,1157,285,1629,781,324,679,552,855,352,1211,2152,2048,1005,36,0,0,36
729,8853,29047,6912,1941,935,1609,2002,4307,415,3204,4319,915,3662,5191,606,661,1525,6061,2211,7735,10466,6576,2059,0,0,0,0
730,4444,12189,1703,2741,922,1294,927,1301,238,1837,1992,377,2275,2169,552,689,1103,2100,744,1956,6317,2689,483,242,0,210,32
731,2742,6456,820,1922,788,925,491,538,287,1529,832,94,1920,822,503,851,734,654,413,1126,2959,1417,541,0,0,0,0
732,1920,5621,1204,716,318,556,384,662,182,719,909,110,1224,696,167,549,575,629,351,1138,2111,1410,611,36,0,0,36
733,2745,7623,1522,1223,550,867,535,793,276,1162,1084,223,1760,985,392,624,558,1171,496,1406,3058,1791,872,46,0,0,46
734,3108,9007,2603,505,486,924,617,1081,380,1005,1293,430,1945,1163,212,497,662,1737,535,1769,2660,2710,1333,15,0,0,15
735,1285,3498,1076,209,222,403,247,413,172,572,478,63,831,454,119,164,210,792,128,615,856,1208,691,0,0,0,0
736,3173,9010,2288,885,506,991,651,1025,341,1152,1362,318,1987,1186,274,553,795,1551,360,1932,2567,2747,1404,113,0,0,113
737,1543,4905,1315,228,173,388,307,675,119,408,891,125,798,745,188,232,249,874,266,1234,1372,1342,691,21,0,0,21
738,2067,6026,1767,300,266,675,426,700,246,629,1058,134,1168,899,188,264,369,1246,187,1379,1441,1986,1033,13,0,0,13
739,2494,6304,785,1709,814,731,378,571,370,931,988,205,1793,701,750,532,360,852,290,1221,2222,1758,813,356,0,0,356
740,1383,3914,1091,292,249,394,256,484,186,617,470,110,694,689,101,203,361,718,178,911,1014,1146,665,7,0,0,7
741,1678,4921,1275,403,213,542,337,586,251,552,666,209,1020,658,165,225,488,800,169,1159,1226,1559,808,23,0,0,23
742,5553,14838,2201,3352,1262,1542,1130,1619,651,2455,1955,492,3276,2277,759,961,1358,2475,941,3121,5725,2992,2059,73,0,0,73
743,3405,9612,2431,974,643,890,656,1216,531,1126,1517,231,2016,1389,561,426,623,1795,367,2288,2450,3037,1470,31,0,0,31
744,1909,5126,1023,886,413,601,349,546,244,705,810,150,1249,660,442,260,352,855,258,1085,1480,1387,916,10,0,0,10
745,2158,5450,1512,646,504,711,391,552,328,914,784,132,1463,695,354,363,458,983,223,1116,1427,1672,1012,0,0,0,0
746,2664,8242,2338,326,245,872,489,1058,232,1173,989,270,1596,1068,173,331,386,1774,241,1878,1805,2993,1325,51,0,0,51
747,1160,3553,1106,54,83,419,249,409,195,325,550,90,744,416,135,112,126,787,79,584,809,1266,815,0,0,0,0
748,1201,4134,1019,182,91,235,259,616,157,359,595,90,533,668,123,89,220,769,148,1046,1156,1236,548,14,0,0,14
749,2125,6702,1275,850,260,405,513,947,253,909,851,112,972,1153,220,413,502,990,418,1680,2358,1588,658,0,0,0,0
750,693,2222,472,221,73,131,175,314,65,232,351,45,234,459,121,57,154,361,137,638,773,469,205,19,0,0,19
751,13,43,10,3,1,2,4,6,1,4,7,1,4,9,1,1,3,8,3,13,15,10,2,0,0,0,0
752,548,1664,273,275,87,141,143,177,47,314,172,15,278,270,45,82,122,299,173,267,855,289,80,166,0,0,166
753,1473,4942,1307,166,108,340,331,694,217,561,584,111,819,654,102,141,294,936,129,1177,1269,1505,862,12,0,0,12
754,1211,3984,1090,121,64,364,273,510,203,442,322,244,866,345,99,82,234,796,77,717,961,1411,818,76,0,0,76
755,3346,10754,2518,828,282,747,788,1529,401,1137,1453,355,1957,1389,372,434,575,1965,346,2537,2892,3490,1489,1,0,0,1
756,2159,7276,1759,400,184,465,451,1059,183,588,1165,223,1056,1103,188,204,403,1364,249,1742,1906,2375,1004,24,0,0,24
757,797,2888,590,207,80,174,155,388,59,339,325,74,393,404,156,124,240,277,151,602,966,795,374,30,0,0,30
758,1923,6650,1410,513,180,447,416,880,197,800,629,297,1006,917,386,427,334,776,355,1446,2140,1886,823,20,0,0,20
759,2353,7661,1580,773,285,616,571,881,166,907,1006,274,1120,1233,157,315,795,1086,553,1355,2933,1853,967,27,0,0,27
760,1944,6334,1273,671,233,563,431,717,246,692,683,323,1211,733,327,410,525,682,371,1068,2438,1677,780,22,0,0,22
761,3779,11463,1458,2321,700,935,795,1349,511,1334,1597,337,1979,1800,770,674,914,1421,653,2374,4367,2847,1222,191,0,0,191
762,1240,3698,417,823,236,366,277,361,91,465,443,241,841,399,51,239,408,542,272,476,1747,820,383,19,0,0,19
763,2937,8014,645,2292,644,732,695,866,501,1364,824,248,1870,1067,540,763,839,795,728,1274,3804,1338,870,35,0,0,35
764,2210,7404,1271,939,254,594,484,878,214,835,621,540,1479,731,242,778,500,690,455,1243,2736,1876,1094,36,0,0,36
765,940,2959,696,244,136,246,229,329,93,262,418,167,512,428,87,154,276,423,174,479,1049,764,493,33,0,0,33
766,1053,3141,782,271,155,272,265,361,157,377,442,77,636,417,108,97,317,531,199,579,1031,859,473,22,0,0,22
767,3646,10860,2879,767,504,1087,814,1241,362,1023,1668,593,2282,1364,319,589,809,1929,808,1596,4419,2648,1389,14,0,0,14
768,3379,10824,2214,1165,420,944,702,1313,337,888,1636,518,2104,1275,385,505,749,1740,800,1765,4539,2507,1213,74,0,0,74
769,4241,13457,2580,1661,454,798,1097,1892,372,1478,2114,277,1684,2557,195,363,949,2734,1029,3197,5303,3015,913,69,0,0,69
770,1932,6455,1403,529,256,480,407,789,136,681,719,396,1359,573,249,381,489,813,345,1074,2304,1826,906,11,0,0,11
771,2567,7703,2010,557,416,821,493,837,461,846,917,343,1845,722,536,360,722,949,493,1120,2469,2033,1588,21,0,0,21
772,1466,5252,811,655,212,348,276,630,193,346,593,334,803,663,244,471,481,270,332,895,2159,1296,570,137,0,0,137
773,1958,6444,869,1089,301,468,410,779,237,644,761,316,1131,827,254,423,593,688,402,1221,2583,1575,663,32,0,0,32
774,3099,9773,1418,1681,649,817,656,977,387,1477,1131,104,2149,950,710,832,637,920,618,1703,3951,2421,1080,870,0,0,870
775,2973,9181,1757,1216,393,820,637,1123,461,1306,898,308,1910,1063,621,547,652,1153,585,1784,3236,2408,1168,36,0,0,36
776,2379,7264,1397,982,366,598,522,893,353,1021,839,166,1443,936,440,390,594,955,466,1503,2741,1672,882,41,0,0,41
777,2395,6098,202,2193,605,664,575,551,375,1196,792,32,1460,935,397,551,750,697,570,891,3087,857,693,0,0,0,0
778,5551,14460,2027,3524,1003,1874,1342,1332,681,2604,1924,342,3779,1772,922,889,1508,2232,1259,2025,7353,2561,1262,26,0,0,26
779,1655,5260,1348,307,179,382,358,736,161,432,875,187,954,701,113,183,318,1041,134,1249,1340,1675,862,0,0,0,0
780,1043,3241,944,99,83,307,240,413,212,305,413,113,678,365,172,98,210,563,80,612,805,1145,599,19,0,0,19
781,1583,4436,1182,401,329,503,280,471,386,534,503,160,1174,409,390,219,305,669,195,721,1229,1276,1015,11,0,0,11
782,2526,7206,1597,929,462,776,501,787,300,1113,973,140,1451,1075,248,606,676,996,387,1371,2516,1924,1008,50,0,0,50
783,1053,2921,504,549,151,359,227,316,106,426,465,56,726,327,138,149,300,466,166,545,1161,662,387,0,0,0,0
784,1843,5701,1257,586,251,485,385,722,326,486,847,184,1053,790,235,244,296,1068,307,1130,1912,1425,927,11,0,0,11
785,2248,7238,1228,1020,332,573,511,832,289,705,1004,250,1281,967,526,506,456,760,449,1466,2723,1724,876,91,0,0,91
786,1418,4616,1087,331,174,401,275,568,206,607,409,196,963,455,185,190,354,689,248,874,1503,1302,689,21,0,0,21
787,2352,7319,1478,874,301,584,537,930,341,952,822,237,1137,1215,328,236,631,1157,469,1475,2603,1776,996,18,0,0,18
788,1810,5897,1414,396,235,415,385,775,233,587,680,310,988,822,264,237,280,1029,246,1237,1814,1581,1019,18,0,0,18
789,1394,4720,1071,323,146,304,310,634,213,354,644,183,663,731,190,232,318,654,261,944,1607,1183,725,8,0,0,8
790,1913,6464,1589,324,175,460,408,870,265,684,736,228,1279,634,227,253,441,992,286,1074,2044,1842,1218,33,0,0,33
791,1028,3971,665,363,68,211,222,527,149,276,331,272,678,350,101,416,209,302,201,770,1370,1094,536,21,0,0,21
792,871,3181,707,164,91,192,161,427,108,335,287,141,493,378,108,155,237,371,162,498,1045,795,681,60,0,0,60
793,1387,4895,893,494,135,329,308,615,258,239,582,308,917,470,211,355,328,493,268,891,1665,1239,832,20,0,0,20
794,863,3034,758,105,46,218,185,414,86,202,433,142,511,352,76,137,197,453,141,485,1038,949,421,0,0,0,0
795,886,3148,407,479,101,172,182,431,78,248,277,283,535,351,91,266,296,233,160,643,1133,831,381,21,0,0,21
796,1943,7018,1544,399,194,495,430,824,342,539,679,383,1217,726,285,438,583,637,379,1043,2292,1947,1357,81,0,0,81
797,2200,7185,1573,627,295,592,447,866,321,918,658,303,1370,830,479,516,362,843,352,1272,2450,2034,1077,34,0,0,34
798,1662,4459,1228,434,332,598,295,437,369,647,473,173,1274,388,423,410,283,546,165,567,1382,1202,1143,17,0,0,17
799,1709,5293,1239,470,190,450,420,649,318,566,669,156,1049,660,134,297,373,905,289,1002,1691,1437,874,14,0,0,14
800,1841,5739,965,876,374,561,306,600,452,621,417,351,1382,459,524,412,431,474,309,785,2038,1345,1262,183,0,0,183
801,3971,11620,1913,2058,677,1304,770,1220,370,1631,1566,404,2741,1230,453,659,1077,1782,629,1697,5102,2815,1377,118,0,0,118
802,1476,5803,774,702,142,292,291,751,160,520,438,358,812,664,222,434,497,323,332,1232,2189,1415,635,22,0,0,22
803,1083,2583,419,664,369,336,129,249,451,325,234,73,823,260,269,253,255,306,144,340,799,483,817,0,0,0,0
804,1138,3594,766,372,193,299,198,448,183,379,360,216,746,392,147,392,291,308,188,619,1267,972,548,31,0,0,31
805,2108,7622,1542,566,263,488,390,967,231,492,809,576,1209,899,226,434,634,814,418,1428,2737,2065,974,13,0,0,13
806,3154,10140,2427,727,552,852,612,1138,619,987,1002,546,2373,781,687,925,745,797,452,1411,3197,2947,2133,166,0,0,166
807,1239,4752,994,245,150,263,226,600,219,301,453,266,683,556,298,339,352,250,229,932,1631,1278,682,13,0,0,13
808,912,3865,681,231,84,180,176,472,92,205,328,287,461,451,122,245,305,240,214,699,1367,1030,555,26,0,0,26
809,734,2460,606,128,79,166,123,366,129,169,290,146,510,224,108,291,236,99,133,347,840,680,460,18,0,0,18
810,3597,12063,2480,1117,570,841,661,1525,498,1163,1047,889,2525,1072,887,976,616,1118,689,1980,4414,3175,1805,51,0,0,51
811,2879,8513,1724,1155,569,885,555,870,478,922,1012,467,1942,937,652,845,692,690,534,1145,3263,2086,1485,75,0,0,75
812,1244,3724,899,345,278,329,185,452,243,435,413,153,903,341,297,292,347,308,140,608,1286,1087,603,46,0,0,46
813,945,3356,507,438,122,209,175,439,133,403,201,208,647,298,414,201,182,148,189,674,1203,863,427,40,0,0,40
814,935,3508,759,176,123,199,188,425,194,265,230,246,606,329,185,328,230,192,182,674,1246,911,495,17,0,0,17
815,1194,4722,309,885,98,189,233,674,224,543,273,154,619,575,439,305,282,168,295,1256,1800,991,380,23,0,0,23
816,937,3269,534,403,160,189,177,411,180,265,268,224,588,349,197,271,289,180,168,578,1114,827,582,23,0,0,23
817,2156,8395,260,1896,208,400,379,1169,249,724,618,565,1040,1116,625,870,464,197,622,2215,3471,1595,492,79,0,0,79
818,1381,4781,971,410,182,320,258,621,221,289,324,547,953,428,197,349,338,497,264,842,1771,1239,665,0,0,0,0
819,705,2426,298,407,110,179,113,303,136,283,167,119,416,289,236,199,152,118,145,430,1031,594,226,18,0,0,18
820,5075,14790,2991,2084,861,1644,950,1620,678,1576,2233,588,3347,1728,702,947,1217,2209,824,2583,5518,4052,1813,67,0,0,67
821,1430,5003,1055,375,307,508,245,370,219,450,594,167,1040,390,193,293,476,468,161,1195,1876,1045,726,1111,1084,0,27
822,1367,3977,1138,229,238,513,247,369,268,555,368,176,989,378,52,258,514,543,177,516,1195,1154,935,204,175,0,29
823,2832,7628,1557,1275,696,897,511,728,403,1040,1081,308,2170,662,734,474,829,795,471,1165,2931,1907,1154,64,0,0,64
824,1912,5629,599,1313,402,619,317,574,178,873,667,194,1234,678,510,688,432,282,363,946,2852,1067,401,168,149,0,19
825,1879,6694,673,1206,276,405,390,808,319,568,675,317,1210,669,611,582,386,300,422,1472,2692,1463,645,31,0,0,31
826,1832,5402,500,1332,419,477,334,602,257,648,712,215,1020,812,520,567,538,207,363,1063,2267,1194,515,38,0,0,38
827,1360,4312,638,722,247,345,310,458,149,567,239,405,835,525,223,455,347,335,265,788,1765,1016,478,8,0,0,8
828,3082,9676,1291,1791,527,871,608,1076,379,1279,1130,294,1960,1122,577,913,699,893,637,1781,4241,2102,915,31,0,0,31
829,1117,3718,643,474,198,278,199,442,170,499,303,145,651,466,327,269,311,210,221,714,1462,893,428,20,0,0,20
830,1927,7099,799,1128,273,366,319,969,228,712,598,389,1031,896,707,385,507,328,446,1633,2679,1671,670,0,0,0,0
831,1277,4078,190,1087,309,258,224,486,211,465,324,277,827,450,417,463,250,147,245,918,1430,982,503,90,0,0,90
832,1789,5771,1047,742,323,454,338,674,321,470,479,519,1137,652,516,444,306,523,300,990,1947,1606,928,0,0,0,0
833,1544,5049,1244,300,232,419,296,597,205,387,697,255,1015,529,336,385,452,371,281,854,1743,1387,784,21,0,0,21
834,1671,5431,1314,357,270,458,336,607,277,410,542,442,1099,572,284,436,519,432,256,936,1754,1578,907,28,0,0,28
835,1735,5735,1234,501,287,462,332,654,205,621,586,323,1019,716,425,476,499,335,262,1089,1934,1558,892,21,0,0,21
836,1477,4904,958,519,248,390,218,621,247,522,589,119,1085,392,254,553,386,284,298,963,1753,1291,599,24,0,0,24
837,3323,10881,956,2367,678,827,553,1265,514,1182,1237,390,2074,1249,893,1386,714,330,674,2228,4163,2603,1213,168,0,0,168
838,1462,4104,459,1003,428,363,253,418,260,600,390,212,1055,407,545,416,299,202,220,714,1497,1037,636,50,0,0,50
839,1951,4817,575,1376,719,519,272,441,422,627,701,201,1417,534,644,563,398,346,278,783,1958,1099,699,122,0,0,122
840,2576,5930,1397,1179,862,793,422,499,556,1102,763,155,1971,605,528,844,723,481,310,719,2102,1579,1220,32,0,0,32
841,1720,4914,710,1010,392,488,296,544,142,749,671,158,1280,440,476,520,444,280,292,836,1888,1198,700,0,0,0,0
842,1344,3502,445,899,320,438,213,373,128,432,646,138,989,355,341,439,409,155,225,562,1463,868,384,20,0,0,20
843,1442,4449,1111,331,245,421,301,475,246,548,464,184,992,450,184,346,516,396,250,664,1541,1234,760,33,0,0,33
844,3238,9404,2815,423,464,1061,642,1071,503,1046,1164,525,2216,1022,420,360,693,1765,425,1730,2459,2933,1857,24,3,0,21
845,2495,7419,2179,316,365,808,491,831,406,643,1124,322,1322,1173,294,441,559,1201,373,1392,1992,2102,1560,3,0,0,3
846,2197,6185,1414,783,487,628,401,681,423,737,617,420,1504,693,680,563,482,472,308,1225,2052,1681,919,14,0,0,14
847,1201,3049,378,823,336,351,226,288,207,459,416,119,823,378,292,431,266,212,160,553,1122,780,434,0,0,0,0
848,1854,5068,400,1454,418,533,348,555,225,712,757,160,1062,792,540,439,498,377,347,1020,1955,1179,567,48,0,0,48
849,1393,4209,1082,311,220,414,260,499,193,500,590,110,805,588,370,288,317,418,223,880,1272,1147,687,17,0,0,17
850,1328,3940,1150,178,194,429,265,440,181,356,556,235,791,537,134,168,385,641,213,733,1115,1089,790,0,0,0,0
851,741,2183,672,69,89,257,146,249,85,214,390,52,500,241,40,87,191,423,121,426,587,587,462,0,0,0,0
852,2146,6373,1729,417,376,639,401,730,307,577,1020,242,1448,698,410,500,405,831,314,1211,1895,1746,1207,17,0,0,17
853,2168,6082,1211,957,456,769,410,533,327,716,843,282,1569,599,608,597,556,407,341,998,2337,1566,840,18,0,0,18
854,2327,6861,416,1911,483,647,418,779,333,903,1030,61,1205,1122,992,710,495,130,483,1548,2781,1527,522,24,0,0,24
855,1795,5453,571,1224,409,460,344,582,266,803,448,278,1185,610,966,316,224,289,354,1161,2051,1272,615,65,0,0,65
856,2480,7727,1106,1374,521,594,491,874,228,855,1003,394,1632,848,743,640,687,410,431,1342,2953,2057,944,49,0,0,49
857,1096,3628,442,654,209,255,189,443,119,447,356,174,654,442,349,341,232,174,233,713,1428,912,342,27,0,0,27
858,2127,6307,1210,917,416,551,412,748,492,795,584,256,1487,640,630,694,480,323,254,1113,2067,1816,1057,33,0,0,33
859,1377,4480,1028,349,234,355,239,549,319,380,348,330,1083,294,582,229,273,293,196,753,1374,1333,824,10,0,0,10
860,2283,6521,1823,460,494,692,394,703,362,641,1032,248,1709,574,430,618,510,725,290,939,1854,2063,1375,23,0,0,23
861,2251,7559,1697,554,303,609,440,899,272,589,796,594,1539,712,466,711,715,359,337,1241,2382,2202,1397,30,0,0,30
862,2826,7583,1122,1704,798,754,573,701,471,1070,635,650,2090,736,1051,887,477,411,495,1241,2798,1822,1227,21,0,0,21
863,1308,3968,765,543,228,377,232,471,110,519,394,285,835,473,271,330,340,367,227,633,1364,1087,657,26,0,0,26
864,3372,8030,845,2527,1180,1043,468,681,589,1455,951,377,2591,781,1269,1128,589,386,407,1367,3225,2055,976,18,0,0,18
865,1449,4198,1080,369,326,414,271,438,220,576,444,209,1022,427,404,417,362,266,208,612,1391,1255,732,23,0,0,23
866,1457,3968,1128,329,335,508,235,379,360,460,381,256,1109,348,338,264,411,444,194,547,1175,1158,894,26,0,0,26
867,1085,2783,770,315,262,362,167,294,155,469,282,179,758,327,273,323,147,342,146,459,839,805,534,1,0,0,1
868,1373,3892,999,374,320,441,246,366,116,514,500,243,968,405,208,191,298,676,208,638,1260,1158,628,198,0,0,198
869,1636,4035,732,904,538,488,251,359,301,705,470,160,1236,400,517,400,338,381,196,611,1340,1020,868,57,0,0,57
870,1633,4768,1015,618,340,447,324,522,195,517,687,234,1225,408,395,201,389,648,245,840,1692,1353,638,40,0,0,40
871,3124,7360,896,2228,1103,905,443,673,399,1389,1060,276,2399,725,914,898,807,505,353,1010,2733,1872,1392,77,0,0,77
872,2935,9802,1564,1371,508,727,568,1132,224,952,933,826,1973,962,819,678,762,676,498,1744,3556,2671,1333,22,0,0,22
873,1911,6368,863,1048,335,475,380,721,269,564,687,391,1049,862,562,555,491,303,351,1183,2247,1738,849,25,0,0,25
874,0,0,0,0,0,0,0,0,0,0,0,0,0,0,0,0,0,0,0,0,0,0,0,0,0,0,0
875,1100,4991,579,521,164,236,170,530,100,435,326,239,525,575,389,381,196,134,279,1034,1760,1399,519,749,0,0,749
876,617,2360,359,258,75,133,112,297,80,223,154,160,412,205,207,230,113,67,172,583,902,512,191,0,0,0,0
877,940,3755,499,441,120,175,146,499,134,381,268,157,570,370,288,418,185,49,261,892,1457,851,294,65,0,0,65
878,1576,5696,688,888,276,320,254,726,331,536,380,329,775,801,698,610,183,85,410,1360,2059,1308,559,91,0,0,91
879,1255,3911,744,511,283,339,215,418,120,520,300,315,846,409,412,299,374,170,217,785,1474,964,471,13,0,0,13
880,1160,4449,448,712,161,204,213,582,139,394,384,243,526,634,561,324,217,58,264,1188,1790,886,321,14,0,0,14
881,1123,3455,502,621,227,297,212,387,138,452,390,143,727,396,382,396,205,140,233,729,1307,780,406,29,0,0,29
882,1187,3327,648,539,341,305,221,320,172,493,452,70,705,482,375,327,293,192,217,612,1233,807,458,6,0,0,6
883,1221,3215,1049,172,229,471,215,306,290,291,560,80,964,257,235,232,243,511,158,494,908,939,716,11,0,0,11
884,1399,3519,1228,171,323,517,241,318,213,435,693,58,995,404,197,270,361,571,175,488,925,1009,922,22,0,0,22
885,2770,6645,2224,546,684,1104,438,544,445,999,1229,97,1997,773,368,514,602,1286,306,890,2020,1921,1508,0,0,0,0
886,1747,4740,1145,602,472,545,303,427,251,726,596,174,1435,312,471,342,430,504,292,800,1759,1227,662,32,0,0,32
887,1231,3268,782,449,350,371,198,312,175,590,313,153,813,418,283,334,278,336,185,554,1116,825,588,63,0,0,63
888,1652,5523,526,1126,316,394,314,628,372,652,457,171,1001,651,983,449,161,59,370,1386,2093,1215,459,40,0,0,40
889,1200,3903,457,743,238,305,212,445,146,457,427,170,828,372,471,394,184,151,247,864,1573,859,360,16,0,0,16
890,1699,5991,687,1012,303,375,305,716,281,637,461,320,1065,634,740,455,311,193,399,1469,2294,1291,538,20,0,0,20
891,1479,5607,538,941,251,286,252,690,300,598,418,163,1093,386,747,405,124,203,379,1424,2176,1211,417,15,0,0,15
892,1234,5084,523,711,140,203,249,642,182,438,330,284,774,460,565,344,226,99,315,1362,2011,1093,303,102,0,0,102
893,981,4043,311,670,152,162,151,516,109,510,230,132,442,539,492,305,125,59,268,1083,1542,880,270,176,0,0,176
894,1133,4212,317,816,272,196,169,496,235,463,252,183,670,463,617,282,165,69,277,1019,1636,899,381,242,0,0,242
895,2209,7468,508,1701,537,504,362,806,371,963,500,375,1204,1005,1253,637,276,43,479,1908,2856,1472,753,219,0,0,219
896,779,3870,226,553,152,189,113,325,84,365,146,184,464,315,299,221,202,57,187,828,1709,892,254,1046,0,0,1046
897,1229,4472,358,871,265,245,228,491,278,397,302,252,726,503,596,351,234,48,310,1064,1840,899,359,74,0,0,74
898,1323,4344,315,1008,349,257,241,476,258,615,404,46,757,566,713,381,151,78,304,1058,1730,872,380,41,0,0,41
899,2461,7820,1006,1455,556,568,399,938,566,1200,289,406,1682,779,1325,613,275,248,472,1747,3087,1707,807,36,0,0,36
900,1815,6115,749,1066,418,436,288,673,238,647,568,362,1191,624,739,479,488,109,374,1362,2322,1417,640,158,0,0,158
901,1730,4418,818,912,506,544,273,407,290,706,570,164,1231,499,619,434,245,432,263,843,1671,1081,560,0,0,0,0
902,788,2426,513,275,181,290,126,191,114,287,359,28,551,237,236,146,175,231,144,416,1014,530,322,310,276,0,34
903,1782,4465,1355,427,467,602,340,373,271,698,715,98,1214,568,282,574,371,555,273,615,1473,1291,813,9,0,0,9
904,2182,6403,1059,1123,575,610,357,640,153,979,689,361,1376,806,663,659,487,373,367,1305,2490,1488,753,53,0,0,53
905,2465,8032,1026,1439,547,609,411,898,350,900,993,222,1495,970,1130,610,344,381,474,1616,3132,1854,956,22,0,0,22
906,2126,6018,843,1283,565,619,371,571,249,728,954,195,1331,795,564,639,566,357,347,1100,2344,1493,734,28,0,0,28
907,1178,3088,839,339,240,412,253,273,99,602,443,34,701,477,169,299,290,420,189,481,1064,832,522,20,0,0,20
908,1431,3602,780,651,351,454,300,326,193,444,760,34,1148,283,255,298,460,418,195,614,1224,976,593,16,0,0,16
909,1502,3801,1020,482,356,491,302,353,194,536,720,52,1054,448,171,394,381,556,190,564,1261,1101,685,36,0,0,36
910,2280,5567,1542,738,716,764,374,426,273,756,929,322,1715,565,352,526,516,886,340,711,1843,1584,1089,237,0,0,237
911,989,2479,833,156,226,394,164,205,212,314,344,119,790,199,119,191,168,511,99,329,650,730,671,104,104,0,0
912,1832,4534,1654,178,357,734,351,390,392,639,703,98,1291,541,188,227,333,1084,235,635,1093,1443,1128,1,1,0,0
913,2497,6225,2105,392,534,915,488,560,409,849,1076,163,1792,705,229,290,456,1522,382,938,1728,1888,1289,29,0,0,29
914,2378,5710,1957,421,619,895,410,454,396,1040,811,131,1782,596,436,311,385,1246,316,865,1627,1746,1156,0,0,0,0
915,1498,3705,1142,356,382,506,263,347,270,470,686,72,1006,492,146,230,249,873,218,603,1021,1022,841,7,2,0,5
916,1612,4074,1217,395,392,568,305,347,278,580,659,95,1111,501,119,238,343,912,218,695,1129,1186,846,116,104,0,12
917,2230,5815,1550,680,499,659,355,717,357,799,974,100,1412,818,322,329,339,1240,239,1276,1471,1691,1138,1,0,0,1
918,2035,6084,1847,188,253,634,340,808,276,715,911,133,1180,855,57,172,238,1568,267,1517,1100,1821,1379,9,0,0,9
919,712,1837,615,97,154,260,105,193,86,272,301,53,461,251,30,76,151,455,87,346,391,554,459,0,0,0,0
920,798,2000,693,105,137,315,148,198,122,261,332,83,589,209,69,93,120,516,102,311,508,638,441,0,0,0,0
921,1239,2757,586,653,434,371,196,238,275,536,369,59,959,280,342,284,206,407,155,425,961,704,512,0,0,0,0
922,1997,4381,1078,919,726,643,288,340,236,597,1093,71,1509,488,438,271,528,760,250,602,1365,1235,929,0,0,0,0
923,2690,7388,999,1691,723,772,473,722,445,1185,861,199,2039,651,1064,795,397,434,425,1306,2921,1837,899,67,0,0,67
924,1954,6184,612,1342,412,514,346,682,170,713,735,336,1156,798,782,484,455,233,366,1274,2445,1380,719,46,0,0,46
925,1926,6715,466,1460,411,395,317,803,208,667,727,324,1140,786,830,674,277,145,458,1499,2724,1332,702,42,0,0,42
926,1873,5840,499,1374,611,522,282,458,331,738,622,182,1432,441,774,565,187,347,246,918,2493,1575,608,827,0,0,827
927,1366,4584,177,1189,283,287,207,589,249,499,302,316,875,491,679,430,141,116,256,1155,1846,864,463,0,0,0,0
928,1451,4846,317,1134,367,310,240,534,168,620,411,252,826,625,733,489,137,92,322,1012,2079,1020,413,39,0,0,39
929,1264,3952,463,801,320,324,197,423,158,472,399,235,756,508,563,314,191,196,180,839,1512,913,508,37,0,0,37
930,710,1904,355,355,201,210,120,179,124,331,164,91,417,293,290,185,109,126,79,249,621,406,549,56,0,0,56
931,1355,3370,387,968,462,381,195,317,102,680,469,104,1125,230,343,590,275,147,163,529,1417,834,427,9,0,0,9
932,1354,4357,505,849,265,338,272,479,168,633,347,206,840,514,546,451,205,152,262,858,1711,1003,523,0,0,0,0
933,2179,7592,556,1623,386,536,474,783,289,825,567,498,1286,893,990,588,375,226,395,1566,2987,1747,897,217,0,0,217
934,3325,7999,383,2942,1155,1016,460,694,524,1391,1109,301,2716,609,1419,898,580,428,377,1100,3799,1736,987,25,0,0,25
935,1588,3826,355,1233,533,513,226,316,246,708,529,105,1330,258,587,404,297,300,169,467,1834,899,457,84,0,0,84
936,1425,3206,346,1079,549,403,197,276,130,771,342,182,1209,216,538,387,214,286,151,414,1473,754,414,0,0,0,0
937,1524,3414,948,576,488,501,250,285,171,518,777,58,1068,456,294,181,379,670,236,466,1092,946,674,8,0,0,8
938,1587,4363,1445,142,261,564,313,449,193,480,813,101,994,593,132,135,222,1098,289,813,1070,1193,998,10,0,0,10
939,1936,3805,681,1255,772,737,212,215,155,1046,701,34,1569,367,321,321,475,819,184,346,1720,952,603,12,0,0,12
940,2404,4278,762,1642,1173,822,214,195,439,1078,866,21,2074,330,552,604,527,721,163,294,2188,965,668,21,0,0,21
941,2852,5067,520,2332,1413,991,244,204,441,1343,1033,35,2384,468,555,1030,695,572,213,326,2843,1081,604,34,0,0,34
942,2814,4667,426,2388,1498,963,211,142,464,1283,1032,35,2481,333,625,895,732,562,156,210,2595,878,828,67,0,0,67
943,2565,5064,679,1886,1125,856,290,294,265,1274,916,110,2165,400,645,572,732,616,224,413,2501,1172,754,11,0,0,11
944,2539,4545,178,2361,1262,852,232,193,357,1224,807,151,2338,201,891,579,413,656,158,295,2295,951,846,49,0,0,49
945,3700,6121,389,3311,2179,1105,232,184,823,2164,682,31,3484,216,1638,880,557,625,187,317,2941,1195,1481,288,0,0,288
946,2476,5130,487,1989,1023,962,256,235,359,991,876,250,2133,343,819,289,655,713,163,329,2662,1234,742,319,0,0,319
947,1853,5270,236,1617,681,571,229,372,333,701,533,286,1445,408,865,422,249,317,178,680,2381,1241,790,881,0,107,774
948,1710,4481,688,1022,506,504,310,390,138,752,722,98,1008,702,481,341,466,422,236,707,1651,1297,590,122,0,104,18
949,1450,3884,1023,427,293,435,290,432,214,429,670,137,857,593,121,190,322,817,205,750,966,1147,816,0,0,0,0
950,2000,4905,1016,984,588,600,325,487,274,691,855,180,1340,660,297,382,525,796,233,914,1454,1489,815,0,0,0,0
951,2659,6619,1544,1115,727,845,468,619,596,935,971,157,1851,808,751,566,523,819,311,1200,1973,1915,1220,0,0,0,0
952,2470,7044,1903,567,492,690,488,800,289,678,1087,416,1511,959,189,437,564,1280,411,1385,2008,2066,1174,45,0,0,45
953,2583,7052,2248,335,438,877,478,790,507,669,1085,322,1672,911,334,220,505,1524,346,1206,1625,2086,1789,18,0,0,18
954,1909,4349,578,1331,636,638,294,341,238,876,707,88,1308,601,544,526,418,421,218,597,1551,1131,852,0,0,0,0
955,1344,2997,205,1139,500,385,211,248,179,722,429,14,907,437,344,453,377,170,149,444,1251,827,326,0,0,0,0
956,2081,4744,775,1306,726,651,308,396,348,752,832,149,1444,637,456,550,433,642,260,673,1663,1319,829,46,0,0,46
957,1450,3347,484,966,463,471,234,282,203,599,621,27,1122,328,250,265,427,508,159,534,1172,926,556,14,0,0,14
958,1521,3231,777,744,566,511,227,217,187,766,509,59,1245,276,248,383,379,511,155,373,1137,835,731,10,0,0,10
959,2068,4857,827,1241,653,681,323,411,241,986,713,128,1503,565,638,352,281,797,252,725,1705,1423,752,2,0,0,2
960,2124,5571,994,1130,650,665,330,479,297,785,924,118,1390,734,534,456,394,740,268,848,1818,1495,1142,306,0,0,306
961,1253,3828,710,543,177,338,245,493,236,377,553,87,685,568,360,134,167,592,350,812,1477,709,480,42,0,0,42
962,1761,4698,364,1397,420,588,306,447,256,715,681,109,1322,439,511,608,400,242,258,825,2035,1022,558,1,0,0,1
963,2358,5048,832,1526,886,810,289,373,287,987,955,129,1925,433,572,511,535,740,220,637,1974,1354,863,0,0,0,0
964,239,709,3,236,56,62,53,68,45,72,105,17,131,108,137,69,7,26,35,203,225,197,49,8,0,0,8
965,258,977,120,138,63,89,33,73,38,77,104,39,216,42,72,45,63,78,33,92,386,383,83,233,0,0,233
966,36,206,21,15,7,7,7,15,3,28,5,0,36,0,0,3,22,11,23,28,73,56,26,113,0,0,113
967,447,872,314,133,186,142,62,57,33,258,156,0,430,17,47,59,139,202,31,38,451,237,115,121,0,0,121
968,1264,2263,415,849,604,484,84,92,489,454,296,25,1173,91,688,237,206,133,43,124,694,468,934,94,0,0,94
969,1169,2238,260,909,525,419,120,105,217,614,316,22,1065,104,414,152,283,320,69,134,1112,494,429,148,0,0,148
970,2433,4632,179,2254,1393,685,195,160,532,1275,546,80,1936,497,1192,335,447,459,130,380,2353,1061,708,527,284,0,243
971,772,1225,3,769,479,246,23,24,267,345,158,2,735,37,382,111,139,140,24,55,649,223,274,38,9,0,29
972,4370,7705,512,3858,2187,1581,360,242,746,2144,1325,155,3814,556,1463,873,980,1054,280,444,4526,1359,1096,122,0,0,122
973,1403,2551,384,1019,664,519,116,104,181,776,420,26,1161,242,378,375,319,331,111,177,1377,542,344,9,0,0,9
974,2976,5057,755,2221,1588,945,256,187,592,1255,1092,37,2665,311,778,634,665,899,201,272,2326,978,1280,24,0,0,24
975,1269,2715,437,832,461,499,155,154,113,556,522,78,1080,189,265,308,207,489,131,225,1466,611,282,155,0,0,155
976,2370,4908,472,1898,1011,799,296,264,252,1245,707,166,1888,482,562,802,460,546,225,451,2956,917,359,188,0,0,188
977,2942,7027,935,2007,956,1050,460,476,274,1154,1145,369,2372,570,647,493,689,1113,325,819,3830,1399,654,199,0,0,199
978,1612,5057,339,1273,486,508,271,347,176,550,518,368,1288,324,486,510,333,283,230,680,2630,1108,409,672,0,0,672
979,2308,5600,227,2081,1145,775,229,159,214,1352,645,97,2054,254,665,582,621,440,200,360,3054,1306,680,1408,0,0,1408
980,510,1308,119,391,169,131,86,124,76,216,146,72,417,93,142,82,131,155,63,198,676,268,103,14,0,0,14
981,362,678,57,305,165,106,44,47,99,180,52,31,310,52,223,71,23,45,20,61,236,149,212,23,0,0,23
982,746,2010,109,637,248,196,129,173,206,313,202,25,537,209,429,196,86,35,137,497,813,407,156,7,0,0,7
983,1107,2449,206,901,459,342,134,172,329,532,149,97,906,201,761,130,115,101,104,258,1167,472,448,29,0,0,29
984,173,478,18,155,66,44,27,36,30,89,43,11,103,70,108,31,10,24,26,107,179,115,51,52,0,0,52
985,703,2075,88,615,235,188,110,170,122,362,174,45,417,286,402,127,60,114,134,462,821,458,200,213,0,0,213
986,706,2322,198,508,187,231,126,162,109,209,275,113,585,121,198,210,165,133,106,333,1164,480,239,406,0,0,406
987,774,1981,173,601,228,260,140,146,100,364,244,66,539,235,239,277,104,154,74,246,1102,407,152,22,0,0,22
988,1737,6040,773,964,584,637,268,248,27,933,648,129,1422,315,210,316,605,606,209,441,2913,2075,402,2099,0,0,2099
989,958,2979,214,744,280,305,175,198,102,447,294,115,663,295,307,214,137,300,134,468,1525,680,172,437,0,0,437
990,1143,2719,355,788,470,300,178,195,215,473,267,188,944,199,494,224,227,198,116,285,1423,627,268,107,0,0,107
991,6408,11784,1943,4465,2935,2209,695,569,742,3560,1845,261,5828,580,1479,1551,1409,1969,519,806,6753,2312,1394,254,0,0,254
992,1081,2474,417,664,355,370,167,189,88,378,436,179,754,327,164,369,196,352,128,300,1237,586,223,12,0,0,12
993,1812,4225,670,1142,641,640,243,288,180,808,689,135,1463,349,540,411,359,502,210,461,2136,867,551,122,0,0,122
994,915,2217,349,566,286,300,137,192,129,364,351,71,649,266,255,217,242,201,111,379,974,486,267,28,0,0,28
995,1532,4075,403,1129,475,526,249,282,187,779,408,158,1173,359,570,294,313,355,155,539,2154,826,401,395,42,0,353
996,1965,4606,803,1162,583,693,369,320,172,845,688,260,1545,420,456,531,486,492,240,464,2367,986,549,36,2,0,34
997,656,1628,268,388,161,227,126,142,47,236,324,49,486,170,101,96,194,265,114,182,820,335,177,17,0,0,17
998,2369,5079,999,1370,908,829,298,334,430,887,887,165,1838,531,412,483,405,1069,280,586,2040,1266,907,131,28,0,103
999,985,2333,564,421,271,392,113,209,124,443,354,64,754,231,106,135,190,554,119,311,863,530,510,66,0,0,66
1000,1798,4050,780,1018,556,671,250,321,268,580,819,131,1324,474,321,251,416,810,222,494,1886,873,575,25,0,0,25
1001,1610,3639,662,948,535,572,231,272,209,696,516,189,1323,287,470,388,337,415,212,377,1808,790,452,4,0,0,4
1002,864,1970,292,572,307,292,148,117,133,285,331,115,689,175,256,177,158,273,76,231,967,404,292,68,1,0,67
1003,716,1532,296,420,246,255,104,111,96,289,276,55,593,123,191,80,102,343,62,163,683,341,283,1,0,0,1
1004,1334,3138,978,356,355,500,218,261,232,647,415,40,1020,314,187,177,246,724,140,407,868,791,932,0,0,0,0
1005,1244,2925,1070,174,300,513,218,213,250,589,317,88,899,345,159,96,250,739,103,340,693,920,869,0,0,0,0
1006,1429,4234,481,948,543,431,206,249,307,538,464,120,1118,311,402,313,168,546,110,1275,1630,529,690,1032,1021,0,11
1007,1106,4868,131,975,482,299,154,171,364,423,182,137,1052,54,573,205,159,169,59,787,3684,183,155,2348,2340,0,8
1008,1848,11245,21,1827,869,503,281,195,505,1076,116,151,1848,0,1318,370,121,39,79,5204,5603,218,141,7441,7364,0,77
1009,2391,5504,317,2074,919,746,368,358,448,822,795,326,2174,217,1058,679,262,392,133,537,3942,496,396,165,113,0,52
1010,1283,2886,487,796,474,416,180,213,144,590,421,128,1061,222,247,233,291,512,108,299,1449,534,496,20,2,0,18
1011,1496,3366,426,1070,618,484,207,187,222,666,497,111,1168,328,489,355,259,393,136,303,1608,703,616,238,45,0,193
1012,2098,5057,778,1320,680,668,323,427,368,570,771,389,1610,488,632,412,397,657,214,742,2288,1159,654,54,0,0,54
1013,1581,3738,847,734,526,474,232,349,323,558,626,74,1151,430,580,305,225,471,198,606,1371,992,571,0,0,0,0
1014,1287,4141,323,964,527,458,153,149,97,590,551,49,1115,172,172,279,429,407,162,454,2013,1138,374,1527,0,0,1527
1015,1158,2879,352,806,383,343,192,240,204,501,367,86,867,291,479,240,167,272,143,466,1238,675,357,60,0,0,60
1016,1936,4289,768,1168,760,555,296,325,532,939,401,64,1397,539,909,347,364,316,192,582,1704,1024,787,142,122,0,20
1017,2034,4562,819,1215,741,751,266,276,240,934,582,278,1688,346,643,499,272,620,161,490,2110,1019,782,178,36,0,142
1018,2279,5262,56,2223,1048,579,314,338,433,1300,420,126,2054,225,1178,585,358,158,163,627,3390,729,353,539,137,0,402
1019,199,1273,14,185,86,52,23,38,49,94,38,18,178,21,114,57,12,16,13,159,1010,68,23,888,852,0,36
1020,1821,5572,290,1531,835,565,236,185,258,1005,420,138,1698,123,874,392,282,273,85,1279,3334,485,389,1987,1910,0,77
1021,1837,3740,262,1575,781,625,240,191,392,782,502,161,1737,100,669,475,242,451,93,321,2416,483,427,59,0,0,59
1022,1720,3687,546,1174,629,610,256,225,412,798,387,123,1441,279,446,499,359,416,143,434,1684,771,655,35,0,0,35
1023,1586,3392,676,910,622,518,204,242,211,769,539,67,1144,442,356,449,279,502,163,438,1472,767,552,42,0,0,42
1024,1117,2724,469,648,351,356,194,216,128,464,482,43,832,285,260,239,264,354,125,423,1083,698,395,0,0,0,0
1025,1703,3928,1061,642,507,619,259,318,212,632,687,172,1169,534,335,295,345,728,188,599,1251,1062,828,15,0,0,15
1026,774,1862,525,249,203,250,153,168,122,337,248,67,609,165,108,117,215,334,63,293,528,514,464,0,0,0,0
1027,1677,3634,602,1075,592,608,241,236,383,742,445,107,1403,274,531,302,412,432,108,426,1626,751,723,38,0,0,38
1028,1576,3826,1175,401,446,621,238,271,339,620,547,70,1249,327,185,180,301,910,146,509,1034,1002,1135,96,8,0,88
1029,1510,3659,1230,280,360,601,251,298,265,572,621,52,1138,372,176,188,315,831,131,528,861,1037,1102,46,27,0,19
1030,833,2015,749,84,154,368,140,171,148,323,307,55,645,188,74,97,133,529,74,268,403,610,660,20,0,0,20
1031,1449,3657,1305,144,259,602,272,316,287,472,624,66,1067,382,64,248,238,899,127,557,736,1012,1225,0,0,0,0
1032,652,1679,536,116,159,206,113,174,172,119,293,68,517,135,79,109,122,342,65,263,433,438,480,0,0,0,0
1033,1705,4086,1380,325,437,628,295,345,405,643,547,110,1333,372,449,274,284,698,146,694,828,1198,1220,0,0,0,0
1034,1307,3399,972,335,271,428,218,390,162,596,497,52,796,511,275,236,193,603,147,694,855,962,741,13,0,0,13
1035,854,2295,635,219,135,282,150,287,167,223,443,21,509,345,106,155,158,435,84,506,521,709,475,0,0,0,0
1036,1254,3234,506,748,286,380,252,336,171,378,520,185,791,463,202,281,325,446,182,653,1110,841,448,13,0,0,13
1037,939,2443,453,486,217,249,194,279,109,418,335,77,575,364,166,239,199,335,125,499,800,654,365,13,0,0,13
1038,1064,3752,9,1055,227,468,167,202,196,458,399,11,696,368,458,272,198,136,244,1168,1984,136,220,1327,1223,0,104
1039,2033,5019,1048,985,574,545,403,511,268,903,791,71,1254,779,294,619,488,632,270,973,1696,1324,756,19,0,0,19
1040,731,1801,77,654,214,225,123,169,62,314,272,83,503,228,237,227,218,49,104,221,937,358,181,10,0,0,10
1041,1020,2434,403,617,290,339,179,212,164,424,302,130,815,205,278,247,246,249,146,325,1057,566,340,2,0,0,2
1042,722,1728,607,115,173,255,148,146,151,288,252,31,560,162,101,120,131,370,92,241,432,506,457,49,39,0,10
1043,1164,2869,938,226,284,426,188,266,313,416,391,44,824,340,122,177,273,592,109,451,692,799,818,13,3,0,10
1044,1008,2428,850,158,243,362,158,245,273,184,472,79,732,276,76,195,187,550,114,370,545,692,707,0,0,0,0
1045,1128,2865,968,160,252,433,197,246,348,378,348,54,887,241,182,235,172,539,119,373,714,803,856,0,0,0,0
1046,914,2376,773,141,190,312,179,233,226,359,295,34,702,212,151,128,224,411,120,379,559,744,574,0,0,0,0
1047,1229,2993,555,674,336,406,231,256,257,439,406,127,807,422,338,300,244,347,185,445,1126,716,521,8,0,0,8
1048,1155,2819,550,605,308,363,243,241,179,478,463,35,740,415,228,315,305,307,144,412,1022,761,480,12,0,0,12
1049,2068,5105,1116,952,595,699,355,419,271,732,903,162,1380,688,680,433,469,486,267,662,1920,1327,929,34,0,0,34
1050,2739,8308,949,1790,662,720,492,865,518,1203,682,336,1584,1155,1328,743,427,241,539,1744,3270,1784,971,259,0,0,259
1051,1407,3478,426,981,432,424,241,310,391,368,472,176,1111,296,628,340,267,172,158,481,1458,786,595,13,0,0,13
1052,578,1453,474,104,106,227,94,151,171,171,200,36,363,215,124,90,141,223,64,220,352,428,389,0,0,0,0
1053,1614,4028,1351,263,350,563,295,406,289,634,650,41,1180,434,236,302,314,762,188,611,1134,1176,919,1,0,0,1
1054,1145,2975,836,309,269,400,202,274,145,331,586,83,778,367,141,203,347,454,152,407,965,851,600,46,0,0,46
1055,1987,5995,1066,921,447,549,309,682,210,837,535,405,1393,594,287,865,530,305,311,1024,2255,1540,865,52,0,0,52
1056,1758,4994,900,858,486,478,268,526,437,616,609,96,1156,602,707,405,496,150,256,911,1817,1288,722,3,0,0,3
1057,1256,4866,428,828,147,189,234,686,271,307,333,345,516,740,508,356,303,89,330,1299,1977,977,283,10,0,0,10
1058,2168,7250,904,1264,493,526,379,770,599,761,539,269,1305,863,886,558,451,273,445,1569,2759,1652,825,283,0,0,283
1059,3199,7422,1974,1225,1149,1076,459,515,588,1713,840,58,2666,533,985,712,784,718,399,972,2973,1986,1092,289,0,0,289
1060,1956,7176,875,1081,336,384,340,896,203,751,568,434,770,1186,782,690,386,98,505,1773,2771,1500,627,31,0,0,31
1061,2413,7725,862,1551,598,518,416,881,811,819,535,248,1332,1081,1426,584,309,94,539,1878,2910,1584,814,31,0,0,31
1062,1924,3892,1080,844,742,715,225,242,442,712,633,137,1611,313,344,404,494,682,146,392,1065,1168,1121,10,0,0,10
1063,1896,6941,664,1232,314,344,362,876,322,630,573,371,1008,888,800,618,327,151,452,1727,2732,1463,567,40,0,0,40
1064,1199,4676,642,557,174,180,217,628,145,353,507,194,611,588,313,421,335,130,254,1142,1782,1025,473,0,0,0,0
1065,2341,8004,1396,945,409,587,390,955,154,939,902,346,1548,793,499,1005,610,227,437,1592,2950,2099,926,53,0,0,53
1066,2334,6443,798,1536,679,545,356,754,483,1115,493,243,1463,871,910,968,380,76,323,1180,2276,1514,1150,46,0,0,46
1067,2487,9615,1020,1467,231,472,466,1318,359,977,877,274,1163,1324,842,940,551,154,658,2357,3762,2093,745,9,0,0,9
1068,1452,6085,647,805,208,260,258,726,164,473,488,327,620,832,430,503,359,160,406,1472,2402,1366,439,385,0,0,385
1069,4090,11227,1612,2478,1100,1215,666,1109,715,1606,1529,240,2855,1235,1089,1463,854,684,599,1867,4589,2851,1321,0,0,0,0
1070,1272,4492,736,536,203,227,238,604,149,505,372,246,688,584,405,387,316,164,237,923,1665,1139,528,0,0,0,0
1071,1805,6525,878,927,253,361,338,853,353,538,544,370,854,951,673,609,394,129,383,1546,2424,1488,684,0,0,0,0
1072,1731,5909,871,860,262,410,338,721,258,719,431,323,1048,683,551,472,429,279,339,1203,2189,1532,646,0,0,0,0
1073,2046,5868,964,1082,578,549,327,592,381,911,473,281,1335,711,716,680,505,145,358,1043,2212,1441,814,23,0,0,23
1074,2679,7612,1710,969,613,817,514,735,422,1043,829,385,1936,743,452,1032,755,440,425,1179,2667,2080,1261,64,0,0,64
1075,1084,2889,601,483,294,289,182,319,153,467,404,60,731,353,292,452,189,151,151,480,1061,741,456,33,0,0,33
1076,1226,3023,978,248,313,417,234,262,225,437,417,147,1002,224,281,288,374,283,148,419,853,872,731,10,0,0,10
1077,1929,5245,1225,704,457,597,309,566,302,704,744,179,1267,662,437,473,598,421,248,817,1730,1527,923,3,0,0,3
1078,1627,4588,955,672,371,511,297,448,261,516,531,319,1025,602,313,443,535,336,217,744,1554,1246,827,15,0,0,15
1079,3256,9264,2746,510,559,1181,630,886,894,1170,610,582,2389,867,751,645,919,941,377,1350,2588,2608,2341,1,0,0,1
1080,1860,5774,1242,618,382,510,323,645,402,447,773,238,1075,785,422,494,595,349,301,1020,1968,1581,904,11,0,0,11
1081,1448,4830,1113,335,303,375,220,550,238,416,375,419,971,477,253,420,456,319,227,904,1517,1293,889,19,0,0,19
1082,1922,5532,1193,729,399,567,355,601,320,834,576,192,1301,621,490,472,623,337,245,953,1896,1483,955,33,0,0,33
1083,5877,16465,4173,1704,1259,1695,1113,1810,897,2320,1950,710,4025,1852,1396,1370,1393,1718,840,2738,5605,4721,2561,17,0,0,17
1084,2174,5921,1857,317,465,803,337,569,470,639,805,260,1633,541,240,654,572,708,245,855,1668,1645,1508,26,0,0,26
1085,1457,4555,1167,290,243,466,261,487,382,329,400,346,1044,413,288,311,435,423,201,612,1337,1286,1119,9,0,0,9
1086,2374,7107,1845,529,427,720,410,817,341,798,843,392,1584,790,404,571,627,772,324,1202,2218,1878,1485,18,0,0,18
1087,2183,5880,1816,367,420,764,375,624,464,636,671,412,1579,604,437,364,528,854,259,842,1657,1802,1320,4,1,0,3
1088,1236,4039,985,251,180,388,206,462,209,531,235,261,803,433,224,308,338,366,190,680,1257,1101,811,14,0,0,14
1089,2097,6101,1067,1030,536,556,428,577,441,795,744,117,1368,729,904,520,448,225,347,1290,2090,1518,856,163,0,0,163
1090,1521,3202,795,726,567,532,212,210,433,522,441,125,1258,263,401,460,336,324,127,370,1054,974,677,0,0,0,0
1091,1492,3358,782,710,515,500,214,263,316,738,327,111,1128,364,432,385,273,402,172,488,1120,940,638,0,0,0,0
1092,510,1031,84,426,248,138,58,66,201,239,70,0,412,98,262,165,62,21,25,94,512,281,119,103,0,0,103
1093,1028,2078,399,629,435,299,140,154,257,454,306,11,755,273,444,216,226,142,94,267,727,655,335,11,0,0,11
1094,3285,8340,1987,1298,875,1003,593,814,411,1188,1505,181,1983,1302,550,822,1085,828,457,1463,2917,2306,1197,11,0,0,11
1095,1213,3626,843,370,228,331,259,395,173,477,443,120,903,310,186,433,347,247,203,744,1226,959,494,18,0,0,18
1096,3784,9848,2779,1005,860,1234,684,1006,649,1337,1484,314,2508,1276,505,1026,941,1312,581,1778,3291,2842,1356,29,0,0,29
1097,1209,3425,985,224,235,378,233,363,206,337,396,270,812,397,162,523,233,291,167,540,1179,1067,472,24,0,0,24
1098,3671,12879,2563,1108,421,872,756,1622,392,1198,1214,867,1976,1695,428,714,1314,1215,786,2453,4832,3469,1339,0,0,0,0
1099,3020,8297,2190,830,542,1069,584,825,658,1055,884,423,2134,886,538,792,912,778,390,1412,2545,2424,1526,29,0,0,29
1100,3084,8014,2600,484,669,1070,526,819,752,1090,1013,229,2067,1017,427,618,823,1216,357,1449,1920,2573,1715,16,0,0,16
1101,1445,4048,1329,116,218,534,221,472,370,412,521,142,962,483,184,260,418,583,197,791,926,1239,895,0,0,0,0
1102,382,952,333,49,69,134,84,95,98,109,138,37,254,128,68,82,91,141,41,160,187,339,225,0,0,0,0
1103,2813,7932,2371,442,448,951,546,868,612,755,1004,442,1915,898,540,513,739,1021,371,1483,2171,2425,1482,9,0,0,9
1104,1277,3707,1064,213,178,448,236,415,221,482,454,120,797,480,186,135,359,597,168,759,989,1021,770,0,0,0,0
1105,437,1173,343,94,85,157,81,114,76,165,155,41,273,164,68,81,199,89,55,172,380,346,220,0,0,0,0
1106,3289,8016,1679,1610,986,1015,551,737,859,1292,1000,138,2602,687,996,577,997,719,430,1271,2694,2093,1528,147,0,0,147
1107,1491,3803,832,659,393,467,290,341,337,507,457,190,1140,351,405,363,413,310,236,555,1332,954,726,14,0,0,14
1108,2183,5955,1678,505,478,746,405,554,407,725,826,225,1502,681,234,681,562,706,304,959,1760,1719,1213,39,0,0,39
1109,2806,7691,2094,712,545,972,544,745,416,856,1253,281,1790,1016,465,702,814,825,431,1263,2513,2089,1395,21,0,0,21
1110,2719,7225,1617,1102,668,902,451,698,608,1000,847,264,2103,616,915,509,608,687,387,1204,2521,1928,1185,36,0,0,36
1111,2047,5761,1486,561,423,707,388,529,397,536,784,330,1407,640,369,463,777,438,382,875,2088,1568,848,16,0,0,16
1112,2227,6423,1443,784,478,723,414,612,454,524,938,311,1561,666,558,545,515,609,354,963,2346,1769,991,90,0,0,90
1113,1363,2306,66,1297,761,393,100,109,509,487,324,43,1276,87,675,356,293,39,82,128,958,512,626,28,0,0,28
1114,2582,7452,474,2108,596,675,484,827,330,1228,831,193,1483,1099,935,908,593,146,569,1627,3320,1478,458,0,0,0,0
1115,1574,4808,247,1327,320,395,282,577,195,550,551,278,1026,548,499,557,311,207,341,1120,2087,930,330,0,0,0,0
1116,1237,3463,849,388,253,438,218,328,183,380,494,180,803,434,224,246,305,462,205,512,1229,985,532,37,0,0,37
1117,1216,3241,892,324,220,487,183,326,258,331,395,232,874,342,207,321,216,472,150,480,967,957,687,17,0,0,17
1118,3068,7406,1899,1169,860,1037,514,657,472,1406,881,309,2174,894,1069,805,633,561,404,1084,2461,2019,1438,18,0,0,18
1119,3134,8642,1879,1255,654,1012,592,876,554,1336,690,554,2069,1065,647,1124,661,702,521,1500,3025,2256,1340,15,0,0,15
1120,2897,9834,1047,1850,515,685,494,1203,494,1163,774,466,1897,1000,1025,862,694,316,702,2241,4088,1971,832,32,0,0,32
1121,5563,11330,1426,4137,2241,1830,704,788,825,2988,1462,288,4565,998,1335,1480,1271,1477,666,1272,4925,2533,1934,42,0,0,42
1122,2876,7672,1932,944,883,836,440,717,585,939,1015,337,2067,809,746,1044,655,431,413,1250,2695,1985,1329,159,0,0,159
1123,2288,5589,1081,1207,677,750,389,472,471,781,799,237,1484,804,544,563,737,444,263,927,2193,1456,750,38,0,0,38
1124,2513,6335,1880,633,652,839,492,530,392,884,963,274,1580,933,298,536,800,879,332,985,1861,1769,1388,0,0,0,0
1125,1898,4862,1526,372,410,727,267,494,487,535,678,198,1311,587,256,363,427,852,249,851,1314,1351,1097,0,0,0,0
1126,2781,6921,2421,360,629,1044,504,604,592,1180,878,131,2103,678,537,574,720,950,318,1029,1768,2129,1677,10,0,0,10
1127,2549,6523,1821,728,572,866,458,653,537,911,755,346,1673,876,586,345,498,1120,338,1116,1853,1861,1355,17,0,0,17
1128,1717,4605,1367,350,360,542,335,480,234,607,793,83,1061,656,199,398,577,543,351,813,1439,1239,763,56,0,0,56
1129,2162,5559,1548,614,542,702,358,560,521,628,758,255,1529,633,360,360,756,686,344,906,1611,1513,1185,97,0,0,97
1130,1352,3492,1137,215,284,459,254,355,379,452,388,133,879,473,273,234,351,494,221,574,867,991,839,6,0,0,6
1131,2218,6090,1941,277,339,831,381,667,438,658,782,340,1316,902,185,213,305,1515,257,1192,1265,1877,1499,1,0,0,1
1132,1644,4817,1474,170,221,589,257,577,361,447,712,124,914,730,157,154,176,1157,208,1167,913,1444,1085,21,0,0,21
1133,3042,7699,2383,659,690,1072,611,669,796,1056,977,213,2157,885,649,464,567,1362,429,1261,2082,2210,1717,52,0,0,52
1134,2463,6259,1341,1122,638,815,464,546,354,1025,909,175,1690,773,605,493,428,937,432,1046,2217,1529,1035,32,0,0,32
1135,2893,6269,1686,1207,995,1010,403,485,529,1127,1024,213,2280,613,560,530,865,938,361,875,2292,1571,1170,10,0,0,10
1136,2584,5344,1054,1530,939,925,361,359,361,1054,1027,142,2152,432,363,436,934,851,287,623,2575,1200,659,12,0,0,12
1137,1422,3764,1205,217,284,543,279,316,287,560,444,131,1009,413,159,191,293,779,207,563,996,1011,987,85,0,0,85
1138,2274,6134,1731,543,397,835,446,596,583,851,723,117,1630,644,393,404,453,1024,331,1070,1661,1788,1284,2,0,0,2
1139,1211,3464,1114,97,150,454,228,379,294,400,452,65,722,489,89,145,181,796,152,689,698,1107,818,3,0,0,3
1140,1047,3051,975,72,157,376,185,329,217,367,364,99,736,311,56,141,210,640,137,623,555,894,842,74,0,0,74
1141,2151,5981,1844,307,356,774,387,634,452,701,903,95,1575,576,245,336,427,1143,316,1154,1351,1768,1392,7,0,0,7
1142,1514,4045,1257,257,254,560,270,430,331,506,533,144,1045,469,138,318,380,678,186,746,934,1240,939,0,0,0,0
1143,1981,4492,1278,703,643,699,261,378,367,714,796,104,1330,651,460,204,470,847,211,707,1173,1157,1244,0,0,0,0
1144,2126,5059,1142,984,617,745,330,434,413,755,691,267,1533,593,258,382,548,938,256,835,1628,1399,941,10,0,0,10
1145,4120,7663,922,3198,1817,1475,422,406,685,2102,1123,210,3533,587,836,915,1118,1251,355,736,3903,1605,1064,60,0,0,60
1146,1919,3603,140,1779,907,599,186,227,143,1244,496,36,1655,264,403,749,547,220,150,429,1952,714,358,11,0,0,11
1147,2262,5780,1722,540,616,702,378,566,774,614,690,184,1528,734,399,345,457,1061,258,1087,1157,1623,1655,0,0,0,0
1148,6213,8652,5841,372,3921,2040,139,113,5180,855,178,0,6203,10,2319,1958,1209,727,32,83,115,843,7579,6,0,0,6
1149,2105,5355,1463,642,537,722,320,526,397,981,593,134,1490,615,323,477,451,854,262,942,1504,1571,1076,135,0,0,135
1150,2112,5187,1195,917,569,676,331,536,575,874,536,127,1432,680,573,325,438,776,260,1098,1328,1428,1073,1,0,0,1
1151,2040,5937,1897,143,264,670,357,749,363,548,1122,7,1188,852,181,215,369,1275,274,1379,1220,1808,1256,0,0,0,0
1152,2547,6181,1381,1166,633,899,369,646,336,1002,1113,96,1750,797,204,479,428,1436,306,1193,1834,1707,1141,0,0,0,0
1153,1473,4237,1367,106,193,509,246,525,275,535,635,28,865,608,70,189,243,971,227,964,862,1218,966,0,0,0,0
1154,2691,7165,2293,398,544,941,405,801,834,889,872,96,1987,704,405,119,366,1801,301,1517,1276,2058,2013,4,0,0,4
1155,746,2001,650,96,125,262,124,235,123,322,291,10,381,365,87,96,118,445,100,404,432,611,454,0,0,0,0
1156,1472,4354,1302,170,184,468,286,534,293,339,656,184,800,672,133,170,282,887,274,963,1056,1248,813,0,0,0,0
1157,1013,2559,809,204,237,320,161,295,301,286,298,128,709,304,186,137,217,473,119,527,531,751,631,0,0,0,0
1158,2327,6219,1665,662,446,751,429,701,416,974,759,178,1568,759,494,367,386,1080,282,1357,1540,1827,1213,0,0,0,0
1159,880,3344,794,86,121,310,140,309,243,288,294,55,579,301,84,106,149,541,118,1037,892,722,575,911,895,0,16
1160,1839,5724,1661,178,267,620,316,636,410,552,802,75,1043,796,148,216,295,1180,204,1371,1343,1668,1138,535,524,0,11
1161,4468,11675,3384,1084,1022,1545,686,1215,852,1685,1471,460,2938,1530,784,626,697,2361,484,2419,2607,3770,2395,10,0,0,10
1162,467,1141,342,125,111,163,88,105,159,127,143,38,315,152,78,143,81,165,50,215,242,361,273,0,0,0,0
1163,1315,3555,1180,135,212,514,210,379,387,395,424,109,898,417,104,219,250,742,169,695,736,1047,908,0,0,0,0
1164,1964,5748,1822,142,243,728,342,651,362,642,750,210,1426,538,141,68,180,1575,202,1223,1033,1876,1414,50,0,0,50
1165,2670,7673,2483,187,344,987,452,887,865,696,911,198,1796,874,388,298,365,1619,309,1682,1500,2426,1756,42,0,0,42
1166,3959,11284,3557,402,559,1359,742,1299,835,1335,1516,273,2409,1550,249,373,840,2497,442,2617,2265,3671,2289,22,0,0,22
1167,4116,11168,3629,487,707,1498,637,1274,935,1607,1324,250,2511,1605,623,536,735,2222,446,2454,2180,3469,2619,16,0,0,16
1168,3433,8271,2440,993,970,1050,607,806,581,1573,1108,171,2327,1106,513,600,723,1597,360,1645,2323,2673,1270,0,0,0,0
1169,2202,6473,1799,403,348,666,410,778,360,840,834,168,1271,931,171,250,675,1106,294,1567,1605,1928,1079,28,0,0,28
1170,3157,8164,1812,1345,705,972,607,873,348,1502,1047,260,1894,1263,245,591,999,1322,495,1616,2862,2269,922,0,0,0,0
1171,3015,9290,2446,569,322,907,587,1199,526,772,1477,240,1603,1412,361,351,514,1789,347,2232,2227,3038,1446,16,0,0,16
1172,2127,6255,1568,559,349,643,371,764,317,597,964,249,1133,994,263,341,441,1082,345,1394,1929,1757,830,13,0,0,13
1173,1436,4441,1233,203,177,400,316,543,140,499,617,180,730,706,168,160,348,760,192,1099,1178,1327,645,13,0,0,13
1174,1879,5112,1455,424,387,572,351,569,519,429,668,263,1258,621,312,228,298,1041,178,1070,1163,1584,1117,11,0,0,11
1175,5545,16250,3105,2440,917,1391,1190,2047,672,2516,1987,370,2807,2738,765,964,1185,2631,930,4056,5358,4287,1619,0,0,0,0
1176,15155,48906,11694,3461,1624,3496,3163,6872,1791,5746,6315,1303,7406,7749,1621,1727,2736,9071,1919,13768,12205,15491,5523,140,0,0,140
1177,6538,17733,5453,1085,1138,2651,1015,1734,1536,2323,1972,707,4353,2185,985,1303,1692,2558,817,3363,4343,5265,3945,0,0,0,0
1178,14843,45721,11570,3273,2472,4164,2518,5689,2914,5193,4407,2329,8704,6139,2247,3734,3865,4997,2349,10575,13009,12446,7342,147,0,0,147
1179,8262,27244,5722,2540,1084,2110,1499,3569,1132,3360,2509,1261,3882,4380,1599,1957,2290,2416,1729,6739,8926,6722,3128,67,0,0,67
1180,5171,18187,4018,1153,552,1224,994,2401,755,1900,1966,550,2837,2334,1151,1066,1648,1306,1231,4476,6494,4280,1706,15,0,0,15
1181,2034,5516,1590,444,508,631,310,585,453,861,569,151,1437,597,441,603,507,483,314,1039,1730,1534,899,23,0,0,23
1182,3771,11124,2436,1335,845,963,689,1274,619,1099,1118,935,2205,1566,1083,862,976,850,688,2373,3765,2835,1463,51,0,0,51
1183,1179,3678,909,270,192,321,236,430,251,625,183,120,772,407,315,380,307,177,224,731,1211,946,566,16,0,0,16
1184,1564,5289,1219,345,169,457,289,649,221,530,646,167,983,581,295,373,446,450,230,1011,1777,1595,676,18,0,0,18
1185,5644,19197,4540,1104,637,1535,1066,2406,692,1657,2480,815,3215,2429,823,1168,1984,1669,1084,4158,6288,5429,2238,45,0,0,45
1186,5514,18763,3919,1595,766,1362,1084,2302,813,2182,1510,1009,3511,2003,1315,1467,1416,1316,974,3872,6090,5267,2560,21,0,0,21
1187,2542,7821,1709,833,498,755,450,839,711,1101,388,342,1552,990,511,1022,645,364,452,1568,2512,2027,1262,0,0,0,0
1188,2966,9161,1516,1450,632,771,511,1052,856,1007,627,476,1879,1087,1199,889,533,345,633,2027,3203,2102,1196,30,0,0,30
1189,2422,7014,687,1735,558,601,455,808,452,1178,581,211,1450,972,1185,701,279,257,505,1519,2617,1618,755,58,0,0,58
1190,1559,4355,257,1302,367,435,292,465,330,692,384,153,782,777,840,470,192,57,354,1094,1691,912,304,8,0,0,8
1191,1809,5874,831,978,311,449,345,704,377,561,583,288,1131,678,727,597,323,162,445,1424,2063,1301,641,0,0,0,0
1192,1339,4526,966,373,197,386,237,519,252,390,538,159,916,423,205,535,388,211,249,917,1556,1150,654,15,0,0,15
1193,2641,7474,1131,1510,610,730,518,783,389,1000,1002,250,1714,927,818,1099,388,336,504,1534,2739,1752,945,29,0,0,29
1194,1638,4503,973,665,460,444,270,464,470,485,376,307,1150,488,668,349,406,215,210,835,1353,1163,942,0,0,0,0
1195,5167,18247,4093,1074,594,1407,931,2235,640,1834,1609,1084,3456,1711,1142,1104,1231,1690,876,3857,5641,5276,2597,122,0,0,122
1196,2778,8950,1766,1012,455,789,506,1028,357,891,926,604,1706,1072,336,652,1033,757,489,1665,3141,2330,1325,22,0,0,22
1197,1123,3794,478,645,171,257,239,456,109,503,314,197,562,561,508,255,180,180,278,992,1342,776,406,10,0,0,10
1198,1502,4485,666,836,318,465,276,443,264,678,369,191,948,554,381,523,382,216,263,844,1591,1179,608,211,0,0,211
1199,3263,9244,1294,1969,873,805,537,1048,570,1036,1520,137,2177,1086,1049,1206,795,213,630,1960,3218,1980,1456,21,0,0,21
1200,2835,9058,1819,1016,450,866,507,1012,370,1168,882,415,1725,1110,490,931,931,483,526,1746,3115,2398,1273,42,0,0,42
1201,1239,4626,904,335,120,293,261,565,187,394,401,257,663,576,223,415,431,170,306,1011,1673,1086,550,7,0,0,7
1202,977,3538,433,544,118,198,201,460,160,299,307,211,512,465,400,301,250,26,236,889,1302,756,355,9,0,0,9
1203,1591,5668,771,820,244,332,283,732,282,512,515,282,903,688,617,414,251,309,379,1352,2107,1269,561,22,0,0,22
1204,935,2936,389,546,214,213,142,366,306,259,228,142,609,326,494,187,192,62,186,636,1059,673,382,0,0,0,0
1205,1367,3699,799,568,393,396,196,382,390,470,407,100,1001,366,464,490,258,155,198,664,1224,1022,591,1,0,0,1
1206,1795,6106,838,957,310,393,329,763,422,580,454,339,1148,647,750,419,346,280,440,1431,2254,1439,542,8,0,0,8
1207,1784,6418,1290,494,238,420,289,837,149,701,460,474,1094,690,286,770,505,223,376,1473,2254,1576,739,0,0,0,0
1208,2497,8266,1132,1365,497,591,428,981,387,1000,609,501,1486,1011,890,763,472,372,566,2051,3077,1831,741,18,0,0,18
1209,1680,5907,690,990,262,373,332,713,188,618,574,300,871,809,508,721,325,126,393,1439,2272,1278,525,22,0,0,22
1210,1813,7168,1176,637,186,363,313,951,217,635,728,233,840,973,695,559,354,205,421,1817,2698,1627,605,3,0,0,3
1211,1642,3992,1002,640,433,540,276,393,374,645,566,57,1201,441,427,428,373,414,225,711,1230,1155,671,6,0,0,6
1212,2105,4361,1282,823,815,787,219,284,560,989,457,99,1788,317,738,450,579,338,142,589,1039,1291,1300,0,0,0,0
1213,1097,2669,774,323,266,394,180,257,192,477,388,40,845,252,190,148,312,447,85,449,722,783,630,17,0,0,17
1214,1472,3700,1025,447,340,527,235,370,348,536,431,157,1042,430,405,251,325,491,185,693,1030,993,799,15,0,0,15
1215,1911,4790,1214,697,485,632,313,481,402,851,509,149,1240,671,395,502,404,610,207,878,1374,1353,978,1,0,0,1
1216,1261,3079,1007,254,319,444,178,320,211,553,372,125,963,298,180,294,422,365,131,490,815,908,735,0,0,0,0
1217,1792,5560,1623,169,151,635,339,667,258,557,795,182,980,812,217,315,464,796,253,1142,1450,1776,939,0,0,0,0
1218,2108,5755,1174,934,462,680,422,544,397,640,812,259,1308,800,507,618,538,445,304,869,2013,1438,1131,11,0,0,11
1219,1156,3254,852,304,230,429,188,309,251,555,282,68,869,287,273,325,247,311,135,508,950,938,723,35,0,0,35
1220,2988,7860,2260,728,728,1021,524,715,625,1037,1009,317,2333,655,644,695,855,794,314,1043,2348,2433,1722,0,0,0,0
1221,1533,4833,937,596,311,432,299,491,237,581,423,292,896,637,466,483,348,236,283,987,1732,1172,659,0,0,0,0
1222,1263,3744,507,756,392,405,184,282,232,626,303,102,1023,240,290,417,391,165,168,757,1581,759,479,629,626,0,3
1223,1138,3482,640,498,296,233,209,400,124,717,264,33,729,409,560,338,203,37,219,723,1203,902,435,20,0,0,20
1224,1513,2925,141,1372,809,364,144,196,627,690,167,29,1238,275,1091,292,91,39,181,441,939,684,680,107,0,0,107
1225,1169,2703,332,837,423,332,192,222,181,776,190,22,792,377,597,300,145,127,165,444,996,723,375,0,0,0,0
1226,1157,3490,498,659,277,303,195,382,333,307,315,202,908,249,419,470,202,66,232,692,1343,822,401,8,0,0,8
1227,1241,3372,692,549,313,391,197,340,184,621,329,107,825,416,367,491,342,41,206,588,1190,882,506,5,0,0,5
1228,755,2215,472,283,169,236,112,238,108,252,318,77,462,293,186,210,194,165,122,391,711,633,358,35,0,0,35
1229,1488,4235,781,707,315,445,252,476,242,525,537,184,929,559,464,519,321,184,276,851,1450,972,686,9,0,0,9
1230,2440,7045,1498,942,591,725,420,704,651,789,583,417,1889,551,722,608,661,449,328,1218,2096,1873,1530,37,0,0,37
1231,1165,3496,691,474,255,349,180,381,211,498,308,148,820,345,294,580,203,88,197,643,1208,884,564,26,0,0,26
1232,1178,3639,515,663,270,325,216,367,217,499,260,202,853,325,465,409,181,123,201,735,1292,943,468,90,0,0,90
1233,1238,3168,874,364,302,439,189,308,233,490,470,45,873,365,243,468,320,207,169,488,963,916,632,0,0,0,0
1234,1479,4031,457,1022,445,403,219,412,344,744,242,149,1005,474,750,409,185,135,258,810,1558,974,431,28,0,0,28
1235,1134,2722,290,844,401,346,137,250,275,684,160,15,794,340,600,343,127,64,164,488,980,751,339,10,0,0,10
1236,1515,3772,515,1000,479,473,213,350,273,762,421,59,1151,364,602,539,317,57,252,679,1389,953,499,28,0,0,28
1237,1012,2819,592,420,231,287,178,316,136,314,420,142,648,364,310,345,268,89,167,560,1026,749,317,0,0,0,0
1238,343,1172,225,118,37,130,75,101,63,170,82,28,278,65,21,100,132,90,61,177,495,287,152,177,176,0,1
1239,1000,3529,720,280,103,235,249,413,84,238,551,127,741,259,56,349,338,257,141,548,1153,972,715,25,0,0,25
1240,1394,5310,946,448,203,303,242,646,210,671,264,249,914,480,261,611,359,163,335,1055,1786,1339,795,119,0,0,119
1241,1250,3121,415,835,493,344,125,288,341,579,303,27,924,326,822,240,102,86,143,550,912,790,726,181,0,0,181
1242,2213,6010,1288,925,533,727,389,564,454,841,688,230,1671,542,574,722,463,454,326,1042,1918,1619,1105,13,0,0,13
1243,1777,5015,873,904,473,467,342,495,572,543,494,168,1229,548,661,569,352,195,281,905,1646,1232,951,70,0,0,70
1244,1685,6135,1125,560,262,409,332,682,323,489,613,260,1030,655,409,650,418,208,345,1277,2026,1549,938,68,0,0,68
1245,1642,5906,1160,482,238,375,344,685,328,621,513,180,902,740,495,502,370,275,325,1195,2035,1467,884,14,0,0,14
1246,3531,10908,2581,950,522,1155,677,1177,635,1369,1165,362,2342,1189,592,777,1160,1002,450,1668,3366,3246,2178,51,0,0,51
1247,4135,13577,3538,597,451,1129,796,1759,445,1194,1901,595,2529,1606,533,924,1158,1520,814,2802,4475,3812,1674,50,0,0,50
1248,3541,10231,2984,557,657,1099,603,1182,587,969,1707,278,1935,1606,387,719,1088,1347,518,2104,2798,2974,1837,0,0,0,0
1249,2137,6084,1312,825,420,676,336,705,312,583,941,301,1410,727,335,552,766,484,344,1153,2117,1578,892,15,0,0,15
1250,1730,5419,818,912,337,455,336,602,290,857,487,96,924,806,587,690,315,138,363,1127,2013,1358,558,47,0,0,47
1251,2348,7028,1554,794,419,664,461,804,529,1165,504,150,1630,718,963,665,366,354,397,1340,2330,1922,1039,21,0,0,21
1252,838,3750,17,821,21,215,198,404,0,467,367,4,258,580,153,464,173,48,493,920,2199,128,10,917,0,917,0
1253,1283,4182,1037,246,163,359,229,532,95,384,498,306,694,589,214,338,456,275,238,848,1478,1102,516,0,0,0,0
1254,1865,6137,1440,425,230,521,409,705,188,650,724,303,1231,634,242,704,594,325,334,1218,2085,1548,952,9,0,0,9
1255,1751,5325,889,862,365,489,278,619,305,641,574,231,1137,614,546,492,469,244,329,1022,2015,1268,691,0,0,0,0
1256,1690,5044,1166,524,359,422,349,560,408,594,422,266,1315,375,668,461,415,146,277,990,1671,1238,868,0,0,0,0
1257,2228,6876,1183,1045,459,608,402,759,457,779,608,384,1390,838,596,957,560,115,420,1482,2445,1618,911,0,0,0,0
1258,1293,4190,548,745,226,343,234,490,159,606,430,98,752,541,397,585,219,92,273,1047,1508,947,415,0,0,0,0
1259,1765,5423,699,1066,403,441,287,634,420,603,475,267,1050,715,786,569,293,117,402,1267,2040,1074,640,18,0,0,18
1260,1130,3758,398,732,165,259,253,453,171,684,236,39,550,580,511,461,121,37,309,938,1451,751,309,3,0,0,3
1261,1310,4263,921,389,195,354,289,472,315,339,487,169,871,439,362,433,318,197,253,878,1593,1030,509,21,0,0,21
1262,669,1844,134,535,188,181,90,210,94,322,200,53,451,218,225,317,93,34,126,385,724,414,195,38,0,0,38
1263,969,2866,361,608,272,191,171,335,215,343,335,76,584,385,443,354,143,29,165,587,982,694,438,22,0,0,22
1264,1936,5985,660,1276,367,542,360,667,239,953,537,207,1038,898,779,619,375,163,482,1379,2292,1282,550,0,0,0,0
1265,1221,3530,494,727,269,379,210,363,89,532,352,248,688,533,300,372,388,161,254,747,1268,802,459,35,21,0,14
1266,1450,4826,779,671,251,369,262,568,312,520,339,279,783,667,466,561,341,82,276,1116,1786,1114,534,4,0,0,4
1267,1277,3523,953,324,288,407,188,394,315,423,305,234,966,311,249,357,417,254,175,626,1021,911,790,0,0,0,0
1268,4244,11133,2958,1286,928,1568,662,1086,994,1298,1523,429,3077,1167,712,1016,1099,1417,453,1754,3062,3470,2394,19,0,0,19
1269,3913,10538,2248,1665,1049,1197,661,1006,1214,1387,786,526,3049,864,1100,1203,880,730,546,1761,3263,2666,2302,48,0,0,48
1270,6065,19962,4662,1403,763,1744,1232,2326,1000,1842,1940,1283,3540,2525,900,1391,2006,1768,1150,4189,6873,5193,2557,11,0,0,11
1271,5381,16533,4263,1118,723,1636,1036,1986,627,2078,2101,575,3111,2270,698,1347,1718,1618,1019,3631,5526,4424,1933,16,0,0,16
1272,4,22,3,1,0,1,2,1,4,0,0,0,0,4,4,0,0,0,0,0,11,8,3,0,0,0,0
1273,1585,4353,958,627,361,475,321,428,329,774,325,157,1184,401,571,524,258,232,218,821,1457,1210,647,18,0,0,18
1274,2375,5999,1083,1292,696,757,392,530,557,673,833,312,1704,671,734,907,505,229,378,1066,2192,1419,944,0,0,0,0
1275,1293,3427,626,667,318,390,252,333,238,575,368,112,951,342,320,508,304,161,211,650,1425,751,390,0,0,0,0
1276,1292,3825,649,643,234,442,222,394,140,533,456,163,820,472,201,507,441,143,224,810,1517,842,432,0,0,0,0
1277,2043,6011,1474,569,359,623,424,637,386,631,856,170,1268,775,284,613,731,415,391,1217,1970,1557,876,10,0,0,10
1278,1469,4381,1231,238,191,481,304,493,292,254,557,366,891,578,164,388,459,458,348,842,1599,1075,517,0,0,0,0
1279,3270,9205,2121,1149,651,1137,523,959,556,1179,1244,291,2140,1130,540,937,961,832,562,1625,3398,2308,1312,25,0,0,25
1280,4832,10599,3168,1664,1834,1620,511,867,1451,1848,815,718,3976,856,1209,1289,1259,1075,404,1460,2480,2738,3517,0,0,0,0
1281,2488,6489,935,1553,615,815,428,630,299,925,1070,194,1659,829,486,1044,664,294,448,1218,2901,1287,635,0,0,0,0
1282,4734,14286,3125,1609,686,1461,949,1638,687,1737,1852,458,2945,1789,1077,1084,1220,1353,869,3300,4471,3919,1727,75,0,0,75
1283,1573,4121,933,640,380,484,285,424,290,750,433,100,997,576,534,494,385,160,238,892,1400,979,612,0,0,0,0
1284,2082,5302,1272,810,532,705,332,513,596,563,585,338,1594,488,489,549,550,494,259,998,1777,1345,923,23,0,0,23
1285,1845,4821,1617,228,341,711,307,486,418,816,424,187,1239,606,269,425,496,655,230,859,1196,1346,1190,0,0,0,0
1286,1701,4619,1391,310,275,700,320,406,496,485,594,126,1371,330,251,520,384,546,148,698,1095,1496,1182,6,0,0,6
1287,331,942,164,167,64,115,49,103,90,112,86,43,245,86,76,122,43,90,46,156,274,285,181,1,0,0,1
1288,3801,11306,2725,1076,546,1156,773,1326,520,1380,1068,833,2077,1724,834,1337,1156,474,618,2352,3642,3033,1661,4,0,0,4
1289,2879,8606,1680,1199,613,730,491,1045,365,1161,1010,343,1703,1176,823,906,580,570,588,1880,2991,2040,1107,0,0,0,0
1290,5287,11177,4158,1129,1643,2384,522,738,2669,1818,560,240,4859,428,1751,1841,1134,561,416,1174,2189,2678,4720,6,0,0,6
1291,3543,12283,2598,945,507,788,635,1613,456,1037,1270,780,1916,1627,629,917,916,1081,527,2895,3851,3369,1641,14,0,0,14
1292,2986,10577,2300,686,355,754,518,1359,410,767,1174,635,1718,1268,614,703,870,799,503,2266,3306,2965,1537,68,0,0,68
1293,2186,5553,1118,1068,594,770,342,480,426,882,557,321,1369,817,576,554,542,514,274,948,1829,1311,1191,25,0,0,25
1294,24,67,3,21,12,3,4,5,3,21,0,0,18,6,24,0,0,0,5,16,13,33,0,22,0,0,22
1295,2938,8323,1671,1267,664,956,493,825,502,1206,905,325,1967,971,794,854,748,542,436,1648,2920,2168,1151,104,0,0,104
1296,1575,3579,979,596,433,684,226,232,457,707,379,32,1297,278,330,335,324,586,151,494,1031,1034,869,16,0,0,16
1297,3413,8999,1363,2050,989,1025,546,853,429,1275,1312,397,2265,1148,977,1047,869,520,482,1710,3273,2074,1460,28,0,0,28
1298,679,2588,188,491,235,214,104,126,58,253,316,52,544,135,110,206,199,164,63,300,1088,913,224,990,0,0,990
1299,1078,2283,293,785,479,327,112,160,272,545,209,52,855,223,433,337,200,108,97,285,953,546,402,57,0,0,57
1300,829,2312,398,431,242,232,115,240,154,369,237,69,539,290,303,257,150,119,129,431,841,602,309,52,0,0,52
1301,1275,3257,584,691,382,404,186,303,178,573,468,56,865,410,328,490,217,240,156,614,1116,898,473,20,0,0,20
1302,2443,7584,1318,1125,458,658,400,927,405,833,901,304,1455,988,475,794,600,574,482,1684,2644,1805,969,23,0,0,23
1303,1215,3078,1075,140,245,487,185,298,356,404,302,153,847,368,166,212,440,397,129,495,638,935,881,0,0,0,0
1304,2740,7359,1440,1300,776,820,394,750,675,938,682,445,1979,761,994,743,612,391,388,1383,2331,1840,1417,0,0,0,0
1305,1727,5121,816,911,353,498,295,581,191,568,769,199,968,759,396,627,485,219,258,1106,1877,1342,538,9,0,0,9
1306,4971,12937,3511,1460,1300,1668,771,1232,1423,1486,1479,583,3692,1279,1332,1229,1063,1347,547,2198,3565,3552,3075,25,0,0,25
1307,2763,7065,1896,867,712,1011,390,650,716,824,959,264,2038,725,623,521,815,804,307,1160,1919,2039,1640,44,34,0,10
1308,1548,3921,1282,266,293,670,210,375,455,543,364,186,1250,298,246,384,443,475,174,591,842,1231,1083,34,0,0,34
1309,155,294,128,27,63,60,17,15,61,42,47,5,122,33,68,32,29,26,7,27,38,75,147,0,0,0,0
1310,1063,2407,679,384,460,415,73,115,407,462,168,26,950,113,407,288,177,191,36,107,261,408,1595,463,0,0,463
1311,2611,6329,2149,462,570,1164,379,498,850,747,827,187,2236,375,429,445,674,1063,190,809,1273,1937,2120,105,0,0,105
1312,753,1849,567,186,200,278,124,151,144,370,205,34,586,167,251,211,201,90,84,297,534,590,344,39,4,0,35
1313,1678,4835,942,736,446,658,234,340,255,787,578,58,1236,442,400,331,548,399,149,844,1586,1163,1093,673,560,0,113
1314,2337,5430,1283,1054,760,775,256,546,529,1228,494,86,1750,587,560,440,450,887,185,985,1330,1474,1456,45,21,0,24
1315,801,1946,504,297,195,360,79,167,207,286,234,74,622,179,202,151,175,273,60,254,457,528,647,20,0,0,20
1316,275,651,183,92,72,120,26,57,41,99,93,42,230,45,45,57,76,97,16,73,154,199,209,42,0,0,42
1317,2225,5507,1236,989,672,722,251,580,406,1103,476,240,1751,474,665,584,514,462,256,968,1508,1431,1344,37,0,0,37
1318,2035,4689,1427,608,594,805,269,367,471,1062,413,89,1800,235,320,309,477,929,157,590,1107,1317,1518,53,0,0,53
1319,3432,9371,1817,1615,880,1123,477,952,642,1212,817,761,2262,1170,844,878,911,799,520,1939,2966,2416,1530,43,0,0,43
1320,2540,5416,1473,1067,908,913,318,401,657,1023,726,134,2176,364,632,761,472,675,205,693,1217,1548,1753,46,0,0,46
1321,2559,6667,1544,1015,681,933,367,578,742,1138,476,203,2178,381,746,756,584,473,297,1169,1896,1890,1415,16,0,0,16
1322,34,64,29,5,12,18,2,2,14,14,4,2,32,2,6,4,3,21,1,5,7,17,34,0,0,0,0
1323,3779,8047,2299,1480,1382,1362,418,617,1496,1270,905,108,3094,685,1063,1001,780,935,243,1114,1708,2161,2821,3,0,0,3
1324,1835,3662,1449,386,676,797,169,193,571,744,359,161,1662,173,599,404,327,505,86,365,514,942,1755,4,0,0,4
1325,3536,9108,2129,1407,781,1308,571,876,749,1086,1250,451,2434,1102,502,959,908,1167,411,1652,2764,2506,1775,12,0,0,12
1326,1971,5181,1628,343,352,721,363,535,394,740,710,127,1448,523,414,464,305,788,214,1003,1174,1581,1209,23,0,0,23
1327,1988,4682,1111,877,573,711,317,387,442,814,576,156,1477,511,553,500,429,506,203,757,1267,1351,1104,0,0,0,0
1328,1711,4866,1084,627,349,646,299,417,323,582,609,197,1083,628,350,427,330,604,220,811,1543,1268,1024,278,0,278,0
1329,1376,3359,889,487,347,536,189,304,249,674,352,101,967,409,445,252,269,410,109,488,841,1044,877,0,0,0,0
1330,1420,3406,987,433,359,511,242,308,344,575,279,222,1052,368,295,324,368,433,156,558,935,988,769,20,0,0,20
1331,2000,5104,911,1089,576,618,319,487,302,780,787,131,1311,689,507,549,622,322,266,1025,1812,1232,769,9,0,0,9
1332,2098,4744,856,1242,773,698,281,346,526,555,895,122,1565,533,490,596,489,523,183,671,1591,1351,948,151,0,0,151
1333,1507,4411,997,510,284,441,285,497,245,683,409,170,1093,414,239,665,401,202,225,915,1469,1115,687,32,0,0,32
1334,1538,4347,1224,314,266,528,293,451,308,484,434,312,1012,526,239,426,444,429,220,744,1263,1228,892,0,0,0,0
1335,2863,7200,1569,1294,905,837,429,692,957,869,732,305,2167,696,986,708,654,515,390,1088,2243,1785,1694,20,0,0,20
1336,5354,14101,3985,1369,1271,1746,883,1454,1418,1698,1725,513,3851,1503,1116,1379,1229,1630,632,2744,3728,4224,2773,4,0,0,4
1337,3163,7966,1695,1468,904,1052,460,747,865,1280,553,465,2516,647,1059,972,479,653,399,1304,2713,2178,1372,23,0,0,23
1338,1490,3651,855,635,438,490,233,329,254,645,438,153,1097,393,533,425,282,250,177,607,1290,991,586,7,0,0,7
1339,2062,5269,1204,858,514,676,312,560,336,1059,551,116,1574,488,519,590,671,282,250,884,1961,1322,852,3,0,0,3
1340,2461,6774,1442,1019,467,827,487,680,239,635,1353,234,1708,753,486,695,628,652,362,1165,2821,1696,730,11,0,0,11
1341,2363,6462,1660,703,493,794,468,608,513,916,799,135,1751,612,523,547,630,663,318,1057,2340,1652,1095,98,97,0,1
1342,1479,6858,764,715,324,489,286,380,215,466,602,196,1155,324,420,501,359,199,212,1401,3623,1086,536,2791,2776,0,15
1343,1576,4467,816,760,363,444,281,488,281,802,369,124,988,588,543,599,287,147,256,779,1800,1121,511,39,0,0,39
1344,2251,5533,628,1623,771,631,329,520,540,733,707,271,1635,616,793,837,480,141,350,1017,2232,1201,733,9,0,0,9
1345,1606,3795,907,699,485,506,278,337,338,554,529,185,1133,473,409,574,440,183,230,542,1380,884,759,0,0,0,0
1346,2054,4861,1152,902,625,750,257,422,447,378,1003,226,1529,525,485,509,558,502,185,705,1581,1144,1246,5,0,0,5
1347,1885,5218,1388,497,336,658,377,514,306,772,505,302,1316,569,320,483,598,484,259,889,1743,1441,886,30,0,0,30
1348,3678,10408,1380,2298,1026,912,608,1132,729,1279,1396,274,2481,1197,1666,1281,523,208,669,2345,3995,2280,1119,39,0,0,39
1349,2560,8222,1322,1238,492,692,458,918,366,975,874,345,1422,1138,620,1092,573,275,531,1885,3054,1967,785,102,0,0,102
1350,2982,6920,1640,1342,973,1035,412,562,592,1126,1093,171,2137,845,748,740,844,650,316,1064,2040,1868,1632,42,0,0,42
1351,1344,3623,1049,295,288,504,241,311,227,513,445,159,930,414,126,313,376,529,150,612,991,926,944,120,0,0,120
1352,1225,3054,1151,74,177,608,203,237,338,330,441,116,957,268,225,180,291,529,84,464,512,900,1094,20,0,0,20
1353,3713,6209,2861,852,1647,1734,154,178,2483,879,239,112,3581,132,1011,1062,818,822,42,212,379,1057,4519,0,0,0,0
1354,2914,7688,2444,470,556,1131,430,797,660,1283,760,211,2122,792,435,643,695,1141,273,1456,1661,2361,1937,36,0,0,36
1355,1484,3480,1032,452,418,533,261,272,426,590,316,152,1077,407,527,380,377,200,112,560,981,933,894,20,0,0,20
1356,2985,7121,1622,1363,994,915,450,626,931,919,981,154,2235,750,909,771,589,716,347,1301,2145,1637,1691,58,0,0,58
1357,1700,4361,833,867,431,576,269,424,289,633,573,205,1136,564,483,351,459,407,221,843,1526,1072,699,31,0,0,31
1358,3148,7428,1383,1765,983,1118,419,628,990,914,987,257,2457,691,964,915,897,372,345,1235,2250,1779,1819,53,0,0,53
1359,2137,5077,1413,724,582,827,358,370,278,923,844,92,1482,655,209,707,635,586,260,761,1581,1442,1033,24,0,0,24
1360,1363,2894,466,897,554,411,199,199,370,486,441,66,1009,354,566,390,263,144,115,417,1117,739,506,35,0,0,35
1361,1069,2108,129,940,534,324,94,117,155,601,204,109,841,228,421,441,135,72,115,323,972,470,228,27,0,0,27
1362,1842,3628,683,1159,800,617,198,227,521,883,357,81,1570,272,752,419,420,251,115,480,1168,883,982,8,0,0,8
1363,891,2134,370,521,259,293,144,195,145,314,304,128,697,194,229,313,224,125,84,257,884,659,250,5,0,0,5
1364,1710,3821,627,1083,549,606,269,286,225,688,671,126,1262,448,563,514,455,178,195,590,1509,976,551,20,0,0,20
1365,1754,4103,1386,368,482,667,277,328,582,703,354,115,1416,338,284,458,451,561,157,596,918,1158,1274,40,0,0,40
1366,3041,7267,2070,971,787,1280,408,566,1174,786,903,178,2400,641,572,612,709,1148,205,990,1469,2066,2537,259,0,0,259
1367,2001,5105,1423,578,539,698,310,454,747,533,642,79,1554,447,636,635,340,390,224,858,1417,1419,1187,56,0,0,56
1368,1896,4857,931,965,515,637,284,460,297,873,588,138,1272,624,461,504,514,417,228,989,1555,1319,766,40,0,0,40
1369,1620,4526,1233,387,317,533,311,459,344,527,564,185,1217,403,528,446,442,204,229,757,1531,1305,704,50,0,0,50
1370,3714,10142,2446,1268,826,1211,652,1025,682,1320,1214,498,2652,1062,942,640,1049,1083,565,1788,3386,2694,1709,37,0,0,37
1371,1954,5294,1232,722,436,622,358,538,279,595,658,422,1299,655,285,530,714,425,260,961,1853,1382,838,19,0,0,19
1372,1554,5257,730,824,270,373,280,631,297,486,529,242,930,624,422,460,514,158,329,1208,1919,1180,621,48,0,0,48
1373,2680,6936,632,2048,856,704,421,699,456,988,1072,164,1658,1022,940,1071,552,117,451,1427,2781,1470,807,55,0,0,55
1374,2808,7389,785,2023,783,860,473,692,565,928,804,511,2187,621,983,783,645,397,439,1489,3138,1474,849,21,0,0,21
1375,2846,7343,1824,1022,826,910,409,701,439,1114,980,313,1962,884,655,1038,729,424,375,1218,2324,1801,1625,77,0,0,77
1376,2033,6578,1035,998,452,574,336,671,284,732,604,413,1305,728,682,764,455,132,380,1335,2436,1681,746,176,0,0,176
1377,2019,5834,969,1050,468,609,387,555,323,854,665,177,1291,728,717,679,480,143,337,1159,2296,1364,678,21,0,0,21
1378,2732,8953,1051,1681,558,630,421,1123,526,841,922,443,1627,1105,1080,938,533,181,537,2159,3355,2047,855,70,0,0,70
1379,1416,5519,660,756,162,291,256,707,134,310,489,483,567,849,370,465,444,137,329,1380,2061,1216,533,40,0,0,40
1380,2400,8608,1323,1077,342,583,422,1053,473,615,999,313,1400,1000,741,785,633,241,533,2060,3056,2194,765,126,0,0,126
1381,3684,12233,2135,1549,698,1006,637,1343,642,1138,1299,605,2200,1484,944,1347,805,588,682,2435,4552,3234,1330,374,0,0,374
1382,2386,6601,1873,513,528,854,402,602,505,827,792,262,1726,660,546,553,668,619,278,1127,1919,1798,1479,20,0,0,20
1383,2376,6009,1733,643,520,1017,384,455,633,798,690,255,2024,352,607,327,526,916,195,805,1406,1706,1897,14,0,0,14
1384,2609,6109,1493,1116,755,882,435,537,599,793,884,333,1804,805,587,749,827,446,196,1048,1563,1713,1589,16,0,0,16
1385,1996,4788,1298,698,583,721,318,374,567,705,515,209,1586,410,622,443,478,453,168,700,1069,1347,1504,0,0,0,0
1386,1682,3964,1089,593,526,588,218,350,536,631,385,130,1330,352,520,438,379,345,153,607,1001,1122,1081,39,0,0,39
1387,1865,4786,1334,531,410,781,287,387,500,648,532,185,1311,554,457,464,570,374,177,625,1192,1392,1400,0,0,0,0
1388,446,1137,331,115,104,184,67,91,149,178,72,47,338,108,67,106,129,144,40,154,289,296,358,0,0,0,0
1389,1856,4171,1320,536,527,818,245,266,588,740,379,149,1551,305,321,481,451,603,137,449,928,1218,1439,14,0,0,14
1390,1556,3167,1021,535,609,589,190,168,601,545,344,66,1353,203,613,450,250,243,106,289,754,1119,899,38,0,0,38
1391,1717,3860,991,726,604,662,190,261,662,466,444,145,1464,253,570,498,339,310,125,532,1074,1234,895,123,0,0,123
1392,1817,4177,1324,493,564,689,254,310,559,466,710,82,1221,596,460,569,430,358,157,573,1016,1225,1206,0,0,0,0
1393,1474,3347,1100,374,453,585,220,216,386,457,496,135,1188,286,395,380,348,351,129,396,877,1009,936,0,0,0,0
1394,2908,9265,2208,700,384,887,564,1073,364,726,1413,405,1472,1436,422,571,912,1003,460,2033,2827,2656,1289,67,0,0,67
1395,3231,8823,2240,991,784,1009,502,936,821,1112,778,520,2139,1092,892,712,982,645,402,1701,2610,2347,1763,45,0,0,45
1396,3584,9888,2939,645,708,1212,607,1057,808,1021,1295,460,2454,1130,717,836,970,1061,431,1885,2495,3054,2023,88,0,0,88
1397,2138,5114,1396,742,611,789,243,495,684,708,585,161,1724,414,550,651,504,433,202,780,1312,1435,1385,0,0,0,0
1398,1534,3608,978,556,365,654,212,303,358,582,520,74,1156,378,427,389,308,410,155,512,895,1043,1003,0,0,0,0
1399,1621,4382,725,896,419,526,205,471,305,634,580,102,1161,460,447,474,330,370,236,811,1521,1096,718,25,0,0,25
1400,927,2216,677,250,230,402,126,169,275,314,262,76,724,203,165,185,217,360,68,252,460,645,791,39,0,0,39
1401,1298,3421,861,437,291,572,175,260,353,332,484,129,1090,208,264,261,339,434,108,457,866,1073,917,33,0,0,33
1402,3921,10342,2497,1424,962,1309,575,1075,811,1437,1313,360,2898,1023,1152,1011,1038,720,513,1826,3155,2660,2188,24,0,0,24
1403,1829,3759,1402,427,619,834,181,195,760,656,404,9,1584,245,582,631,315,301,105,297,721,1081,1555,43,0,0,43
1404,1060,2689,905,155,234,450,175,201,333,317,339,71,886,174,210,170,178,502,79,385,537,823,865,55,0,0,55
1405,1091,2924,862,229,213,399,181,298,183,431,340,137,706,385,176,209,208,498,125,495,775,908,621,35,0,0,35
1406,679,1563,569,110,155,302,100,122,132,182,329,36,542,137,96,88,162,333,59,179,280,564,481,0,0,0,0
1407,2656,6843,1692,964,800,719,474,663,742,943,756,215,1835,821,714,732,517,693,348,1395,1830,1933,1337,127,0,0,127
1408,2305,5575,1585,720,616,896,298,495,486,820,791,208,1812,493,326,843,528,608,228,910,1418,1520,1499,0,0,0,0
1409,3106,7912,2175,931,832,1028,492,754,606,1150,1112,238,2305,801,433,793,697,1183,362,1356,2057,2315,1822,21,0,0,21
1410,2074,5321,1100,974,567,654,373,480,519,633,693,229,1330,744,689,437,471,477,282,1022,1809,1436,772,29,0,0,29
1411,2596,6561,1500,1096,795,806,397,598,1006,617,689,284,1973,623,893,489,528,686,326,1094,1815,1770,1556,82,0,0,82
1412,4137,11138,2374,1763,967,1374,704,1092,1089,1453,1338,257,3005,1132,1133,1146,754,1104,566,2129,3180,3078,2185,128,0,0,128
1413,939,2290,807,132,212,390,146,191,334,243,324,38,776,163,231,207,233,268,65,380,449,712,684,15,0,0,15
1414,2738,7376,2370,368,457,1092,459,730,686,955,839,258,1915,823,519,497,477,1245,288,1340,1577,2207,1964,41,0,0,41
1415,1621,3809,960,661,518,596,217,290,352,697,489,83,1345,276,411,285,385,540,141,523,892,1097,1156,27,0,0,27
1416,637,1332,367,270,240,244,72,81,247,251,117,22,596,41,228,172,131,106,40,164,273,354,501,3,0,0,3
1417,144,359,87,57,36,55,26,27,26,66,47,5,94,50,36,13,25,70,15,62,95,109,78,8,2,0,6
1418,1652,3919,1179,473,469,626,267,290,414,621,386,231,1407,245,344,332,422,554,123,577,824,1247,1148,19,0,0,19
1419,1321,3124,858,463,356,435,227,303,307,558,371,85,1000,321,368,261,290,402,117,594,713,979,721,3,0,0,3
1420,2764,7489,2230,534,507,926,509,822,529,1166,847,222,1687,1077,243,634,614,1273,301,1748,1398,2448,1594,32,10,0,22
1421,3182,7598,1756,1426,1138,913,427,704,1175,1043,674,290,2550,632,975,841,624,742,358,1280,1958,1915,2087,190,24,0,166
1422,2300,5937,1993,307,516,783,415,586,531,805,787,177,1586,714,349,602,570,779,270,1104,1311,1811,1441,43,0,0,43
1423,2404,6296,1967,437,531,836,420,617,580,721,930,173,1693,711,343,279,435,1347,256,1255,1296,1902,1587,65,0,0,65
1424,1909,4111,816,1093,808,637,226,238,310,711,516,372,1618,291,437,408,552,512,178,557,1482,957,937,17,0,0,17
1425,2420,5937,1615,805,742,839,368,471,706,730,712,272,1841,579,605,476,504,835,238,823,1608,1740,1528,56,0,0,56
1426,2166,5338,1975,191,429,966,325,446,557,573,943,93,1655,511,248,230,440,1248,199,852,934,1581,1772,0,0,0,0
1427,2855,8182,1346,1509,806,884,415,750,788,1140,684,243,2066,789,728,766,396,965,432,1693,2622,1945,1490,607,481,0,126
1428,2654,10496,646,2008,419,472,341,1422,271,783,730,870,1309,1345,809,787,577,481,663,2304,4482,2218,829,68,0,0,68
1429,1856,4611,935,921,508,640,304,404,290,747,716,103,1341,515,397,480,379,600,303,671,1575,1272,790,31,0,0,31
1430,2745,6121,828,1917,1093,809,374,469,531,1333,768,113,2409,336,855,759,494,637,292,795,2255,1764,1015,195,0,0,195
1431,3721,8648,1766,1955,1231,1232,510,748,758,1368,1431,164,2808,913,843,843,831,1204,430,1362,2656,2391,1809,48,4,0,44
1432,2072,4800,1210,862,658,711,256,447,382,668,935,87,1369,703,356,322,399,995,180,865,1124,1543,1088,43,0,0,43
1433,1310,3150,881,429,374,403,241,292,205,511,478,116,895,415,232,257,180,641,156,644,665,1089,596,14,0,0,14
1434,2257,5300,1529,728,617,822,391,427,535,625,981,116,1687,570,540,379,569,769,195,855,1199,1813,1238,14,0,0,14
1435,796,2320,695,101,128,238,122,308,152,347,254,43,435,361,78,75,132,511,117,592,418,677,516,50,0,0,50
1436,1827,4757,1301,526,432,611,283,501,383,862,554,28,1208,619,361,257,264,945,187,1105,941,1462,1062,18,0,0,18
1437,3175,7122,1714,1461,1078,1070,398,629,787,1332,845,211,2413,762,688,636,503,1348,301,1263,1538,2064,1956,0,0,0,0
1438,2068,5003,1156,912,561,641,333,533,361,813,828,66,1548,520,174,456,281,1157,183,667,1623,1746,784,15,0,0,15
1439,0,0,0,0,0,0,0,0,0,0,0,0,0,0,0,0,0,0,0,0,0,0,0,0,0,0,0
1440,2940,6604,1754,1186,987,989,395,569,732,1187,806,215,1963,977,648,420,484,1388,236,1231,1389,2133,1615,13,0,0,13
1441,2505,6116,1550,955,693,780,418,614,707,952,792,54,1506,999,329,499,403,1274,308,1269,1509,1889,1141,4,0,0,4
1442,2331,5955,1669,662,586,695,399,651,452,974,764,141,1454,877,240,297,373,1421,258,1426,1116,1956,1199,11,0,0,11
1443,2038,4469,1152,886,836,586,240,376,651,832,469,86,1515,523,290,364,479,905,164,804,887,1328,1286,115,0,0,115
1444,1913,4220,878,1035,747,637,215,314,506,734,594,79,1421,492,374,515,300,724,179,735,1037,1224,1045,109,103,0,6
1445,2500,6273,1546,954,651,767,405,677,379,1039,928,154,1719,781,326,234,473,1467,240,1459,1296,1959,1319,2,0,0,2
1446,2472,5830,1582,890,666,941,316,549,612,1270,535,55,1758,714,279,300,537,1356,233,1051,1130,1707,1709,0,0,0,0
1447,901,2131,645,256,246,323,106,226,274,351,247,29,601,300,118,109,113,561,65,437,299,615,715,0,0,0,0
1448,4393,7935,2287,2106,1914,1734,412,333,1161,2107,1041,84,3982,411,768,748,1114,1763,266,544,2163,2699,2263,158,0,0,158
1449,1143,2734,274,869,343,388,197,215,169,646,310,18,722,421,482,198,168,295,139,536,996,696,367,19,0,0,19
1450,2740,6877,1991,749,654,965,468,653,429,1113,1028,170,1585,1155,220,416,433,1671,341,1377,1597,2195,1367,22,0,0,22
1451,1927,4876,1548,379,483,628,294,522,442,651,732,102,1147,780,291,222,269,1145,210,1059,941,1629,1037,0,0,0,0
1452,1923,4560,1296,627,576,641,260,446,341,859,611,112,1347,576,233,287,289,1114,190,867,993,1534,976,13,0,0,13
1453,273,681,166,107,68,104,50,51,49,125,89,10,178,95,68,25,48,132,28,118,181,206,148,15,4,0,11
1454,991,2127,587,404,379,356,131,125,298,433,162,98,878,113,372,182,131,306,57,247,455,553,815,27,0,0,27
