"TAZ","TOTHH","TOTPOP","hh_own","hh_rent","hh_size_1","hh_size_2","hh_size_3","hh_size_4_plus","hh_wrks_0","hh_wrks_1","hh_wrks_2","hh_wrks_3_plus","hh_kids_no","hh_kids_yes","HHINCQ1","HHINCQ2","HHINCQ3","HHINCQ4","AGE0004","AGE0519","AGE2044","AGE4564","AGE65P","gq_tot_pop","gq_type_univ","gq_type_mil","gq_type_othnon"
1,48,108,6,42,26,14,3,5,13,24,8,3,42,6,25,11,4,8,4,8,48,24,24,11,2,0,9
2,150,337,19,131,80,45,10,15,41,75,26,8,132,18,78,35,13,24,13,25,149,76,74,33,5,0,28
3,264,400,8,256,152,81,19,12,71,132,46,15,231,33,119,31,55,59,11,14,190,120,65,39,6,0,33
4,157,260,14,143,99,39,12,7,42,79,27,9,138,19,56,26,41,34,1,12,124,80,43,24,3,0,21
5,478,800,56,422,303,119,30,26,129,239,83,27,419,59,186,79,100,113,5,42,361,253,139,81,12,0,69
6,2122,3455,102,2020,1387,576,93,66,194,1508,399,21,2029,93,675,537,290,620,45,235,2292,595,288,375,375,0,0
7,3336,5963,24,3312,2280,718,179,159,1204,1600,491,41,3205,131,2042,688,422,184,103,289,2954,1718,899,988,39,0,949
8,4993,10998,66,4927,3523,834,282,354,2102,1835,692,364,4238,755,3438,878,604,73,238,770,3762,3546,2682,2934,0,0,2934
9,6053,12069,142,5911,3359,1622,544,528,1529,3217,1056,251,5480,573,3130,1382,829,712,409,1023,6337,3001,1299,1280,172,0,1108
10,4022,8240,462,3560,2125,1223,330,344,989,1767,988,278,3430,592,1195,861,787,1179,225,707,4865,1752,691,1123,327,0,796
11,2540,4935,182,2358,1634,502,189,215,460,1368,608,104,2241,299,1348,385,443,364,124,324,2085,1772,630,726,0,0,726
12,809,1313,210,599,422,283,66,38,196,363,250,0,765,44,103,25,96,585,30,65,705,286,227,21,0,0,21
13,51,96,23,28,22,20,5,4,12,23,16,0,48,3,19,1,2,29,4,6,46,28,12,2,0,0,2
14,392,734,165,227,172,152,36,32,91,175,125,1,370,22,143,12,15,222,33,46,358,210,87,13,0,0,13
15,273,542,14,259,129,93,26,25,7,103,141,22,249,24,37,80,74,82,23,55,307,110,47,28,0,0,28
16,5413,9764,1316,4097,2396,2078,570,369,421,2093,2736,163,5188,225,560,388,861,3604,394,478,6630,1752,510,151,0,0,151
17,4546,8144,1557,2989,2072,1778,441,255,669,2490,1280,107,4279,267,810,559,849,2328,286,333,5057,1796,672,281,92,0,189
18,1024,1910,358,666,498,363,100,63,92,540,319,73,921,103,93,251,234,446,58,63,1271,431,87,188,0,0,188
19,880,2023,166,714,360,370,82,68,79,464,274,63,791,89,241,66,84,489,55,116,1373,421,58,273,0,0,273
20,2228,4780,504,1724,1027,741,251,209,325,1160,624,119,1975,253,698,288,411,831,151,284,2813,1106,426,441,11,0,430
21,3612,5793,594,3018,2091,1133,227,161,1299,1616,606,91,3454,158,2039,252,542,779,94,156,2610,992,1941,219,10,0,209
22,1209,1957,93,1116,682,389,73,65,260,741,184,24,1092,117,117,158,249,685,48,74,1006,377,452,35,0,0,35
23,642,1277,319,323,273,238,66,65,138,393,98,13,580,62,183,93,84,282,63,130,385,331,368,23,0,0,23
24,489,865,50,439,258,131,57,43,224,161,99,5,382,107,401,38,0,50,21,69,153,243,379,11,0,0,11
25,1598,3586,38,1560,520,546,273,259,536,727,241,94,1211,387,1157,245,142,54,111,439,922,1014,1100,14,0,0,14
26,748,1589,21,727,315,215,100,118,168,377,162,41,656,92,456,139,115,38,36,153,556,432,412,9,0,0,9
27,1520,3068,165,1355,705,443,186,186,478,706,210,126,1355,165,884,265,162,209,75,253,1033,688,1019,39,0,0,39
28,1962,3441,452,1510,935,696,187,144,420,856,640,46,1796,166,384,346,408,824,94,128,1659,742,818,13,0,0,13
29,3235,5013,423,2812,1944,1000,186,105,556,1755,909,15,3022,213,983,861,661,730,79,152,3047,1056,679,97,79,0,18
30,3933,6991,208,3725,2333,1044,249,307,1189,2074,588,82,3549,384,2170,906,403,454,159,497,3580,1808,947,339,0,0,339
31,2717,4269,137,2580,1687,758,146,126,521,1444,694,58,2655,62,1031,817,431,438,78,199,2531,949,512,134,14,0,120
32,3271,5494,310,2961,1804,1034,258,175,528,1634,921,188,3120,151,809,878,819,765,116,176,3062,1135,1005,47,0,0,47
33,2808,5442,458,2350,1260,967,329,252,614,985,1098,111,2572,236,956,460,505,887,169,240,3185,1013,835,23,0,0,23
34,2642,4670,513,2129,1238,986,257,161,427,1032,770,413,2518,124,569,310,596,1167,144,194,2708,818,806,0,0,0,0
35,2365,4573,545,1820,1023,854,274,214,431,796,889,249,2266,99,764,348,270,983,132,242,2357,888,954,0,0,0,0
36,2623,5564,167,2456,1009,925,414,275,886,1179,406,152,2294,329,1770,461,158,234,147,484,1864,1517,1552,93,0,0,93
37,1813,3554,161,1652,874,579,203,157,344,986,343,140,1641,172,868,350,267,328,69,216,1713,861,695,48,0,0,48
38,2366,4455,700,1666,988,887,295,196,464,1136,691,75,1958,408,514,353,278,1221,116,276,2274,998,791,14,0,0,14
39,2066,4084,526,1540,809,776,324,157,344,946,622,154,1833,233,416,323,433,894,118,231,2141,872,722,1,0,0,1
40,2594,4542,792,1802,1184,1011,236,163,364,1208,959,63,2401,193,362,272,675,1285,145,232,2414,893,858,25,0,0,25
41,2128,4004,386,1742,999,743,215,171,632,1004,424,68,1780,348,1005,331,328,464,114,273,1887,846,884,88,0,0,88
42,643,2733,3,640,114,188,141,200,78,166,132,267,507,136,221,127,94,201,93,349,1291,749,251,637,0,68,569
43,3182,5635,644,2538,1548,1053,295,286,413,1603,1095,71,2745,437,405,365,779,1633,292,382,3334,1009,618,14,0,0,14
44,3674,6499,607,3067,1786,1312,370,206,370,1554,1467,283,3224,450,405,526,642,2101,222,268,4301,997,711,34,34,0,0
45,2463,4549,602,1861,1078,913,257,215,201,1358,644,260,2073,390,344,185,552,1382,194,276,2680,778,621,12,0,0,12
46,4040,7135,818,3222,1864,1554,379,243,612,2083,1084,261,3595,445,525,524,667,2324,312,307,4100,1357,1059,112,84,0,28
47,1718,2912,442,1276,916,556,115,131,226,1093,397,2,1594,124,270,293,345,810,106,208,1517,584,497,18,0,0,18
48,1998,3852,662,1336,822,735,222,219,271,1112,593,22,1743,255,286,158,538,1016,177,354,1968,791,562,12,0,0,12
49,2258,4464,859,1399,978,776,251,253,465,1184,552,57,2073,185,281,288,455,1234,195,496,1807,1100,866,18,9,0,9
50,2416,4643,699,1717,1082,829,255,250,270,1124,903,119,1919,497,227,257,283,1649,207,352,2516,890,678,40,0,0,40
51,2082,3769,521,1561,1003,733,187,159,238,935,864,45,1877,205,244,269,324,1245,169,272,2055,782,491,0,0,0,0
52,1354,3690,14,1340,334,323,298,399,125,428,581,220,860,494,74,219,181,880,199,623,1892,774,202,0,0,0,0
53,33,284,0,33,16,7,7,3,0,25,8,0,33,0,13,0,16,4,3,15,162,76,28,214,0,0,214
54,2792,6808,1372,1420,863,907,476,546,756,750,934,352,2136,656,730,588,477,997,255,751,2464,1842,1496,90,0,0,90
55,1534,3584,709,825,473,547,238,276,341,627,475,91,1269,265,374,365,271,524,132,395,1256,1005,796,0,0,0,0
56,50,110,27,23,16,19,8,7,11,21,15,3,41,9,5,11,7,27,2,8,22,22,56,0,0,0,0
57,943,2433,706,237,221,313,157,252,162,297,391,93,632,311,99,74,160,610,112,455,559,734,573,0,0,0,0
58,2448,5496,620,1828,821,835,409,383,562,947,748,191,1937,511,739,536,534,639,218,562,2271,1335,1110,54,0,0,54
59,3169,7914,1302,1867,878,1038,562,691,535,1109,1062,463,2400,769,656,584,627,1302,319,942,3028,2086,1539,21,0,0,21
60,1562,3823,634,928,468,497,240,357,326,567,553,116,1193,369,309,454,278,521,131,442,1448,985,817,6,0,0,6
61,1877,4435,577,1300,571,652,304,350,339,737,697,104,1414,463,520,370,367,620,186,453,1975,1024,797,0,0,0,0
62,3215,7386,980,2235,995,1106,564,550,589,1218,1280,128,2485,730,617,635,822,1141,351,905,3044,1778,1308,13,0,0,13
63,2162,5302,897,1265,593,724,421,424,306,682,1060,114,1555,607,291,304,588,979,250,612,2059,1300,1081,16,0,0,16
64,2854,6773,1016,1838,809,979,518,548,422,1109,1161,162,2162,692,620,539,417,1278,270,742,2982,1610,1169,14,0,0,14
65,2435,5539,698,1737,816,829,418,372,365,922,986,162,1932,503,288,567,339,1241,224,638,2433,1305,939,71,0,0,71
66,1998,4373,551,1447,661,716,284,337,329,574,717,378,1519,479,405,404,424,765,162,442,1986,990,793,0,0,0,0
67,2136,5048,618,1518,675,729,345,387,331,711,832,262,1587,549,300,394,415,1027,208,490,2489,1067,794,100,89,0,11
68,1462,3274,451,1011,467,523,262,210,391,578,325,168,1288,174,485,295,207,475,118,308,1575,667,606,31,0,0,31
69,2682,8184,816,1866,887,930,432,433,289,844,1099,450,2138,544,306,438,617,1321,269,1789,4237,1135,754,2257,2134,0,123
70,2884,6075,837,2047,995,1101,408,380,413,1107,1053,311,2370,514,489,402,586,1407,310,605,2962,1322,876,6,0,0,6
71,1936,4338,876,1060,693,612,247,384,415,943,472,106,1443,493,503,199,293,941,262,688,1511,1002,875,19,0,0,19
72,1102,2279,419,683,421,394,162,125,173,454,325,150,930,172,146,229,176,551,93,163,1249,433,341,27,0,0,27
73,2427,4089,518,1909,1273,770,195,189,676,918,531,302,2154,273,760,413,450,804,153,185,2028,785,938,0,0,0,0
74,2156,3697,169,1987,1213,624,158,161,1010,688,355,103,2089,67,925,215,395,621,85,194,1542,586,1290,54,0,0,54
75,1960,3067,562,1398,1138,618,116,88,503,942,456,59,1879,81,393,384,311,872,81,63,1641,482,800,16,0,0,16
76,1694,2969,402,1292,949,568,93,84,384,996,303,11,1694,0,523,263,511,397,55,85,1397,694,738,372,0,0,372
77,2128,4553,560,1568,814,762,340,212,415,898,602,213,1742,386,751,273,385,719,144,361,2296,770,982,236,0,0,236
78,2872,5660,206,2666,1354,881,288,349,1512,840,308,212,2618,254,1798,510,335,229,179,614,1991,1199,1677,40,0,0,40
79,2161,3558,294,1867,1229,642,163,127,182,1143,681,155,2094,67,344,463,261,1093,102,162,2178,766,350,67,1,0,66
80,1993,4296,353,1640,848,650,278,217,317,811,716,149,1750,243,541,322,377,753,152,342,2517,845,440,58,0,0,58
81,4190,8074,767,3423,1946,1433,457,354,383,1952,1480,375,3831,359,875,857,656,1802,295,478,4807,1794,700,224,0,0,224
82,1775,3419,485,1290,718,677,228,152,293,866,496,120,1573,202,461,320,181,813,94,200,1907,887,331,30,0,0,30
83,2106,3965,1012,1094,815,898,213,180,275,820,947,64,1840,266,262,162,268,1414,172,222,1709,1230,632,20,0,0,20
84,2317,4835,655,1662,858,910,288,261,160,585,1247,325,2032,285,240,248,346,1483,155,330,2862,1083,405,64,0,0,64
85,1854,3764,335,1519,712,720,256,166,135,754,711,254,1562,292,216,218,374,1046,118,175,2424,654,393,28,0,0,28
86,3290,6899,729,2561,1315,1138,413,424,495,1362,1219,214,2880,410,689,642,662,1297,273,644,3617,1447,918,105,0,0,105
87,2370,5125,582,1788,860,859,346,305,308,949,912,201,2034,336,404,329,489,1148,241,436,2870,941,637,144,24,0,120
88,2570,5483,490,2080,895,1003,353,319,210,1089,958,313,2348,222,418,378,515,1259,185,289,3575,949,485,91,19,0,72
89,3480,7687,1302,2178,1169,1308,488,515,407,1279,1556,238,2779,701,375,631,665,1809,404,802,3730,1776,975,138,0,0,138
90,2088,4592,606,1482,726,700,355,307,218,931,758,181,1827,261,258,473,766,591,208,304,2622,899,559,166,109,0,57
91,2307,5500,974,1333,731,865,325,386,445,1042,724,96,1865,442,446,259,302,1300,262,586,2672,1211,769,487,473,0,14
92,1021,2486,733,288,286,308,144,283,222,267,420,112,752,269,210,130,155,526,100,313,591,767,715,19,0,0,19
93,4197,7872,1496,2701,1655,1748,438,356,639,1839,1383,336,3835,362,701,784,886,1826,271,477,3651,2422,1051,6,0,0,6
94,1325,2653,586,739,460,544,203,118,188,500,558,79,1057,268,208,165,182,770,92,209,1173,801,378,14,0,0,14
95,1416,3015,764,652,474,549,197,196,226,569,571,50,1166,250,194,193,288,741,177,329,1221,839,449,10,0,0,10
96,1145,2562,618,527,342,398,183,222,110,500,503,32,868,277,85,207,236,617,176,301,1028,710,347,16,0,0,16
97,1604,3404,697,907,498,628,232,246,247,648,619,90,1322,282,244,193,226,941,202,308,1602,823,469,0,0,0,0
98,1896,4111,835,1061,595,724,300,277,230,835,712,119,1552,344,219,276,293,1108,205,413,1881,1011,601,0,0,0,0
99,2029,4213,500,1529,813,754,249,213,415,870,562,182,1767,262,431,324,388,886,172,260,2362,942,477,116,0,0,116
100,1821,4296,312,1509,662,596,250,313,198,748,698,177,1455,366,457,445,203,716,145,368,2317,1020,446,83,27,0,56
101,2950,6761,485,2465,1170,907,379,494,548,922,1056,424,2520,430,770,674,584,922,243,623,3672,1491,732,49,0,0,49
102,2705,5507,674,2031,1077,980,361,287,257,1010,1271,167,2370,335,435,333,551,1386,220,390,2971,1311,615,129,0,0,129
103,2721,5178,945,1776,1071,1108,309,233,572,907,945,297,2538,183,569,458,371,1323,170,299,2539,1487,683,32,0,0,32
104,1895,3624,458,1437,793,750,208,144,237,1072,511,75,1753,142,326,249,349,971,132,170,2057,874,391,23,0,0,23
105,3219,6363,543,2676,1469,1049,375,326,497,1158,1275,289,2850,369,799,510,511,1399,194,454,3314,1494,907,120,0,0,120
106,3214,6922,557,2657,1642,910,295,367,547,1113,1128,426,2995,219,908,527,695,1084,178,537,3539,1853,815,728,0,0,728
107,890,2841,216,674,308,304,122,156,56,441,327,66,734,156,201,143,183,363,80,218,1591,706,246,733,0,0,733
108,1256,2735,267,989,479,477,142,158,270,335,601,50,1113,143,454,145,91,566,105,326,1621,493,190,220,168,0,52
109,3516,7250,1118,2398,1185,1527,473,331,283,1378,1334,521,2911,605,754,401,273,2088,265,409,4750,1192,634,356,142,0,214
110,2989,7447,630,2359,863,1308,425,393,217,937,1784,51,2396,593,570,270,516,1633,527,609,5185,846,280,869,848,0,21
111,2376,5001,587,1789,887,1041,269,179,47,1055,1235,39,2063,313,123,202,516,1535,189,189,3777,693,153,575,551,0,24
112,1032,2194,406,626,332,405,144,151,104,440,354,134,876,156,188,127,125,592,90,178,1184,487,255,8,0,0,8
113,2477,5819,1086,1391,709,921,436,411,498,1060,793,126,2004,473,545,277,455,1200,283,766,2897,1306,567,22,0,0,22
114,1748,3796,879,869,541,685,269,253,205,611,807,125,1375,373,217,238,220,1073,225,307,1885,940,439,62,0,0,62
115,673,1834,180,493,173,238,119,143,46,311,218,98,543,130,101,205,77,290,72,152,869,509,232,131,0,0,131
116,1869,4956,715,1154,523,625,323,398,210,693,687,279,1411,458,340,342,316,871,194,584,2467,1207,504,186,0,0,186
117,1583,4356,494,1089,374,507,303,399,103,639,561,280,1110,473,249,228,397,709,191,505,2277,938,445,28,0,0,28
118,1427,4275,286,1141,310,424,265,428,151,422,616,238,957,470,463,302,289,373,175,604,2169,908,419,22,0,0,22
119,784,2283,292,492,141,253,174,216,100,208,325,151,617,167,165,90,124,405,80,258,1096,557,292,17,0,0,17
120,1123,3007,401,722,279,367,227,250,140,309,513,161,934,189,262,226,50,585,127,304,1484,733,359,35,0,0,35
121,1302,3364,847,455,300,459,249,294,152,536,549,65,919,383,161,356,276,509,210,369,1386,866,533,60,0,0,60
122,2092,5164,1277,815,494,782,422,394,424,667,820,181,1575,517,523,381,255,933,271,646,2004,1468,775,26,0,0,26
123,1743,4214,750,993,451,625,344,323,148,681,694,220,1376,367,221,308,438,776,223,457,1983,1072,479,23,0,0,23
124,1265,3331,564,701,350,377,238,300,98,435,664,68,800,465,222,297,172,574,175,489,1377,825,465,34,0,0,34
125,1036,2869,737,299,220,359,198,259,121,349,434,132,793,243,218,136,226,456,163,385,1037,828,456,6,0,0,6
126,1515,4488,781,734,293,483,300,439,186,482,587,260,851,664,337,233,233,712,244,688,1754,1126,676,0,0,0,0
127,1761,4091,1074,687,509,611,294,347,253,514,760,234,1424,337,154,221,306,1080,267,528,1494,1111,691,7,0,0,7
128,2467,5435,1000,1467,788,867,416,396,190,1012,1101,164,1913,554,229,375,528,1335,330,585,2569,1274,677,24,0,0,24
129,2099,4403,1252,847,749,730,303,317,262,993,747,97,1684,415,172,210,462,1255,227,477,1625,1257,817,0,0,0,0
130,1834,4222,1253,581,593,602,290,349,365,747,662,60,1293,541,457,292,303,782,191,613,1205,1221,992,0,0,0,0
131,2630,6760,2177,453,539,950,491,650,640,750,1118,122,1853,777,394,537,473,1226,380,1072,1814,2054,1440,0,0,0,0
132,1546,4192,1033,513,318,507,310,411,335,420,506,285,1144,402,319,253,296,678,179,607,1359,1217,830,0,0,0,0
133,2448,6305,1562,886,561,864,464,559,352,649,1073,374,1916,532,362,307,520,1259,325,723,2349,1734,1174,13,0,0,13
134,2480,8022,1509,971,438,695,460,887,304,883,647,646,1634,846,358,465,638,1019,326,1154,2871,2215,1456,46,0,0,46
135,1562,5553,790,772,250,369,301,642,159,516,508,379,1085,477,348,361,398,455,195,858,2061,1493,946,0,0,0,0
136,963,3027,678,285,189,239,184,351,130,248,364,221,752,211,195,186,187,395,108,372,1062,850,635,11,0,0,11
137,1566,5424,1072,494,261,424,279,602,140,392,727,307,1073,493,360,381,339,486,212,721,1903,1504,1084,20,0,0,20
138,2619,9267,1451,1168,433,601,483,1102,327,791,942,559,1963,656,545,716,649,709,361,1301,3242,2595,1768,32,0,0,32
139,1319,5412,898,421,205,275,227,612,262,255,296,506,836,483,339,462,310,208,238,809,1784,1551,1030,37,0,0,37
140,1188,4143,779,409,223,326,188,451,229,269,369,321,879,309,335,277,221,355,195,638,1458,1163,689,0,0,0,0
141,763,2732,260,503,187,214,102,260,109,259,215,180,477,286,169,210,172,212,152,511,1057,688,324,57,0,0,57
142,272,1183,32,240,95,102,45,30,85,82,92,13,199,73,104,51,43,74,38,83,594,384,84,564,0,0,564
143,436,1434,211,225,125,123,72,116,62,148,123,103,273,163,166,121,94,55,88,192,519,380,255,29,0,0,29
144,1495,4143,446,1049,407,411,324,353,353,713,300,129,1002,493,899,251,169,176,257,822,1496,1002,566,23,0,0,23
145,1365,4135,110,1255,375,339,236,415,378,687,171,129,748,617,1022,302,38,3,275,1213,1455,830,362,20,0,0,20
146,550,1340,322,228,149,188,99,114,64,270,200,16,357,193,104,106,151,189,98,183,645,295,119,0,0,0,0
147,1307,4987,697,610,238,324,282,463,212,267,454,374,863,444,330,295,299,383,300,924,1949,1227,587,184,0,0,184
148,1129,4110,397,732,221,228,261,419,227,491,135,276,601,528,506,136,251,236,237,869,1538,1001,465,22,0,0,22
149,1601,5044,930,671,325,469,300,507,234,519,572,276,1109,492,439,390,251,521,275,819,1955,1313,682,110,0,0,110
150,1370,4369,606,764,352,348,196,474,316,402,391,261,937,433,541,300,336,193,238,672,1543,1097,819,106,0,0,106
151,618,2030,302,316,168,114,93,243,165,109,242,102,466,152,270,84,114,150,95,270,754,568,343,18,0,0,18
152,1391,4454,1001,390,281,357,230,523,229,425,456,281,1069,322,259,254,319,559,190,551,1508,1262,943,37,0,0,37
153,1084,3988,749,335,159,242,228,455,138,278,350,318,778,306,226,308,229,321,184,575,1348,1174,707,0,0,0,0
154,1061,4015,616,445,156,210,209,486,177,337,382,165,871,190,291,286,251,233,156,577,1289,1216,777,11,0,0,11
155,1016,3954,608,408,124,227,206,459,144,349,263,260,604,412,231,333,207,245,189,651,1278,1070,766,12,0,0,12
156,740,3100,352,388,89,149,160,342,78,229,201,232,490,250,221,226,160,133,139,552,1106,866,437,0,0,0,0
157,709,2556,193,516,105,187,152,265,188,290,107,124,405,304,425,130,77,77,138,639,880,601,298,0,0,0,0
158,385,1052,77,308,105,107,57,116,160,107,59,59,282,103,264,53,17,51,48,233,334,226,211,1,0,0,1
159,1434,4760,939,495,228,340,311,555,330,358,501,245,1082,352,374,455,339,266,177,681,1617,1345,940,26,0,0,26
160,1361,4890,899,462,201,329,268,563,104,521,496,240,887,474,153,584,304,320,180,767,1725,1353,865,0,0,0,0
161,1163,4162,690,473,172,297,207,487,119,267,476,301,839,324,205,370,222,366,159,624,1475,1166,738,6,0,0,6
162,1316,4761,763,553,210,295,235,576,249,398,484,185,926,390,350,451,308,207,180,653,1636,1314,978,17,0,0,17
163,1227,4449,785,442,198,310,239,480,180,312,360,375,783,444,206,437,208,376,176,649,1521,1236,867,4,0,0,4
164,1958,7520,1180,778,288,447,366,857,213,530,607,608,1362,596,382,440,502,634,334,1123,2619,2110,1334,32,0,0,32
165,1938,6797,1076,862,324,467,340,807,206,567,744,421,1314,624,461,497,419,561,309,897,2490,1856,1245,0,0,0,0
166,2704,9107,1566,1138,491,710,435,1068,287,927,906,584,2038,666,754,608,551,791,339,1173,3631,2346,1618,35,0,0,35
167,1919,7260,1243,676,308,453,366,792,178,480,677,584,1135,784,425,437,459,598,337,1049,2895,1809,1170,60,0,0,60
168,3050,9459,2020,1030,628,835,529,1058,439,1210,843,558,2458,592,625,772,828,825,374,1171,3733,2477,1704,36,0,0,36
169,2294,6664,1990,304,377,744,469,704,337,870,797,290,1522,772,338,522,299,1135,274,1029,1802,1913,1646,18,11,0,7
170,2170,5894,1626,544,468,709,404,589,443,679,789,259,1538,632,297,350,378,1145,256,955,1624,1695,1364,41,0,0,41
171,913,2442,758,155,187,301,170,255,114,351,374,74,691,222,59,95,181,578,117,406,659,746,514,12,0,0,12
172,1953,5306,1446,507,388,669,350,546,662,546,555,190,1551,402,286,405,458,804,244,786,1567,1505,1204,0,0,0,0
173,1375,3633,971,404,283,449,264,379,238,434,496,207,1054,321,187,227,238,723,139,493,1170,1006,825,0,0,0,0
174,2431,6019,1296,1135,599,831,459,542,436,1008,793,194,1887,544,533,333,379,1186,289,683,2503,1412,1132,14,0,0,14
175,2121,4507,454,1667,755,741,304,321,311,912,783,115,1766,355,271,475,482,893,183,350,2513,841,620,12,0,0,12
176,1868,3988,483,1385,645,684,272,267,348,841,544,135,1445,423,491,335,429,613,166,307,1975,898,642,55,43,0,12
177,3300,8701,1387,1913,876,971,652,801,470,1219,1201,410,2571,729,582,646,739,1333,355,931,3664,2067,1684,129,0,0,129
178,2382,6472,1433,949,502,755,465,660,402,942,663,375,1904,478,544,476,433,929,288,727,2370,1667,1420,16,0,0,16
179,2724,7803,1533,1191,517,809,542,856,476,865,921,462,1937,787,495,702,473,1054,336,949,2963,2077,1478,7,0,0,7
180,1765,4353,573,1192,510,571,302,382,202,710,557,296,1272,493,495,439,369,462,181,472,1954,1046,700,4,0,0,4
181,1907,5288,1109,798,413,570,386,538,303,594,720,290,1449,458,395,359,481,672,260,658,2028,1356,986,0,0,0,0
182,2397,6696,1470,927,540,757,478,622,469,867,670,391,1570,827,459,370,585,983,287,820,2400,1815,1374,17,0,0,17
183,2491,7360,1584,907,465,729,509,788,526,655,881,429,1798,693,648,303,613,927,327,967,2572,1937,1557,24,0,0,24
184,3038,8851,2052,986,551,887,622,978,606,989,880,563,2311,727,566,652,690,1130,354,1108,3039,2309,2041,8,0,0,8
185,2896,8224,1658,1238,627,855,541,873,636,906,715,639,2286,610,678,645,589,984,308,977,3050,2115,1774,7,0,0,7
186,2699,7891,1830,869,521,810,509,859,432,997,820,450,1958,741,340,629,532,1198,291,1100,2660,2092,1748,29,0,0,29
187,1432,4010,1147,285,280,423,277,452,337,415,482,198,950,482,307,241,222,662,130,664,1082,1198,936,0,0,0,0
188,542,1862,14,528,208,165,79,90,59,211,116,156,490,52,259,84,123,76,32,487,914,217,212,626,574,0,52
189,3173,7719,127,3046,945,1021,615,592,803,1532,434,404,2803,370,1371,607,569,626,353,1065,3550,1595,1156,0,0,0,0
190,1319,2358,239,1080,667,361,140,151,314,728,199,78,1052,267,355,411,317,236,83,207,1019,579,470,42,0,0,42
191,1430,4039,1068,362,271,455,301,403,348,383,536,163,1066,364,275,348,292,515,201,532,1356,1128,822,13,0,0,13
192,2635,7648,161,2474,514,744,588,789,230,977,859,569,1685,950,841,914,665,215,423,1228,3656,1624,717,10,0,0,10
193,2154,6801,1150,1004,361,558,423,812,229,645,897,383,1304,850,403,516,580,655,359,1060,2511,1802,1069,76,0,0,76
194,1990,7203,1193,797,326,510,372,782,368,509,620,493,1485,505,359,545,547,539,274,959,2490,1946,1534,194,0,0,194
195,1773,5598,1242,531,322,459,353,639,206,506,594,467,1313,460,233,355,477,708,247,790,1880,1596,1085,9,0,0,9
196,1907,6466,1452,455,293,496,362,756,212,477,847,371,1351,556,205,606,456,640,288,890,2373,1746,1169,7,0,0,7
197,1548,5897,1042,506,228,366,254,700,193,382,375,598,1149,399,345,270,308,625,220,817,2051,1606,1203,18,0,0,18
198,1679,5055,264,1415,369,415,336,559,157,510,687,325,1207,472,571,377,385,346,229,811,2091,1141,783,0,0,0,0
199,1147,2492,758,389,404,337,170,236,62,545,467,73,980,167,149,367,399,232,99,262,994,744,393,1,0,0,1
200,961,2853,655,306,220,225,155,361,127,362,316,156,703,258,212,319,239,191,129,431,861,847,585,26,26,0,0
201,2776,8611,783,1993,566,702,479,1029,431,731,1213,401,1669,1107,1113,586,710,367,413,1497,3350,2053,1298,36,0,0,36
202,2226,7648,1375,851,341,573,442,870,390,539,653,644,1600,626,424,640,513,649,362,1144,2932,1934,1276,20,0,0,20
203,1554,5464,733,821,232,397,264,661,167,581,372,434,1154,400,348,464,438,304,264,889,2101,1434,776,0,0,0,0
204,2163,7842,1014,1149,359,489,392,923,333,499,1000,331,1673,490,713,403,560,487,345,1159,3128,1924,1286,59,0,0,59
205,2401,8275,1684,717,412,586,403,1000,360,656,552,833,1832,569,447,440,800,714,383,1170,3020,2315,1387,13,0,0,13
206,1212,3817,919,293,199,340,262,411,326,221,386,279,898,314,275,182,261,494,159,548,1324,1114,672,0,0,0,0
207,1169,4356,660,509,166,252,224,527,136,286,410,337,752,417,334,274,261,300,205,763,1549,1160,679,0,0,0,0
208,2194,5474,1406,788,537,703,378,576,496,732,838,128,1652,542,436,427,383,948,318,781,1884,1631,860,14,0,0,14
209,2547,7790,1857,690,475,688,503,881,277,910,1017,343,1836,711,297,655,632,963,375,1133,2686,2174,1422,19,0,0,19
210,1052,3883,308,744,154,198,210,490,149,322,312,269,628,424,342,308,245,157,241,849,1537,868,388,0,0,0,0
211,2881,8786,430,2451,665,824,436,956,406,1166,821,488,1912,969,774,1149,395,563,469,1561,3675,2014,1067,83,0,0,83
212,1236,4228,686,550,192,299,231,514,97,414,344,381,787,449,305,142,280,509,180,787,1454,1189,618,25,0,0,25
213,2670,6924,1488,1182,797,766,476,631,652,633,1040,345,2099,571,586,606,679,799,329,952,2139,1861,1643,31,0,0,31
214,2037,6366,1569,468,340,582,407,708,282,535,957,263,1553,484,350,522,569,596,351,971,2050,1804,1190,62,0,0,62
215,2161,6188,839,1322,443,611,419,688,271,809,894,187,1517,644,429,591,586,555,317,984,2401,1589,897,12,0,0,12
216,1500,3770,861,639,434,482,247,337,173,549,671,107,1083,417,340,300,411,449,193,461,1517,990,609,7,0,0,7
217,1328,4239,1098,230,186,414,279,449,161,286,672,209,831,497,132,221,362,613,222,622,1397,1169,829,64,0,0,64
218,1353,4119,777,576,278,401,203,471,288,376,405,284,1020,333,402,348,219,384,201,547,1465,1051,855,18,0,0,18
219,1915,6899,1418,497,226,484,359,846,327,568,565,455,1399,516,360,379,449,727,313,912,2392,1700,1582,11,0,0,11
220,1879,5994,1123,756,299,555,339,686,176,614,745,344,1239,640,382,341,520,636,328,1068,2222,1550,826,20,0,0,20
221,1515,4707,1053,462,282,431,314,488,230,329,666,290,1004,511,293,218,369,635,226,750,1658,1245,828,0,0,0,0
222,1774,4429,927,847,473,619,314,368,249,665,570,290,1293,481,306,411,394,663,212,554,1760,1247,656,12,0,0,12
223,1935,4597,921,1014,557,718,315,345,190,890,698,157,1581,354,338,449,472,676,223,601,1686,1318,769,31,0,0,31
224,1273,3352,1060,213,225,446,251,351,145,542,413,173,901,372,174,193,221,685,170,552,876,1083,671,0,0,0,0
225,1434,3939,1083,351,239,479,285,431,273,579,453,129,1037,397,244,307,323,560,240,677,1160,1200,662,0,0,0,0
226,2413,6509,1909,504,433,834,491,655,430,732,942,309,1781,632,256,588,653,916,326,1091,1828,1939,1325,14,0,0,14
227,2102,5561,1637,465,471,681,412,538,664,529,702,207,1395,707,303,567,436,796,257,903,1429,1533,1439,0,0,0,0
228,73,251,59,14,6,16,21,30,8,22,27,16,46,27,4,2,25,42,8,39,95,77,32,1,0,0,1
229,1851,5652,1194,657,253,576,395,627,197,543,706,405,1162,689,197,241,449,964,255,915,2063,1537,882,24,0,0,24
230,2874,8871,1974,900,502,771,580,1021,448,779,1147,500,2010,864,543,529,554,1248,480,1262,3204,2327,1598,10,0,0,10
231,1494,5148,1240,254,182,421,312,579,198,442,470,384,1098,396,259,222,325,688,223,757,1723,1301,1144,72,0,0,72
232,1804,5649,1411,393,282,541,374,607,381,548,628,247,1248,556,409,389,385,621,248,864,1822,1574,1141,127,0,0,127
233,3223,7558,2237,986,997,1006,501,719,550,1385,1124,164,2379,844,521,828,829,1045,412,998,2543,2145,1460,7,0,0,7
234,1922,3565,476,1446,817,701,221,183,254,944,593,131,1571,351,531,416,471,504,138,245,1920,694,568,0,0,0,0
235,1161,3314,903,258,224,360,177,400,210,272,519,160,783,378,181,218,278,484,198,537,1075,930,574,13,0,0,13
236,2197,5668,1203,994,596,685,334,582,527,511,1001,158,1585,612,331,633,473,760,269,860,2058,1517,964,42,0,0,42
237,2614,8086,729,1885,509,695,528,882,222,882,780,730,1702,912,704,624,751,535,438,1464,3299,2009,876,31,0,0,31
238,1120,4197,646,474,183,233,214,490,124,182,468,346,608,512,122,306,312,380,219,772,1621,1078,507,0,0,0,0
239,0,0,0,0,0,0,0,0,0,0,0,0,0,0,0,0,0,0,0,0,0,0,0,0,0,0,0
240,1886,5153,687,1199,414,603,363,506,238,787,639,222,1308,578,477,326,500,583,294,802,1976,1316,765,42,0,0,42
241,1299,3627,972,327,296,363,221,419,305,427,399,168,798,501,280,199,293,527,166,644,913,1010,894,24,0,0,24
242,945,2808,831,114,151,272,190,332,252,156,373,164,657,288,148,159,202,436,134,524,709,805,636,0,0,0,0
243,977,2879,779,198,153,291,212,321,139,285,451,102,690,287,168,99,146,564,110,458,808,850,653,9,0,0,9
244,1890,5203,793,1097,413,540,362,575,378,447,824,241,1307,583,439,294,425,732,241,901,1681,1472,908,20,0,0,20
245,1272,3462,945,327,264,391,215,402,356,436,389,91,878,394,295,354,189,434,163,570,982,971,776,26,0,0,26
246,2918,8166,1768,1150,585,883,536,914,520,907,1246,245,1934,984,505,479,391,1543,391,1666,2168,2203,1738,129,0,0,129
247,1300,3843,987,313,196,351,245,508,295,441,500,64,869,431,183,169,285,663,207,941,910,1173,612,10,0,0,10
248,1394,3339,526,868,441,422,195,336,193,527,601,73,887,507,273,266,325,530,175,615,1212,920,417,76,0,0,76
249,2521,6234,1048,1473,705,851,386,579,243,1162,898,218,1808,713,352,375,681,1113,333,1155,2325,1598,823,14,0,0,14
250,1927,4979,1035,892,488,579,330,530,285,839,685,118,1138,789,300,299,401,927,288,1025,1539,1325,802,49,0,0,49
251,2738,5490,705,2033,1125,923,280,410,374,1366,900,98,2179,559,540,691,488,1019,292,722,2299,1335,842,5,0,0,5
252,1909,5882,1746,163,219,646,287,757,258,761,736,154,1004,905,209,145,168,1387,208,1424,1133,1754,1363,11,0,0,11
253,969,2570,731,238,168,381,154,266,230,282,372,85,673,296,125,89,265,490,78,504,638,791,559,0,0,0,0
254,1865,5744,1737,128,197,606,331,731,337,584,731,213,1176,689,83,256,216,1310,200,1310,1104,1816,1314,0,0,0,0
255,1277,3511,1066,211,222,440,205,410,285,443,464,85,806,471,166,111,245,755,165,800,759,1054,733,2,0,0,2
256,2470,4961,828,1642,993,892,274,311,620,1033,813,4,1979,491,656,429,303,1082,243,562,1963,1059,1134,10,0,0,10
257,1754,3939,774,980,740,531,204,279,529,593,541,91,1406,348,371,445,312,626,235,467,1496,870,871,149,0,0,149
258,2872,6507,731,2141,1062,953,376,481,419,1127,1138,188,2286,586,762,578,726,806,344,833,2881,1497,952,118,0,0,118
259,2202,5372,913,1289,777,613,342,470,294,1110,567,231,1641,561,565,536,527,574,345,829,2239,1245,714,17,0,0,17
260,2453,8379,815,1638,473,705,428,847,281,784,973,415,1509,944,758,534,429,732,506,1584,3707,1712,870,51,0,0,51
261,1390,4380,828,562,241,373,305,471,176,341,637,236,819,571,288,233,478,391,289,831,1671,1037,552,8,0,0,8
262,1194,3969,704,490,210,378,212,394,97,569,261,267,935,259,288,186,286,434,205,653,1518,1055,538,89,0,0,89
263,797,2934,621,176,91,213,159,334,128,224,233,212,503,294,156,102,237,302,157,467,1027,822,461,121,0,0,121
264,1030,3228,840,190,158,297,202,373,170,282,459,119,725,305,154,152,205,519,155,561,985,941,586,75,0,0,75
265,1809,3518,917,892,737,612,251,209,270,1053,463,23,1469,340,363,409,438,599,206,298,1521,833,660,0,0,0,0
266,3011,7059,1127,1884,828,1079,516,588,453,1228,1104,226,2017,994,579,343,500,1589,415,1032,2810,1420,1382,120,0,0,120
267,1305,3736,786,519,199,388,283,435,264,470,503,68,800,505,176,163,318,648,193,717,1184,972,670,48,0,0,48
268,1282,3630,768,514,222,357,277,426,183,402,569,128,790,492,52,225,245,760,190,746,1184,919,591,0,0,0,0
269,1594,4042,692,902,369,509,289,427,182,764,569,79,1102,492,199,231,367,797,223,700,1592,952,575,4,0,0,4
270,1272,3173,703,569,315,402,265,290,185,589,438,60,830,442,160,181,270,661,182,521,1191,709,570,0,0,0,0
271,2073,5578,1268,805,382,681,443,567,362,893,729,89,1277,796,297,275,455,1046,340,987,1983,1309,959,47,0,0,47
272,774,2314,616,158,104,251,153,266,142,207,361,64,496,278,44,132,139,459,107,478,564,667,498,3,0,0,3
273,1581,4245,849,732,272,553,320,436,191,603,729,58,977,604,218,245,397,721,264,726,1522,1119,614,0,0,0,0
274,2127,5656,739,1388,564,731,354,478,284,835,763,245,1733,394,378,381,535,833,328,808,2738,1147,635,0,0,0,0
275,1864,4765,725,1139,455,619,340,450,364,605,773,122,1377,487,501,277,371,715,301,706,2107,1104,547,12,0,0,12
276,1225,2819,592,633,354,444,164,263,231,321,585,88,966,259,233,206,375,411,147,346,1240,641,445,3,0,0,3
277,1738,4948,1084,654,318,534,378,508,188,506,737,307,1073,665,264,220,494,760,302,858,1830,1319,639,74,0,0,74
278,2522,6515,940,1582,536,950,509,527,149,1041,1272,60,1743,779,294,384,480,1364,541,953,3190,1341,490,176,0,0,176
279,1733,4521,864,869,384,598,319,432,210,880,597,46,1236,497,276,517,360,580,297,762,1807,1113,542,19,0,0,19
280,1339,3482,716,623,298,432,247,362,214,474,524,127,912,427,106,246,253,734,201,616,1142,1021,502,0,0,0,0
281,2037,4803,897,1140,662,626,307,442,390,708,832,107,1601,436,569,241,420,807,254,680,1714,1229,926,61,0,0,61
282,979,2576,741,238,245,282,147,305,191,329,368,91,638,341,153,165,179,482,150,519,632,748,527,0,0,0,0
283,1312,3567,1100,212,239,457,233,383,174,355,543,240,853,459,165,195,114,838,205,593,930,1044,795,47,0,0,47
284,1761,4913,361,1400,423,536,311,491,174,760,618,209,1272,489,353,433,421,554,342,782,2144,1050,595,21,0,0,21
285,1099,2974,944,155,202,359,233,305,175,369,428,127,734,365,119,113,127,740,196,480,830,889,579,1,0,0,1
286,2672,7336,1858,814,585,865,487,735,320,974,1260,118,1762,910,316,371,420,1565,387,1420,2448,1933,1148,370,322,0,48
287,985,2580,654,331,194,318,160,313,202,293,415,75,645,340,178,173,184,450,119,483,726,726,526,50,17,0,33
288,3027,7249,1147,1880,849,1063,435,680,568,1224,1192,43,1949,1078,601,546,586,1294,373,1227,2654,1788,1207,80,0,0,80
289,2131,6117,1911,220,301,658,425,747,270,582,1103,176,1131,1000,129,109,336,1557,304,1333,1469,1871,1140,0,0,0,0
290,1458,3659,873,585,335,518,261,344,306,581,460,111,1047,411,240,228,284,706,218,584,1092,1016,749,0,0,0,0
291,1218,3151,892,326,235,421,243,319,207,358,580,73,769,449,132,185,245,656,156,530,854,928,683,8,0,0,8
292,875,2430,733,142,141,293,139,302,133,314,338,90,584,291,87,133,133,522,126,482,556,734,532,0,0,0,0
293,2134,5928,1768,366,384,821,377,552,400,777,605,352,1658,476,225,547,442,920,264,988,1587,1803,1286,31,0,0,31
294,2396,6054,1814,582,495,924,430,547,281,1286,543,286,1877,519,316,258,492,1330,263,916,1529,2090,1256,11,0,0,11
295,1364,4148,930,434,252,450,243,419,214,407,628,115,990,374,133,304,377,550,231,750,1292,1162,713,13,0,0,13
296,3610,9212,2358,1252,1083,1236,444,847,712,1442,912,544,2671,939,775,583,813,1439,393,1518,2329,2694,2278,101,0,0,101
297,1667,4277,1000,667,478,607,246,336,201,578,656,232,1233,434,200,282,229,956,194,564,1273,1321,925,106,0,0,106
298,2620,6830,2094,526,532,966,412,710,725,1009,708,178,2113,507,245,272,470,1633,246,1289,1253,2057,1985,4,0,0,4
299,1151,3134,925,226,223,399,182,347,225,408,454,64,698,453,191,85,125,750,131,579,669,1004,751,0,0,0,0
300,958,2632,842,116,151,340,168,299,142,357,390,69,637,321,88,115,60,695,90,504,527,881,630,0,0,0,0
301,2196,6073,1794,402,371,756,403,666,340,677,989,190,1307,889,67,326,494,1309,389,1098,1637,1810,1139,42,0,0,42
302,1618,4411,1439,179,251,622,298,447,224,453,881,60,1014,604,106,190,127,1195,219,731,1053,1427,981,24,0,0,24
303,1678,4690,1347,331,279,583,301,515,327,564,651,136,1137,541,189,263,282,944,304,754,1391,1389,852,26,0,0,26
304,2106,5514,1829,277,410,783,387,526,325,865,763,153,1513,593,176,294,289,1347,257,940,1239,1797,1281,89,0,0,89
305,721,1993,625,96,114,251,148,208,112,245,312,52,446,275,79,57,80,505,126,391,507,584,385,2,0,0,2
306,1338,3591,1012,326,227,441,265,405,205,500,483,150,798,540,172,154,268,744,206,689,963,1083,650,10,0,0,10
307,1787,5205,1546,241,258,531,360,638,226,678,708,175,1046,741,184,243,245,1115,289,1132,1344,1548,892,2,0,0,2
308,1618,4540,1266,352,315,459,286,558,185,396,865,172,852,766,168,200,317,933,271,1044,1186,1385,654,8,0,0,8
309,3644,8395,1651,1993,1150,1176,540,778,476,1478,1427,263,2551,1093,505,644,834,1661,491,1361,3186,2115,1242,42,0,0,42
310,672,1817,452,220,148,177,155,192,74,228,318,52,458,214,109,111,75,377,129,320,618,551,199,19,0,0,19
311,1736,4104,1261,475,499,568,301,368,260,720,697,59,1111,625,231,234,373,898,218,688,1248,1202,748,17,0,0,17
312,3287,8677,2085,1202,640,1059,668,920,503,1444,1240,100,2212,1075,542,301,579,1865,430,1783,2829,2636,999,2,0,0,2
313,1635,4054,800,835,473,650,197,315,102,754,592,187,1122,513,338,353,290,654,167,472,1942,1090,383,152,0,0,152
314,1898,6206,413,1485,433,433,333,699,220,682,693,303,1276,622,637,648,339,274,353,1271,2583,1376,623,78,0,0,78
315,2370,4866,57,2313,812,1129,214,215,214,948,1134,74,2146,224,418,411,478,1063,182,348,3312,720,304,202,0,0,202
316,993,2635,386,607,233,347,172,241,100,330,446,117,714,279,238,201,238,316,143,422,1219,612,239,17,0,0,17
317,2236,5380,895,1341,641,796,346,453,234,1011,863,128,1604,632,273,440,601,922,289,786,2183,1418,704,27,0,0,27
318,1064,2934,788,276,214,310,201,339,140,375,481,68,602,462,132,143,117,672,157,660,791,882,444,1,0,0,1
319,1186,3359,991,195,179,410,242,355,235,353,505,93,871,315,185,106,220,675,185,588,875,1039,672,11,0,0,11
320,2219,5803,990,1229,541,724,427,527,256,795,924,244,1411,808,340,536,387,956,370,873,2254,1512,794,41,0,0,41
321,1054,3013,864,190,175,315,191,373,219,274,478,83,677,377,172,95,203,584,208,514,935,818,538,16,0,0,16
322,1952,4890,1389,563,467,662,336,487,350,727,718,157,1484,468,272,318,282,1080,295,766,1434,1415,980,2,0,0,2
323,1789,5271,656,1133,465,524,299,501,230,811,565,183,1160,629,442,481,332,534,299,806,2078,1135,953,288,0,0,288
324,1413,4061,195,1218,338,418,236,421,112,484,620,197,787,626,392,476,306,239,260,765,1826,852,358,6,0,0,6
325,2163,6203,671,1492,466,643,405,649,147,1012,741,263,1618,545,495,599,470,599,384,1124,2682,1430,583,22,0,0,22
326,855,2747,90,765,163,197,181,314,65,346,272,172,525,330,270,347,138,100,153,588,1300,555,151,38,0,0,38
327,1507,5540,388,1119,255,272,300,680,145,629,429,304,746,761,452,348,388,319,340,1264,2213,1268,455,134,0,0,134
328,1154,3370,775,379,255,351,205,343,200,372,390,192,836,318,209,154,248,543,173,579,1200,928,490,0,0,0,0
329,1277,4589,644,633,219,286,227,545,129,520,374,254,858,419,332,377,337,231,258,973,1760,1106,492,71,0,0,71
330,1627,5496,670,957,298,386,293,650,146,484,563,434,837,790,504,415,356,352,357,1126,2180,1266,567,23,0,0,23
331,1998,6437,678,1320,509,517,319,653,186,719,564,529,1366,632,441,459,417,681,399,1174,2998,1294,572,13,0,0,13
332,956,4463,577,379,79,169,150,558,78,292,286,300,542,414,175,265,279,237,238,964,1837,976,448,25,0,0,25
333,2663,10800,1321,1342,369,476,440,1378,113,736,987,827,1713,950,379,630,576,1078,676,2317,4333,2481,993,76,0,0,76
334,1653,7369,758,895,228,302,257,866,209,355,608,481,962,691,387,591,323,352,431,1558,3047,1614,719,28,0,0,28
335,2764,8361,434,2330,707,531,399,1127,230,1643,511,380,1819,945,1074,646,459,585,535,2136,3537,1645,508,9,0,0,9
336,1627,4352,1020,607,354,492,292,489,189,745,569,124,999,628,195,191,292,949,247,907,1358,1224,616,0,0,0,0
337,567,1477,331,236,146,172,80,169,66,260,198,43,348,219,76,64,115,312,68,285,413,447,264,0,0,0,0
338,815,2466,652,163,142,205,129,339,76,280,372,87,474,341,71,111,122,511,162,635,644,704,321,65,0,0,65
339,895,2649,800,95,124,295,179,297,183,330,304,78,550,345,67,54,73,701,83,575,494,848,649,0,0,0,0
340,2018,4758,792,1226,561,694,304,459,262,970,645,141,1387,631,355,192,567,904,314,789,1981,1081,593,23,0,0,23
341,2122,4529,553,1569,782,685,298,357,370,839,873,40,1457,665,389,389,400,944,301,595,1936,947,750,8,0,0,8
342,1328,4453,1168,160,204,502,220,402,296,568,382,82,931,397,141,115,212,860,106,1016,1026,1128,1177,592,535,0,57
343,805,2334,676,129,119,281,131,274,140,364,294,7,468,337,82,65,119,539,101,524,466,752,491,13,0,0,13
344,1144,3360,1006,138,182,328,203,431,122,449,520,53,569,575,146,91,90,817,146,945,583,1095,591,0,0,0,0
345,1740,4626,1309,431,396,525,307,512,298,649,721,72,1012,728,155,227,208,1150,234,1052,1113,1333,894,10,0,0,10
346,1348,3359,913,435,328,484,209,327,321,487,440,100,958,390,187,141,196,824,119,670,933,810,827,0,0,0,0
347,2792,7669,2496,296,488,1065,462,777,737,801,1086,168,2162,630,311,386,296,1799,195,1260,1443,2369,2402,81,0,0,81
348,0,0,0,0,0,0,0,0,0,0,0,0,0,0,0,0,0,0,0,0,0,0,0,0,0,0,0
349,362,994,266,96,66,98,63,135,52,83,151,76,238,124,51,23,37,251,49,190,284,268,203,4,0,0,4
350,987,3590,882,105,174,371,145,297,189,415,299,84,728,259,57,109,77,744,91,554,1441,736,768,960,958,0,2
351,2074,4775,803,1271,699,677,311,387,361,652,933,128,1508,566,374,264,316,1120,198,825,1688,1147,917,23,0,0,23
352,419,2751,6,413,90,223,65,41,102,212,98,7,370,49,160,224,29,6,46,70,2479,152,4,1821,1818,0,3
353,1927,6228,29,1898,857,781,136,153,468,977,452,30,1704,223,1074,482,155,216,229,318,5402,264,15,2844,2839,0,5
354,953,5294,6,947,591,257,38,67,231,484,223,15,843,110,604,208,104,37,28,170,4835,247,14,3723,3717,0,6
355,2101,7028,155,1946,1018,611,224,248,428,1086,563,24,1650,451,406,460,435,800,244,550,4885,528,821,3144,3128,0,16
356,3867,7706,1211,2656,1735,1197,425,510,918,1659,1158,132,3188,679,1112,525,605,1625,302,992,2806,1722,1884,23,0,0,23
357,1700,4706,1301,399,294,583,321,502,184,735,610,171,1033,667,89,83,348,1180,188,1037,1052,1433,996,20,0,0,20
358,1882,5513,1562,320,246,596,352,688,407,692,710,73,1135,747,259,188,238,1197,174,1315,1106,1795,1123,0,0,0,0
359,1300,3649,923,377,208,445,255,392,183,430,629,58,723,577,97,62,144,997,124,749,923,1083,770,15,0,0,15
360,1993,5404,1142,851,400,615,367,611,377,743,722,151,1439,554,231,270,461,1031,224,1116,1641,1497,926,0,0,0,0
361,2425,6939,1364,1061,474,666,472,813,216,945,914,350,1187,1238,200,277,478,1470,329,1616,2149,1936,909,6,0,0,6
362,2138,5999,1533,605,439,602,389,708,367,720,973,78,1172,966,248,172,342,1376,251,1343,1452,1652,1301,6,0,0,6
363,1104,2781,559,545,303,321,182,298,173,352,361,218,621,483,231,87,157,629,80,576,774,757,594,0,0,0,0
364,692,1971,521,171,117,211,133,231,158,261,232,41,452,240,69,70,78,475,89,459,433,567,423,4,0,0,4
365,1801,3754,308,1493,748,500,258,295,180,939,551,131,1473,328,352,294,467,688,151,579,1803,869,352,0,0,0,0
366,2185,5487,810,1375,623,635,372,555,235,964,906,80,1628,557,300,388,314,1183,247,1095,2049,1393,703,20,0,0,20
367,2333,6286,1356,977,516,744,439,634,412,847,955,119,1616,717,382,335,480,1136,254,1300,1717,1808,1207,0,0,0,0
368,1422,4285,1235,187,147,476,268,531,351,560,394,117,1070,352,150,217,198,857,115,906,851,1333,1080,4,0,0,4
369,1957,5169,1436,521,480,580,283,614,570,458,870,59,1250,707,216,249,299,1193,165,1119,939,1491,1455,12,0,0,12
370,1757,4621,1259,498,392,563,272,530,376,661,670,50,1101,656,228,157,242,1130,197,1030,974,1389,1031,0,0,0,0
371,1322,3652,975,347,235,402,242,443,163,512,546,101,788,534,104,122,155,941,152,815,977,1109,599,7,0,0,7
372,2815,6651,817,1998,891,913,476,535,313,1528,858,116,2075,740,509,348,715,1243,399,1055,3401,1194,602,19,0,0,19
373,1234,3142,771,463,286,367,232,349,183,474,507,70,844,390,215,228,172,619,202,537,948,851,604,1,0,0,1
374,1290,3282,529,761,330,467,247,246,115,485,582,108,915,375,210,203,289,588,248,392,1696,711,235,40,0,0,40
375,1815,3550,491,1324,786,593,217,219,330,650,706,129,1452,363,472,191,304,848,204,317,1678,612,739,0,0,0,0
376,1807,4655,826,981,521,579,308,399,178,733,732,164,1331,476,304,272,306,925,280,667,1932,1089,687,64,0,0,64
377,2543,5324,990,1553,937,914,375,317,315,1200,855,173,2041,502,269,577,582,1115,286,502,2901,1067,568,28,0,0,28
378,1666,3601,425,1241,494,685,279,208,163,765,689,49,1320,346,234,240,298,894,224,363,1913,813,288,40,0,0,40
379,2373,5553,461,1912,778,795,360,440,211,1163,792,207,1879,494,460,523,415,975,315,737,3021,1091,389,19,0,0,19
380,2134,5095,208,1926,743,674,281,436,47,1197,772,118,1607,527,541,385,355,853,337,720,2965,793,280,67,0,0,67
381,2471,5991,1249,1222,753,704,399,615,272,1344,681,174,1711,760,503,244,510,1214,291,1166,2111,1628,795,0,0,0,0
382,1069,2908,630,439,232,306,177,354,98,437,521,13,638,431,86,210,179,594,195,606,920,793,394,6,0,0,6
383,712,2046,577,135,103,209,155,245,64,230,284,134,345,367,22,58,107,525,96,458,405,618,469,0,0,0,0
384,1560,4754,1387,173,183,457,305,615,326,592,514,128,953,607,125,153,194,1088,176,1147,972,1524,935,6,0,0,6
385,969,2906,866,103,113,318,189,349,180,470,257,62,595,374,90,114,110,655,90,689,561,906,660,0,0,0,0
386,1039,2914,940,99,158,375,173,333,199,419,386,35,645,394,197,90,112,640,92,636,516,961,709,0,0,0,0
387,1294,3820,1096,198,165,418,241,470,159,461,557,117,719,575,112,56,166,960,136,871,825,1265,723,17,0,0,17
388,2083,6269,1846,237,252,673,375,783,346,738,774,225,1272,811,146,184,340,1413,209,1526,1215,2010,1309,0,0,0,0
389,1910,5286,1355,555,383,585,327,615,397,660,698,155,1162,748,366,201,240,1103,233,1128,1335,1467,1123,13,0,0,13
390,1418,3230,580,838,440,503,215,260,242,493,634,49,1059,359,243,216,212,747,195,480,1457,736,362,0,0,0,0
391,3003,7106,920,2083,843,1071,514,575,409,1566,856,172,2102,901,404,489,702,1408,374,981,3458,1335,958,154,0,0,154
392,2327,5792,158,2169,518,882,495,432,129,1017,1040,141,1692,635,257,612,469,989,462,678,3573,822,257,1,0,0,1
393,1885,4672,505,1380,453,716,358,358,194,1050,507,134,1563,322,318,389,461,717,332,586,2300,954,500,1,0,0,1
394,1463,4169,818,645,295,463,282,423,172,445,646,200,981,482,266,144,258,795,265,710,1591,1042,561,178,0,0,178
395,2340,5084,731,1609,642,976,439,283,142,1197,836,165,1774,566,205,282,584,1269,384,387,3089,881,343,0,0,0,0
396,4,10,2,2,1,1,1,1,0,2,2,0,3,1,0,1,1,2,1,1,5,2,1,0,0,0,0
397,962,2568,643,319,159,331,231,241,47,436,384,95,650,312,53,74,164,671,236,386,1247,552,147,0,0,0,0
398,1336,3095,543,793,385,453,276,222,65,605,534,132,903,433,156,315,210,655,237,323,1714,598,223,0,0,0,0
399,16,40,9,7,4,5,4,3,1,7,6,2,11,5,4,4,3,5,3,6,19,7,5,0,0,0,0
400,1862,4590,676,1186,530,576,356,400,153,885,648,176,1314,548,274,321,292,975,316,669,2279,913,413,0,0,0,0
401,340,1031,222,118,75,104,94,67,50,177,80,33,263,77,143,91,51,55,24,128,446,281,152,100,0,0,100
402,190,685,4,186,20,34,44,92,4,88,97,1,55,135,14,71,38,67,69,203,285,104,24,0,0,0,0
403,2,8,1,1,0,1,0,1,0,1,1,0,1,1,0,1,0,1,0,1,4,2,1,0,0,0,0
404,586,2039,371,215,92,134,116,244,77,199,247,63,393,193,162,133,115,176,104,354,728,597,256,18,0,0,18
405,3,9,2,1,0,1,1,1,0,2,1,0,2,1,0,1,1,1,0,2,3,3,1,0,0,0,0
406,712,1645,176,536,171,265,148,128,9,412,261,30,527,185,44,58,135,475,160,145,1039,242,59,12,0,0,12
407,42,91,4,38,10,21,7,4,1,24,15,2,31,11,3,3,9,27,7,4,66,11,3,1,0,0,1
408,15,33,1,14,4,6,3,2,0,8,6,1,11,4,1,1,3,10,3,1,24,4,1,0,0,0,0
409,0,0,0,0,0,0,0,0,0,0,0,0,0,0,0,0,0,0,0,0,0,0,0,0,0,0,0
410,4829,10144,535,4294,1364,2145,844,476,64,2792,1769,204,3575,1254,448,480,1165,2736,907,488,7156,1320,273,76,0,0,76
411,0,0,0,0,0,0,0,0,0,0,0,0,0,0,0,0,0,0,0,0,0,0,0,0,0,0,0
412,8375,19592,1269,7106,2032,3637,1485,1221,323,3741,3358,953,6576,1799,884,1258,2321,3912,1364,1840,12793,2766,829,0,0,0,0
413,3930,9932,1145,2785,813,1372,845,900,240,1625,1898,167,2614,1316,646,415,722,2147,847,1565,5387,1631,502,15,0,0,15
414,977,3577,600,377,136,213,234,394,127,305,320,225,601,376,167,256,184,370,177,635,1262,866,637,56,22,0,34
415,729,2170,415,314,133,200,161,235,82,246,246,155,401,328,136,109,227,257,119,320,933,531,267,14,0,0,14
416,2821,7654,1057,1764,663,874,580,704,240,1081,1140,360,1894,927,362,309,645,1505,462,1072,3837,1619,664,15,0,0,15
417,0,0,0,0,0,0,0,0,0,0,0,0,0,0,0,0,0,0,0,0,0,0,0,0,0,0,0
418,593,1578,570,23,155,177,106,155,62,234,187,110,415,178,124,158,154,157,60,224,474,515,305,6,0,0,6
419,1174,3783,583,591,203,328,249,394,123,462,371,218,822,352,228,243,308,395,235,542,1669,853,484,15,0,0,15
420,743,2711,519,224,102,180,152,309,84,213,293,153,511,232,127,194,158,264,158,387,1075,702,389,9,0,0,9
421,3068,7454,2022,1046,806,1184,522,556,273,1487,1004,304,2636,432,546,733,786,1003,261,870,3033,2070,1220,0,0,0,0
422,3296,7624,1213,2083,928,1302,536,530,199,1519,1160,418,2582,714,305,516,651,1824,485,744,4233,1316,846,82,0,0,82
423,1675,4899,698,977,352,511,329,483,175,560,698,242,1145,530,410,335,372,558,270,753,2255,1112,509,0,0,0,0
424,2519,7202,1185,1334,561,721,529,708,181,910,1123,305,1649,870,490,667,506,856,408,1137,3129,1791,737,13,0,0,13
425,1412,3609,365,1047,372,503,243,294,87,484,650,191,1058,354,230,318,376,488,223,467,1967,670,282,0,0,0,0
426,1834,4448,661,1173,516,627,378,313,111,837,679,207,1365,469,204,337,318,975,276,513,2546,813,300,88,0,0,88
427,1231,2909,485,746,261,540,265,165,29,530,600,72,1019,212,90,70,293,778,215,208,2110,291,85,2,0,0,2
428,591,1391,230,361,125,262,127,77,13,254,290,34,491,100,43,32,142,374,103,96,1020,134,38,0,0,0,0
429,0,0,0,0,0,0,0,0,0,0,0,0,0,0,0,0,0,0,0,0,0,0,0,0,0,0,0
430,705,1604,43,662,237,286,82,100,72,299,246,88,528,177,93,150,122,340,82,202,984,259,77,0,0,0,0
431,14,31,1,13,5,5,2,2,1,6,5,2,11,3,2,3,2,7,2,4,19,5,1,0,0,0,0
432,218,495,13,205,73,89,25,31,22,93,76,27,164,54,29,46,38,105,25,62,304,80,24,0,0,0,0
433,2279,5739,602,1677,637,722,444,476,235,966,796,282,1712,567,608,452,401,818,321,841,2793,1172,612,35,33,0,2
434,36,115,17,19,14,15,3,4,6,17,11,2,29,7,24,12,0,0,11,20,44,35,5,2,0,0,2
435,2135,4501,549,1586,849,666,305,315,343,995,651,146,1694,441,595,493,447,600,239,514,2279,992,477,82,0,0,82
436,1595,4248,824,771,380,455,307,453,138,675,586,196,878,717,306,325,418,546,287,676,1551,1141,593,7,0,0,7
437,2190,6127,854,1336,479,619,428,664,141,897,795,357,1473,717,401,533,406,850,377,1040,2651,1456,603,0,0,0,0
438,1730,4743,1011,719,377,586,336,431,201,604,695,230,1052,678,270,309,340,811,265,694,1804,1185,795,11,0,0,11
439,1120,3108,645,475,221,370,203,326,173,351,336,260,839,281,281,147,190,502,194,501,1127,810,476,0,0,0,0
440,3405,8687,963,2442,761,1135,769,740,299,1764,1093,249,2323,1082,548,434,794,1629,677,1178,4556,1600,676,0,0,0,0
441,2649,6492,634,2015,674,998,461,516,299,961,1115,274,2150,499,508,361,545,1235,431,721,3546,1184,610,13,0,0,13
442,1068,3252,822,246,153,321,216,378,102,263,413,290,816,252,92,124,177,675,157,501,1122,920,552,13,0,0,13
443,2053,5678,637,1416,388,717,429,519,88,924,886,155,1562,491,222,371,565,895,327,802,2786,1200,563,0,0,0,0
444,2217,6053,1149,1068,482,692,451,592,249,899,749,320,1529,688,213,520,379,1105,360,891,2377,1525,900,1,0,0,1
445,3311,9122,1062,2249,636,1051,724,900,280,1468,1312,251,2153,1158,435,703,759,1414,659,1437,4355,1787,884,18,0,0,18
446,3488,8892,1365,2123,700,1245,806,737,204,1539,1381,364,2501,987,235,542,924,1787,653,978,5001,1462,798,0,0,0,0
447,1825,4539,894,931,435,630,383,377,222,949,546,108,1284,541,255,289,275,1006,313,561,1880,1055,730,0,0,0,0
448,3234,7651,484,2750,949,1133,595,557,329,1670,848,387,2230,1004,643,558,829,1204,519,903,4210,1169,850,28,0,0,28
449,2661,6836,698,1963,673,666,627,695,306,1103,1054,198,1720,941,363,496,543,1259,555,1198,3175,1203,705,0,0,0,0
450,2442,5461,598,1844,717,932,400,393,284,807,1150,201,1940,502,299,412,677,1054,381,598,2856,1063,563,11,0,0,11
451,2427,6884,1419,1008,462,686,450,829,395,994,822,216,1565,862,436,252,461,1278,481,1404,2369,1711,919,15,0,0,15
452,1058,2958,882,176,214,298,209,337,163,353,416,126,570,488,80,187,124,667,137,606,705,881,629,0,0,0,0
453,2564,7348,1598,966,468,640,518,938,257,1048,1011,248,1412,1152,268,282,603,1411,455,1623,2350,1925,995,25,0,0,25
454,1522,4417,1200,322,222,444,322,534,233,502,693,94,895,627,107,138,248,1029,138,938,1022,1407,912,0,0,0,0
455,905,2631,777,128,118,298,151,338,244,246,321,94,640,265,161,103,114,527,104,567,557,889,514,2,0,0,2
456,2972,8295,893,2079,554,803,624,991,414,1333,898,327,1739,1233,585,678,594,1115,432,1725,3042,2163,933,6,0,0,6
457,1734,5279,1098,636,223,454,377,680,233,517,918,66,831,903,154,237,236,1107,374,1227,1685,1256,737,0,0,0,0
458,1546,4633,938,608,207,410,364,565,238,582,559,167,694,852,218,193,157,978,296,1036,1567,1119,615,0,0,0,0
459,2837,8203,1631,1206,465,801,612,959,337,1119,1160,221,1920,917,368,379,558,1532,509,1591,3031,1944,1128,21,0,0,21
460,1497,4143,542,955,267,396,372,462,165,708,544,80,940,557,114,181,351,851,304,813,1760,887,379,27,0,0,27
461,1681,4829,1114,567,328,484,356,513,103,554,925,99,1079,602,189,298,428,766,260,840,1602,1339,788,17,0,0,17
462,1660,5052,1014,646,233,427,352,648,194,739,563,164,888,772,257,191,356,856,260,1146,1599,1430,617,29,0,0,29
463,1784,4556,996,788,364,587,406,427,250,747,569,218,1271,513,147,404,410,823,281,660,1855,1057,703,0,0,0,0
464,1881,4907,987,894,379,676,364,462,180,711,833,157,1320,561,277,271,505,828,344,696,2053,1147,667,20,0,0,20
465,3197,7517,1259,1938,960,1037,563,637,493,1330,1048,326,2424,773,799,691,490,1217,426,977,3115,1802,1197,40,0,0,40
466,1594,4040,1042,552,371,542,288,393,191,546,653,204,1185,409,246,346,278,724,221,610,1395,1207,607,9,0,0,9
467,2190,5096,677,1513,720,711,338,421,239,1147,661,143,1695,495,341,594,358,897,267,662,2189,1372,606,118,0,0,118
468,2216,5625,702,1514,564,714,395,543,447,855,822,92,1542,674,577,478,392,769,339,896,2199,1469,722,42,0,0,42
469,2539,7473,658,1881,541,653,468,877,313,1113,702,411,1360,1179,557,843,650,489,549,1592,3104,1588,640,0,0,0,0
470,2270,6210,1330,940,445,722,471,632,245,1043,761,221,1702,568,334,307,522,1107,367,980,2342,1681,840,18,0,0,18
471,2351,5571,629,1722,669,858,371,453,283,835,1014,219,1847,504,460,658,654,579,349,707,2486,1240,789,39,0,0,39
472,2148,5412,414,1734,580,663,393,512,158,1170,757,63,1386,762,414,619,508,607,347,917,2623,1118,407,0,0,0,0
473,2550,7392,503,2047,541,740,475,794,324,1198,845,183,1648,902,794,769,369,618,449,1436,2945,1812,750,16,0,0,16
474,1593,4320,684,909,351,481,243,518,132,661,529,271,1173,420,253,414,400,526,252,713,1693,1135,527,14,0,0,14
475,1681,4591,774,907,362,497,318,504,146,827,565,143,1146,535,270,504,256,651,273,869,1647,1207,595,0,0,0,0
476,2544,7302,1523,1021,436,743,513,852,322,999,989,234,1537,1007,228,532,599,1185,364,1448,2172,2084,1234,18,0,0,18
477,2125,6423,1256,869,325,517,479,804,280,853,735,257,1286,839,351,373,322,1079,323,1409,2018,1841,832,0,0,0,0
478,2640,7138,591,2049,550,679,650,761,290,1320,613,417,1584,1056,555,548,713,824,502,1441,3197,1437,561,10,0,0,10
479,2850,8827,1426,1424,395,661,688,1106,337,1113,1217,183,1604,1246,402,367,499,1582,410,2143,3014,2345,915,62,0,0,62
480,1095,3404,934,161,74,329,235,457,109,389,497,100,697,398,81,98,142,774,93,762,700,1224,625,0,0,0,0
481,1600,4888,1317,283,177,434,337,652,259,579,623,139,854,746,94,237,334,935,114,1070,1150,1686,868,0,0,0,0
482,1417,4508,1175,242,125,329,370,593,140,457,696,124,723,694,144,116,151,1006,127,992,1056,1625,708,0,0,0,0
483,2140,6188,1005,1135,393,475,487,785,263,1101,643,133,1355,785,529,280,431,900,273,1494,1953,1744,724,0,0,0,0
484,2875,8011,1541,1334,606,652,652,965,491,1294,920,170,1751,1124,450,446,516,1463,300,1851,2342,2267,1251,0,0,0,0
485,2249,6725,1288,961,327,525,485,912,263,985,799,202,1157,1092,244,173,286,1546,306,1672,2114,1742,891,15,0,0,15
486,1893,5824,651,1242,246,380,521,746,157,1112,447,177,826,1067,344,190,432,927,329,1502,2237,1223,533,0,0,0,0
487,1973,5248,764,1209,395,594,417,567,210,889,756,118,1221,752,267,182,435,1089,258,1069,1987,1348,586,17,0,0,17
488,2777,7779,1723,1054,533,759,503,982,546,922,1096,213,1597,1180,493,377,287,1620,260,1677,1955,2336,1551,17,0,0,17
489,2044,6107,1746,298,173,690,459,722,270,775,739,260,1190,854,235,171,316,1322,156,1203,1304,2090,1354,0,0,0,0
490,1396,4154,1065,331,187,364,304,541,235,518,489,154,904,492,182,200,226,788,140,864,1059,1341,750,0,0,0,0
491,1021,3191,671,350,96,275,229,421,58,418,489,56,514,507,61,127,145,688,98,769,896,1037,391,0,0,0,0
492,1819,5674,1330,489,166,422,493,738,145,728,776,170,848,971,155,214,249,1201,206,1325,1512,1864,767,0,0,0,0
493,1940,5718,1756,184,251,610,379,700,423,606,670,241,1230,710,255,294,273,1118,138,1159,1163,1961,1297,15,0,0,15
494,2024,5975,1815,209,225,615,456,728,454,772,576,222,1355,669,236,296,459,1033,133,1287,1167,2140,1248,0,0,0,0
495,2022,5838,1790,232,227,745,384,666,339,763,815,105,1262,760,162,315,265,1280,117,1158,1129,2061,1373,0,0,0,0
496,988,2766,818,170,164,322,193,309,196,311,355,126,772,216,148,58,142,640,87,532,508,880,759,0,0,0,0
497,2440,6708,1900,540,444,836,425,735,626,668,925,221,1531,909,363,204,194,1679,162,1255,1209,2143,1939,0,0,0,0
498,1477,4065,1227,250,273,438,304,462,210,535,619,113,1011,466,170,182,226,899,149,759,995,1375,787,0,0,0,0
499,2622,7714,1836,786,403,708,587,924,308,1086,1041,187,1327,1295,267,414,482,1459,402,1688,2292,2263,1069,13,0,0,13
500,1369,4082,1041,328,182,399,277,511,170,411,469,319,792,577,88,250,245,786,201,902,1179,1198,602,0,0,0,0
501,1380,4049,1092,288,205,401,273,501,151,572,590,67,799,581,149,192,205,834,208,789,1224,1183,645,0,0,0,0
502,1682,4537,734,948,363,483,370,466,326,506,614,236,1109,573,443,369,321,549,266,777,1673,1174,647,10,0,0,10
503,2880,6539,794,2086,1051,902,392,535,675,1057,968,180,2180,700,989,554,532,805,329,947,2398,1492,1373,0,0,0,0
504,2224,4749,1004,1220,763,828,305,328,248,1051,649,276,1521,703,407,522,510,785,282,562,2141,1259,505,8,0,0,8
505,2093,5961,1145,948,407,653,416,617,284,834,806,169,1157,936,344,524,369,856,312,1159,2011,1728,751,24,0,0,24
506,1459,3905,787,672,337,388,280,454,309,532,537,81,1034,425,303,230,297,629,190,787,1143,1147,638,24,0,0,24
507,1934,5003,1599,335,385,699,339,511,314,941,566,113,1182,752,236,255,412,1031,169,1000,1131,1519,1184,0,0,0,0
508,1158,2891,586,572,314,333,191,320,101,445,562,50,683,475,166,130,225,637,127,657,851,872,384,0,0,0,0
509,1350,3008,485,865,450,440,193,267,123,901,314,12,1017,333,224,266,276,584,124,561,997,954,372,21,0,0,21
510,962,2766,839,123,115,334,167,346,228,386,319,29,631,331,69,75,130,688,75,563,525,932,671,0,0,0,0
511,2947,6947,1864,1083,860,995,439,653,614,1419,809,105,2198,749,494,357,487,1609,245,1321,1504,2394,1483,14,0,0,14
512,1587,4185,1273,314,310,588,279,410,147,686,668,86,1089,498,151,259,323,854,187,747,1061,1393,797,22,0,0,22
513,1032,3012,889,143,148,384,184,316,190,479,264,99,713,319,155,78,95,704,73,648,571,1034,686,94,0,0,94
514,2754,7736,2113,641,529,789,478,958,583,956,1025,190,1642,1112,304,361,533,1556,236,1768,1577,2351,1804,0,0,0,0
515,2382,7346,1595,787,296,671,451,964,240,984,879,279,1279,1103,381,570,304,1127,337,1815,2247,2072,875,19,0,0,19
516,1348,3936,1109,239,216,356,260,516,140,406,701,101,736,612,95,218,242,793,189,1004,936,1222,585,0,0,0,0
517,1894,5426,1362,532,319,518,383,674,233,436,994,231,1013,881,318,199,345,1032,281,1269,1465,1609,802,8,0,0,8
518,2303,6411,1487,816,448,609,433,813,347,933,849,174,1453,850,276,330,369,1328,291,1532,1572,1975,1041,0,0,0,0
519,3187,8586,2086,1101,758,881,571,977,290,1612,1188,97,2146,1041,368,538,728,1553,478,1729,2741,2355,1283,36,0,0,36
520,1395,4407,1074,321,159,358,305,573,111,561,505,218,733,662,222,211,243,719,235,985,1289,1287,611,26,0,0,26
521,1978,5048,1014,964,554,623,330,471,302,661,805,210,1136,842,504,359,394,721,291,861,1767,1337,792,27,0,0,27
522,2215,6250,1356,859,413,659,425,718,200,630,1091,294,1345,870,438,408,451,918,334,1252,1967,1749,948,62,0,0,62
523,2702,7807,2197,505,459,843,559,841,391,737,1249,325,1450,1252,257,511,563,1371,450,1583,2255,2238,1281,50,0,0,50
524,1909,5333,1648,261,324,619,368,598,293,717,723,176,1198,711,251,250,335,1073,328,1049,1415,1554,987,16,0,0,16
525,1586,4339,1283,303,293,519,284,490,302,697,494,93,962,624,163,403,361,659,248,833,1130,1290,838,17,0,0,17
526,2395,6540,1889,506,458,776,457,704,227,862,1217,89,1409,986,277,238,416,1464,422,1265,1871,1965,1017,21,0,0,21
527,2861,7254,2067,794,696,1005,513,647,375,1204,1003,279,2104,757,559,489,311,1502,434,1144,2209,2250,1217,91,0,0,91
528,2593,6333,1235,1358,681,889,424,599,254,1200,864,275,1808,785,366,587,666,974,332,1071,2188,1781,961,26,0,0,26
529,1227,2870,907,320,366,409,165,287,359,510,330,28,876,351,171,201,332,523,153,429,609,833,846,0,0,0,0
530,3287,7149,1205,2082,1106,1214,404,563,374,1707,989,217,2502,785,584,852,702,1149,362,945,3104,1844,894,2,0,0,2
531,1405,2897,775,630,533,463,197,212,254,717,323,111,1147,258,424,295,264,422,146,297,1076,839,539,44,0,0,44
532,3094,7241,564,2530,1028,1034,497,535,423,1160,1266,245,2425,669,949,857,547,741,384,973,3489,1526,869,93,0,0,93
533,2562,6964,607,1955,606,833,430,693,257,1120,818,367,1898,664,805,775,462,520,388,1205,3084,1551,736,41,0,0,41
534,1992,5006,1178,814,555,656,339,442,349,727,646,270,1627,365,582,284,408,718,252,664,1871,1288,931,36,22,0,14
535,2028,5010,754,1274,655,606,298,469,330,739,712,247,1555,473,503,493,518,514,261,753,2095,1304,597,0,0,0,0
536,1802,5166,389,1413,409,507,297,589,115,666,640,381,1172,630,367,570,352,513,320,1083,2372,1067,324,0,0,0,0
537,3265,7094,681,2584,1093,1227,444,501,220,1947,899,199,2761,504,662,654,816,1133,378,783,4065,1355,513,80,0,0,80
538,1215,3488,405,810,394,382,198,241,108,579,438,90,1000,215,227,386,224,378,176,360,1697,943,312,622,0,0,622
539,391,1277,158,233,118,132,63,78,35,186,141,29,322,69,80,73,86,152,57,134,567,398,121,270,0,0,270
540,2525,5548,766,1759,831,924,389,381,332,1115,823,255,1864,661,554,679,576,716,235,691,2597,1326,699,15,0,0,15
541,2113,5275,1412,701,509,760,381,463,290,1091,554,178,1757,356,254,306,527,1026,255,749,1582,1631,1058,11,0,0,11
542,990,2466,392,598,273,333,152,232,61,481,387,61,723,267,95,254,257,384,117,364,972,686,327,20,0,0,20
543,1458,5758,552,906,401,476,265,316,189,621,596,52,1230,228,401,311,224,522,243,1427,3150,673,265,2243,2215,0,28
544,2228,5725,673,1555,600,755,362,511,251,975,712,290,1953,275,567,576,544,541,329,806,2799,1229,562,50,50,0,0
545,1356,4057,354,1002,518,410,216,212,191,547,536,82,1118,238,386,258,307,405,163,1019,1857,566,452,998,935,0,63
546,2059,4720,561,1498,677,733,282,367,105,947,905,102,1597,462,255,580,390,834,210,441,2722,963,384,15,0,0,15
547,2885,7969,961,1924,703,964,472,746,300,958,1318,309,2155,730,686,341,681,1177,426,1187,4105,1613,638,87,0,0,87
548,3317,8742,1253,2064,1024,1028,488,777,480,1551,877,409,2558,759,901,697,828,891,471,1185,3791,2095,1200,67,0,0,67
549,2422,5468,337,2085,1054,640,314,414,558,1196,414,254,2045,377,1166,736,257,263,234,734,2560,1256,684,96,0,0,96
550,1337,4088,522,815,325,380,247,385,92,475,573,197,975,362,358,282,360,337,214,633,1736,984,521,51,0,0,51
551,1887,6458,543,1344,353,485,355,694,279,743,588,277,1275,612,653,602,371,261,382,1344,2591,1524,617,273,0,0,273
552,1245,4392,461,784,199,292,246,508,140,551,436,118,776,469,443,448,159,195,248,986,1770,1013,375,0,0,0,0
553,1225,4710,564,661,190,255,250,530,156,505,348,216,796,429,386,282,178,379,271,986,1992,1050,411,116,0,0,116
554,1156,3734,510,646,304,381,226,245,148,409,497,102,890,266,406,130,220,400,134,419,1733,994,454,570,249,0,321
555,2722,7169,484,2238,847,776,447,652,187,1309,819,407,2281,441,998,772,480,472,390,1002,4094,1269,414,157,0,0,157
556,627,4957,22,605,229,177,84,137,87,235,200,105,521,106,398,174,44,11,63,3211,1398,207,78,3457,3445,0,12
557,1988,4002,382,1606,934,588,227,239,327,1169,350,142,1902,86,795,347,397,449,152,290,2434,726,400,142,0,0,142
558,2384,4669,513,1871,1113,808,206,257,342,1144,768,130,2210,174,661,295,429,999,176,373,2638,1004,478,184,0,0,184
559,1670,4852,1007,663,322,491,290,567,145,748,596,181,1152,518,282,402,316,670,272,868,1794,1322,596,7,0,0,7
560,1554,5155,296,1258,354,407,221,572,180,657,402,315,898,656,535,314,304,401,296,1025,2417,1084,333,231,0,0,231
561,1598,4379,401,1197,462,405,264,467,271,713,433,181,1073,525,622,513,286,177,248,781,1855,1080,415,11,0,0,11
562,1324,4585,500,824,251,277,204,592,185,314,533,292,832,492,451,358,235,280,248,993,1836,1088,420,36,0,0,36
563,4502,12764,1325,3177,1327,1137,649,1389,792,2062,1094,554,3062,1440,2128,1151,806,417,678,2500,4641,3382,1563,604,0,0,604
564,2980,8414,1031,1949,615,826,590,949,209,1455,1020,296,1864,1116,711,670,767,832,471,1673,3400,2016,854,32,0,0,32
565,2181,5785,1087,1094,529,709,385,558,354,920,698,209,1607,574,627,453,550,551,320,824,2365,1465,811,0,0,0,0
566,3484,9008,2575,909,778,1173,716,817,255,1775,1042,412,2435,1049,731,599,643,1511,679,1185,3932,2181,1031,19,0,0,19
567,2250,7671,1077,1173,376,458,433,983,229,797,712,512,1351,899,725,724,540,261,377,1580,2507,2085,1122,29,0,0,29
568,2267,8473,1190,1077,364,463,400,1040,444,842,669,312,1207,1060,830,581,395,461,471,1711,3204,2178,909,20,0,0,20
569,1046,4406,555,491,81,197,198,570,91,312,340,303,488,558,312,321,233,180,248,966,1655,1132,405,0,0,0,0
570,1107,4384,350,757,174,215,177,541,156,435,241,275,548,559,472,355,178,102,251,979,1675,1077,402,18,0,0,18
571,847,3830,582,265,65,173,126,483,38,251,256,302,499,348,169,154,241,283,185,774,1395,998,478,0,0,0,0
572,926,4104,562,364,66,144,181,535,86,195,317,328,480,446,155,279,231,261,207,805,1456,1084,552,0,0,0,0
573,1020,4114,777,243,80,240,183,517,163,283,370,204,594,426,194,248,221,357,176,682,1330,1232,694,46,0,0,46
574,1340,4769,790,550,208,291,252,589,112,525,326,377,707,633,416,515,294,115,240,826,1579,1473,651,79,0,0,79
575,982,4117,755,227,90,215,206,471,122,305,223,332,641,341,202,247,223,310,183,705,1361,1172,696,44,0,0,44
576,1147,4730,855,292,110,243,218,576,157,349,438,203,776,371,192,420,292,243,213,850,1541,1383,743,50,0,0,50
577,1079,4727,757,322,75,191,210,603,43,275,446,315,645,434,133,351,368,227,203,890,1664,1283,687,35,0,0,35
578,2305,8134,665,1640,355,494,450,1006,187,975,750,393,1543,762,612,737,605,351,459,1675,3380,1847,773,6,0,0,6
579,763,2417,207,556,191,224,126,222,237,190,195,141,584,179,372,217,84,90,97,363,797,648,512,163,0,0,163
580,1102,4407,259,843,122,233,189,558,129,276,391,306,495,607,356,367,296,83,237,1180,1624,1002,364,98,0,0,98
581,1172,4956,415,757,117,220,168,667,115,569,239,249,498,674,512,318,136,206,282,1161,1786,1192,535,16,0,0,16
582,1796,6395,927,869,250,421,360,765,186,586,601,423,1125,671,609,409,435,343,284,1190,2070,1747,1104,37,0,0,37
583,1526,6333,927,599,190,316,239,781,183,327,665,351,932,594,528,406,244,348,290,1113,2148,1672,1110,15,0,0,15
584,904,4231,660,244,67,141,180,516,106,155,263,380,465,439,232,213,203,256,199,795,1491,1166,580,8,0,0,8
585,962,4797,612,350,75,141,152,594,123,248,301,290,573,389,255,301,255,151,262,1001,1809,1204,521,3,0,0,3
586,1116,5888,755,361,75,125,172,744,31,278,229,578,586,530,171,247,334,364,310,1262,2205,1430,681,0,0,0,0
587,378,2062,233,145,39,51,53,235,21,63,92,202,151,227,57,102,105,114,106,464,763,494,235,5,0,0,5
588,1231,6160,682,549,64,189,213,765,124,183,434,490,547,684,185,443,290,313,306,1388,2213,1562,691,39,0,0,39
589,1378,5908,623,755,169,261,231,717,110,412,386,470,780,598,404,404,283,287,326,1167,2140,1508,767,22,0,0,22
590,864,3927,376,488,47,134,150,533,75,218,238,333,419,445,269,304,156,135,230,942,1406,968,381,0,0,0,0
591,2140,8468,678,1462,313,365,389,1073,309,534,668,629,1018,1122,788,564,417,371,492,2048,3033,1886,1009,148,0,0,148
592,1291,4735,563,728,208,294,201,588,131,415,362,383,630,661,405,368,273,245,269,998,1747,1117,604,20,0,0,20
593,875,2993,284,591,129,216,155,375,67,264,307,237,445,430,215,259,173,228,190,588,1154,729,332,8,0,0,8
594,1392,5406,727,665,181,263,247,701,139,347,564,342,823,569,351,429,340,272,282,1135,1972,1433,584,67,0,0,67
595,2441,7042,577,1864,560,605,388,888,491,852,668,430,1642,799,1019,735,478,209,388,1355,2399,1591,1309,0,0,0,0
596,739,2686,403,336,99,176,132,332,83,229,204,223,530,209,221,155,195,168,101,425,921,762,477,24,0,0,24
597,2312,6878,640,1672,471,664,469,708,500,829,779,204,1621,691,1134,408,179,591,358,1197,2739,1541,1043,70,0,0,70
598,2362,7917,1558,804,316,616,472,958,356,678,971,357,1463,899,337,405,450,1170,506,1224,3199,1932,1056,58,0,0,58
599,1385,4902,991,394,158,316,302,609,132,368,517,368,821,564,154,265,317,649,242,759,1763,1378,760,17,0,0,17
600,1224,4312,892,332,130,348,243,503,128,247,540,309,787,437,106,262,362,494,205,580,1505,1196,826,26,0,0,26
601,2805,8308,1743,1062,422,837,706,840,282,1110,1177,236,2100,705,338,431,746,1290,516,1020,3588,2202,982,133,0,0,133
602,677,2342,551,126,89,183,155,250,60,236,213,168,369,308,130,269,151,127,91,383,756,792,320,145,0,0,145
603,308,897,213,95,60,94,75,79,27,108,97,76,168,140,48,39,38,183,42,99,359,296,101,66,0,0,66
604,1144,4188,886,258,167,283,237,457,102,398,361,283,624,520,302,200,323,319,205,726,1661,1186,410,253,0,0,253
605,3846,11190,1531,2315,604,1209,906,1127,279,1894,1112,561,2324,1522,473,629,1071,1673,710,1687,5261,2488,1044,46,0,0,46
606,3898,11257,1912,1986,565,1294,962,1077,245,1398,1740,515,2716,1182,320,463,860,2255,978,1377,6392,1759,751,15,0,0,15
607,2193,6441,1064,1129,318,562,591,722,137,913,861,282,1258,935,132,381,751,929,420,956,3291,1306,468,18,0,0,18
608,2105,5600,813,1292,330,731,536,508,160,883,972,90,1406,699,136,257,654,1058,548,730,3354,760,208,44,0,0,44
609,1531,5146,1244,287,154,384,340,653,262,412,587,270,941,590,295,237,315,684,203,891,1591,1502,959,0,0,0,0
610,657,1819,375,282,163,152,122,220,189,152,260,56,441,216,232,61,88,276,103,323,598,439,356,0,0,0,0
611,1678,5973,1066,612,202,389,353,734,166,531,586,395,922,756,265,321,381,711,316,1121,2023,1576,937,33,0,0,33
612,2331,7046,1204,1127,369,551,553,858,171,738,953,469,1368,963,433,332,596,970,456,1309,2779,1666,836,1,0,0,1
613,1007,3680,635,372,137,206,203,461,113,298,407,189,546,461,252,228,214,313,163,670,1210,1008,629,0,0,0,0
614,1328,4804,1047,281,117,315,260,636,135,377,559,257,727,601,226,206,205,691,234,924,1494,1397,755,4,0,0,4
615,1353,4526,964,389,102,373,330,548,192,369,469,323,907,446,271,274,228,580,155,763,1382,1393,833,20,0,0,20
616,1252,4701,675,577,120,243,274,615,64,414,357,417,693,559,157,353,365,377,275,904,1720,1246,556,0,0,0,0
617,1296,4852,637,659,139,271,278,608,140,402,448,306,787,509,286,280,384,346,256,968,1758,1300,570,3,0,0,3
618,743,2650,588,155,67,202,166,308,96,248,229,170,477,266,93,133,155,362,150,434,840,740,486,7,0,0,7
619,1513,5218,1245,268,159,325,359,670,254,410,532,317,928,585,295,228,242,748,285,978,1596,1511,848,16,0,0,16
620,1071,3758,747,324,126,177,246,522,89,364,456,162,552,519,151,148,209,563,224,760,1245,1013,516,11,0,0,11
621,1206,4282,715,491,173,298,265,470,144,345,405,312,934,272,278,136,383,409,222,719,1442,1225,674,28,0,0,28
622,1507,5350,1117,390,170,373,323,641,194,352,387,574,991,516,265,204,383,655,273,911,1829,1512,825,22,0,0,22
623,2051,7073,1513,538,216,440,457,938,231,443,831,546,1297,754,207,322,592,930,358,1325,2321,2062,1007,12,0,0,12
624,840,2866,689,151,91,213,169,367,122,268,278,172,567,273,126,106,219,389,163,413,921,804,565,38,0,0,38
625,1597,5419,999,598,215,420,356,606,147,555,554,341,1039,558,240,323,329,705,289,880,2079,1391,780,31,0,0,31
626,1202,4368,900,302,88,257,268,589,197,226,462,317,760,442,161,202,253,586,159,862,1375,1324,648,8,0,0,8
627,1739,5722,1209,530,231,449,369,690,177,764,595,203,1091,648,218,315,509,697,255,1046,1865,1674,882,56,0,0,56
628,1472,4603,1171,301,216,428,285,543,346,403,420,303,948,524,287,165,279,741,171,786,1298,1400,948,16,0,0,16
629,1658,5188,1277,381,276,541,292,549,202,302,738,416,1003,655,157,271,403,827,268,871,1618,1505,926,70,0,0,70
630,2265,8089,1374,891,302,533,391,1039,250,686,844,485,1516,749,418,575,637,635,429,1474,2786,2150,1250,39,0,0,39
631,1341,4617,880,461,136,370,276,559,158,355,497,331,702,639,186,237,351,567,251,812,1576,1248,730,5,0,0,5
632,1743,5700,1148,595,286,445,335,677,323,542,451,427,1246,497,502,368,418,455,292,873,2176,1441,918,49,0,0,49
633,2484,9312,1279,1205,321,511,423,1229,265,698,733,788,1341,1143,564,726,623,571,521,1983,3287,2326,1195,47,0,0,47
634,1536,6022,760,776,219,302,258,757,216,551,324,445,1094,442,561,429,285,261,337,1324,2231,1501,629,36,0,0,36
635,1052,4182,681,371,131,256,184,481,126,245,307,374,715,337,261,246,289,256,252,827,1532,1049,522,9,0,0,9
636,1347,5853,923,424,139,263,240,705,221,340,278,508,742,605,358,327,321,341,310,1210,2103,1570,660,25,0,0,25
637,1559,5085,1341,218,204,535,271,549,181,400,618,360,1039,520,79,308,403,769,224,759,1535,1531,1036,21,0,0,21
638,1290,6136,844,446,76,202,220,792,135,274,387,494,681,609,297,265,432,296,366,1318,2278,1493,681,24,0,0,24
639,1344,5921,792,552,104,217,232,791,109,367,493,375,685,659,294,438,331,281,361,1289,2200,1451,620,22,0,0,22
640,816,3622,603,213,50,138,142,486,91,237,231,257,486,330,122,272,181,241,155,642,1289,990,546,0,0,0,0
641,863,3897,625,238,65,136,166,496,84,222,177,380,434,429,153,206,235,269,215,768,1432,1021,461,0,0,0,0
642,1017,3464,799,218,148,275,194,400,108,484,314,111,729,288,93,184,254,486,158,560,1152,972,622,0,0,0,0
643,1047,4310,811,236,92,227,204,524,90,350,316,291,655,392,188,304,284,271,207,788,1376,1270,669,53,0,0,53
644,1059,4571,896,163,65,189,201,604,121,339,297,302,735,324,98,210,300,451,207,670,1531,1282,881,39,0,0,39
645,1208,4712,978,230,114,212,249,633,107,414,383,304,754,454,191,251,281,485,212,941,1481,1367,711,42,0,0,42
646,894,3577,730,164,54,196,158,486,93,272,333,196,550,344,120,182,203,389,149,730,1087,1018,593,12,0,0,12
647,1274,4600,1107,167,95,305,278,596,147,250,622,255,617,657,180,132,250,712,132,931,1310,1342,885,0,0,0,0
648,1704,6625,1481,223,70,282,326,1026,244,477,620,363,880,824,184,220,415,885,240,1615,1746,2239,785,0,0,0,0
649,1137,4449,868,269,90,185,252,610,107,335,382,313,651,486,131,188,302,516,169,933,1384,1325,638,34,11,0,23
650,1983,7722,1196,787,173,354,388,1068,146,486,782,569,1144,839,279,351,630,723,336,1486,2790,2140,970,19,0,0,19
651,1773,7149,1364,409,169,300,334,970,152,459,652,510,1046,727,356,366,524,527,307,1290,2425,2085,1042,71,0,0,71
652,1429,4951,1049,380,243,261,244,681,270,444,519,196,823,606,248,295,256,630,226,894,1543,1261,1027,24,0,0,24
653,3065,11272,2697,368,132,479,669,1785,130,1047,1625,263,1395,1670,86,249,344,2386,372,2981,2993,3766,1160,20,0,0,20
654,3905,8708,3418,487,1234,1505,392,774,1546,1043,890,426,3277,628,981,741,799,1384,176,1062,1287,2384,3799,8,0,0,8
655,3939,13473,3473,466,297,951,824,1867,341,1269,1759,570,2228,1711,258,375,699,2607,525,3013,3669,4558,1708,31,0,0,31
656,2030,6914,1704,326,186,509,445,890,107,556,1054,313,1245,785,188,280,498,1064,337,1492,2148,2092,845,32,0,0,32
657,2490,8199,1779,711,348,609,541,992,219,779,890,602,1380,1110,589,520,713,668,441,1474,3043,2341,900,61,0,0,61
658,1349,4186,1064,285,196,367,283,503,232,235,652,230,801,548,234,141,293,681,246,825,1265,1157,693,0,0,0,0
659,1038,3179,814,224,148,318,188,384,77,427,473,61,609,429,174,163,211,490,169,574,1113,906,417,16,0,0,16
660,1086,3487,879,207,149,328,192,417,212,290,474,110,670,416,233,119,308,426,186,652,1158,972,519,17,0,0,17
661,4495,12361,1983,2512,917,1362,983,1233,446,2056,1532,461,2739,1756,781,1080,1165,1469,988,2096,5438,2702,1137,59,0,0,59
662,1376,4447,1097,279,150,387,291,548,180,457,552,187,756,620,77,303,290,706,243,924,1395,1247,638,24,0,0,24
663,963,3096,827,136,99,293,197,374,157,287,400,119,558,405,107,154,218,484,192,602,927,900,475,0,0,0,0
664,2646,7626,1283,1363,498,712,580,856,141,1075,1216,214,1740,906,296,517,803,1030,433,1480,2799,2090,824,38,0,0,38
665,2432,7375,1874,558,449,709,485,789,271,793,923,445,1579,853,312,377,650,1093,476,1227,2576,2069,1027,58,0,0,58
666,1869,5873,1123,746,340,511,349,669,240,653,723,253,1220,649,532,568,502,267,303,1052,2115,1539,864,46,0,0,46
667,1921,5655,947,974,372,473,416,660,158,806,754,203,1140,781,318,709,564,330,352,1177,2347,1313,466,6,0,0,6
668,2042,6283,1647,395,357,598,390,697,172,736,782,352,1213,829,230,382,628,802,301,1027,2186,1848,921,29,0,0,29
669,2462,8999,1058,1404,352,473,481,1156,303,799,905,455,1354,1108,915,727,396,424,575,2073,3153,2252,946,43,0,0,43
670,2158,7849,1354,804,267,543,361,987,250,649,573,686,1398,760,548,386,558,666,412,1648,2637,2088,1064,28,0,0,28
671,2667,7464,499,2168,580,850,495,742,159,1066,1021,421,1790,877,386,938,660,683,489,1138,3635,1567,635,51,0,0,51
672,1466,4544,877,589,225,443,316,482,236,512,593,125,1066,400,248,349,413,456,248,754,1805,1100,637,46,0,0,46
673,1420,4212,994,426,242,400,287,491,137,448,615,220,998,422,251,330,346,493,231,746,1537,1136,562,3,0,0,3
674,1785,5548,1450,335,234,521,352,678,266,555,634,330,1040,745,222,351,384,828,285,1018,1781,1568,896,37,0,0,37
675,1674,5245,1294,380,243,501,360,570,210,428,627,409,1102,572,179,277,420,798,272,915,1708,1482,868,46,0,0,46
676,3044,8311,1634,1410,647,997,587,813,292,1214,1045,493,2001,1043,406,782,847,1009,438,1397,2991,2236,1249,64,0,0,64
677,1622,4356,633,989,438,456,261,467,264,511,616,231,1157,465,351,412,342,517,241,737,1691,1000,687,16,0,0,16
678,968,2949,762,206,185,278,155,350,190,240,374,164,652,316,131,137,146,554,148,494,858,815,634,32,0,0,32
679,1638,4698,890,748,303,491,357,487,204,632,677,125,1151,487,331,315,404,588,243,886,1620,1280,669,44,0,0,44
680,2181,6590,1690,491,302,676,475,728,294,643,1019,225,1361,820,298,339,460,1084,363,1183,2049,1866,1129,26,0,0,26
681,1246,3489,856,390,222,420,213,391,232,362,465,187,816,430,136,352,289,469,205,597,1021,967,699,43,0,0,43
682,1773,5218,1460,313,286,539,360,588,233,767,601,172,1186,587,224,238,472,839,312,973,1579,1526,828,20,0,0,20
683,1308,3849,1092,216,191,412,284,421,192,569,441,106,841,467,208,250,235,615,208,767,1126,1115,633,52,0,0,52
684,2365,6951,1667,698,390,640,476,859,310,801,997,257,1372,993,589,391,451,934,423,1524,2193,1942,869,13,0,0,13
685,1655,4848,989,666,295,411,387,562,156,619,694,186,935,720,297,405,350,603,289,1076,1656,1270,557,9,0,0,9
686,2017,5324,1047,970,506,573,384,554,308,775,783,151,1365,652,464,479,552,522,329,989,1902,1333,771,0,0,0,0
687,1482,3908,666,816,370,444,284,384,206,483,613,180,1038,444,252,372,293,565,223,745,1330,1064,546,2,0,0,2
688,2826,8234,1573,1253,539,703,511,1073,407,1199,970,250,1539,1287,634,509,539,1144,468,1859,2516,2219,1172,48,0,0,48
689,1413,4285,1300,113,169,431,275,538,175,396,592,250,791,622,104,175,147,987,178,992,963,1317,835,0,0,0,0
690,2006,5827,1737,269,276,640,414,676,400,492,819,295,1207,799,223,180,313,1290,261,1228,1316,1750,1272,23,0,0,23
691,1070,3187,990,80,136,351,209,374,196,311,451,112,769,301,109,91,140,730,85,752,603,1100,647,0,0,0,0
692,1119,3422,929,190,145,307,233,434,157,419,443,100,660,459,106,154,124,735,123,853,756,1090,600,0,0,0,0
693,1398,4267,1193,205,180,351,295,572,149,463,650,136,737,661,111,166,176,945,160,1012,961,1395,739,2,0,0,2
694,1732,5348,1526,206,157,522,364,689,172,694,678,188,922,810,190,123,242,1177,136,1282,1103,1867,960,13,0,0,13
695,2692,8378,2427,265,223,818,581,1070,427,1103,983,179,1693,999,279,233,471,1709,263,1875,1805,2851,1584,0,0,0,0
696,2074,5377,1496,578,461,697,359,557,308,900,689,177,1526,548,328,376,493,877,194,914,1439,1781,1049,34,0,0,34
697,504,1795,306,198,92,119,88,205,48,289,129,38,312,192,109,175,69,151,90,359,542,480,324,30,0,0,30
698,2814,8951,2466,348,329,857,522,1106,326,1185,892,411,1627,1187,192,450,497,1675,481,1985,2344,2762,1379,13,0,0,13
699,1709,4983,1434,275,235,581,368,525,237,469,688,315,1166,543,142,242,447,878,226,959,1313,1543,942,0,0,0,0
700,4488,12975,2916,1572,966,1203,809,1510,543,1815,1643,487,2574,1914,857,1032,978,1621,753,2739,4142,3563,1778,25,0,0,25
701,2472,6841,1937,535,465,836,423,748,492,1077,740,163,1529,943,399,593,538,942,357,1286,1844,1959,1395,18,0,0,18
702,3427,10962,1773,1654,593,930,612,1292,323,1483,1201,420,2008,1419,649,1062,699,1017,758,2439,3808,2656,1301,347,0,0,347
703,1546,4783,1291,255,174,534,279,559,189,563,487,307,949,597,113,185,350,898,220,884,1264,1523,892,20,0,0,20
704,1648,4790,1383,265,233,638,224,553,241,673,460,274,1103,545,85,285,303,975,200,806,1188,1537,1059,0,0,0,0
705,4492,14260,3173,1319,756,1188,835,1713,637,1493,1736,626,2459,2033,896,967,1034,1595,923,3042,4563,3601,2131,62,0,0,62
706,1086,3531,592,494,222,315,157,392,163,478,259,186,798,288,230,241,250,365,165,712,1095,1023,536,55,0,0,55
707,2622,10141,753,1869,380,486,439,1317,174,1019,778,651,1292,1330,752,876,589,405,766,2624,3783,2092,876,231,0,0,231
708,2597,8174,1411,1186,543,653,447,954,479,948,711,459,1581,1016,751,621,645,580,474,1837,2579,1990,1294,3,0,0,3
709,2101,7537,1054,1047,250,437,405,1009,210,872,697,322,1073,1028,636,455,571,439,527,1949,2708,1736,617,27,0,0,27
710,2229,7643,1222,1007,298,520,414,997,210,736,922,361,1121,1108,370,667,644,548,424,1833,2616,1986,784,23,0,0,23
711,2945,9764,2575,370,288,857,555,1245,328,1382,802,433,1680,1265,247,417,1150,1131,503,2314,2707,2960,1280,2,0,0,2
712,1407,4804,1012,395,226,464,247,470,255,518,447,187,998,409,234,272,294,607,216,838,1417,1379,954,180,0,0,180
713,1528,5136,1126,402,218,519,228,563,233,540,606,149,993,535,276,346,374,532,220,927,1431,1549,1009,46,0,0,46
714,328,922,193,135,60,123,50,95,33,121,117,57,219,109,31,118,70,109,46,147,247,286,196,37,0,0,37
715,2803,8440,2083,720,415,797,579,1012,240,992,1256,315,1337,1466,295,421,595,1492,484,1799,2707,2516,934,7,0,0,7
716,1844,4934,1248,596,409,636,290,509,264,615,800,165,1289,555,408,269,366,801,233,890,1411,1474,926,39,0,0,39
717,2331,6611,1587,744,487,744,434,666,272,715,1072,272,1453,878,454,328,560,989,416,1242,2207,1806,940,145,0,0,145
718,2762,7866,1968,794,496,913,531,822,203,978,1102,479,1682,1080,215,549,761,1237,403,1554,2469,2318,1122,125,0,0,125
719,2704,7271,1921,783,601,804,515,784,316,1165,970,253,1783,921,605,716,761,622,480,1294,2581,2112,804,14,0,0,14
720,2092,5815,1753,339,352,695,462,583,176,819,921,176,1518,574,254,268,623,947,446,905,2264,1614,586,6,0,0,6
721,2306,6053,1448,858,509,795,425,577,295,845,875,291,1571,735,503,633,472,698,338,959,2066,1780,910,88,0,0,88
722,2824,8422,1450,1374,595,811,528,890,317,730,1213,564,1802,1022,586,815,697,726,557,1659,3303,2006,897,41,0,0,41
723,1908,5003,1346,562,378,725,302,503,119,775,883,131,1175,733,146,369,374,1019,213,932,1330,1685,843,65,0,0,65
724,2726,6479,1582,1144,904,877,388,557,396,1055,844,431,1909,817,397,597,628,1104,310,1001,1921,1606,1641,156,0,0,156
725,1351,3955,1296,55,118,539,242,452,146,472,482,251,871,480,89,105,253,904,115,831,748,1421,840,29,0,0,29
726,2967,8524,2317,650,435,952,552,1028,313,1082,1169,403,2007,960,448,518,719,1282,480,1768,2449,2413,1414,10,0,0,10
727,1101,3270,863,238,199,278,225,399,120,331,525,125,718,383,115,158,304,524,189,739,1069,842,431,17,0,0,17
728,2410,6768,1935,475,401,841,472,696,290,651,1175,294,1629,781,333,686,535,856,352,1211,2152,2048,1005,36,0,0,36
729,8853,29047,6912,1941,935,1609,2002,4307,375,3185,4356,937,3662,5191,625,657,1508,6063,2211,7735,10466,6576,2059,0,0,0,0
730,4444,12189,1703,2741,922,1294,927,1301,216,1829,2012,387,2275,2169,560,702,1081,2101,744,1956,6317,2689,483,242,0,210,32
731,2742,6456,820,1922,788,925,491,538,262,1536,847,97,1920,822,511,858,718,655,413,1126,2959,1417,541,0,0,0,0
732,1920,5621,1204,716,318,556,384,662,166,719,922,113,1224,696,180,552,559,629,351,1138,2111,1410,611,36,0,0,36
733,2745,7623,1522,1223,550,867,535,793,251,1163,1101,230,1760,985,407,623,543,1172,496,1406,3058,1791,872,46,0,0,46
734,3108,9007,2603,505,486,924,617,1081,346,1006,1312,444,1945,1163,217,504,648,1739,535,1769,2660,2710,1333,15,0,0,15
735,1285,3498,1076,209,222,403,247,413,157,576,487,65,831,454,123,163,207,792,128,615,856,1208,691,0,0,0,0
736,3173,9010,2288,885,506,991,651,1025,310,1153,1382,328,1987,1186,286,555,779,1553,360,1932,2567,2747,1404,113,0,0,113
737,1543,4905,1315,228,173,388,307,675,108,406,901,128,798,745,201,225,242,875,266,1234,1372,1342,691,21,0,0,21
738,2067,6026,1767,300,266,675,426,700,224,630,1075,138,1168,899,196,259,364,1248,187,1379,1441,1986,1033,13,0,0,13
739,2494,6304,785,1709,814,731,378,571,338,936,1008,212,1793,701,769,519,353,853,290,1221,2222,1758,813,356,0,0,356
740,1383,3914,1091,292,249,394,256,484,170,621,479,113,694,689,101,208,355,719,178,911,1014,1146,665,7,0,0,7
741,1678,4921,1275,403,213,542,337,586,230,554,677,217,1020,658,167,232,479,800,169,1159,1226,1559,808,23,0,0,23
742,5553,14838,2201,3352,1262,1542,1130,1619,595,2460,1989,509,3276,2277,791,952,1332,2478,941,3121,5725,2992,2059,73,0,0,73
743,3405,9612,2431,974,643,890,656,1216,486,1132,1548,239,2016,1389,563,432,613,1797,367,2288,2450,3037,1470,31,0,0,31
744,1909,5126,1023,886,413,601,349,546,223,708,823,155,1249,660,444,262,348,855,258,1085,1480,1387,916,10,0,0,10
745,2158,5450,1512,646,504,711,391,552,301,920,800,137,1463,695,359,365,449,985,223,1116,1427,1672,1012,0,0,0,0
746,2664,8242,2338,326,245,872,489,1058,211,1172,1003,278,1596,1068,183,328,378,1775,241,1878,1805,2993,1325,51,0,0,51
747,1160,3553,1106,54,83,419,249,409,178,327,561,94,744,416,141,109,123,787,79,584,809,1266,815,0,0,0,0
748,1201,4134,1019,182,91,235,259,616,143,360,605,93,533,668,127,87,217,770,148,1046,1156,1236,548,14,0,0,14
749,2125,6702,1275,850,260,405,513,947,231,912,866,116,972,1153,222,421,490,992,418,1680,2358,1588,658,0,0,0,0
750,693,2222,472,221,73,131,175,314,59,232,356,46,234,459,123,56,152,362,137,638,773,469,205,19,0,0,19
751,13,43,10,3,1,2,4,6,1,4,7,1,4,9,1,1,3,8,3,13,15,10,2,0,0,0,0
752,548,1664,273,275,87,141,143,177,43,315,175,15,278,270,54,75,119,300,173,267,855,289,80,166,0,0,166
753,1473,4942,1307,166,108,340,331,694,199,564,595,115,819,654,103,147,286,937,129,1177,1269,1505,862,12,0,0,12
754,1211,3984,1090,121,64,364,273,510,186,444,328,253,866,345,99,83,232,797,77,717,961,1411,818,76,0,0,76
755,3346,10754,2518,828,282,747,788,1529,366,1139,1475,366,1957,1389,387,427,565,1967,346,2537,2892,3490,1489,1,0,0,1
756,2159,7276,1759,400,184,465,451,1059,166,586,1178,229,1056,1103,189,209,395,1366,249,1742,1906,2375,1004,24,0,0,24
757,797,2888,590,207,80,174,155,388,54,338,329,76,393,404,160,123,236,278,151,602,966,795,374,30,0,0,30
758,1923,6650,1410,513,180,447,416,880,180,799,638,306,1006,917,408,413,325,777,355,1446,2140,1886,823,20,0,0,20
759,2353,7661,1580,773,285,616,571,881,151,904,1016,282,1120,1233,173,309,783,1088,553,1355,2933,1853,967,27,0,0,27
760,1944,6334,1273,671,233,563,431,717,224,693,693,334,1211,733,335,421,506,682,371,1068,2438,1677,780,22,0,0,22
761,3779,11463,1458,2321,700,935,795,1349,467,1338,1626,348,1979,1800,781,678,895,1425,653,2374,4367,2847,1222,191,0,0,191
762,1240,3698,417,823,236,366,277,361,83,463,447,247,841,399,52,240,404,544,272,476,1747,820,383,19,0,0,19
763,2937,8014,645,2292,644,732,695,866,460,1377,842,258,1870,1067,562,761,817,797,728,1274,3804,1338,870,35,0,0,35
764,2210,7404,1271,939,254,594,484,878,194,833,628,555,1479,731,261,769,489,691,455,1243,2736,1876,1094,36,0,0,36
765,940,2959,696,244,136,246,229,329,85,261,423,171,512,428,89,156,272,423,174,479,1049,764,493,33,0,0,33
766,1053,3141,782,271,155,272,265,361,143,379,451,80,636,417,109,102,312,530,199,579,1031,859,473,22,0,0,22
767,3646,10860,2879,767,504,1087,814,1241,329,1020,1688,609,2282,1364,329,594,793,1930,808,1596,4419,2648,1389,14,0,0,14
768,3379,10824,2214,1165,420,944,702,1313,306,886,1654,533,2104,1275,388,518,732,1741,800,1765,4539,2507,1213,74,0,0,74
769,4241,13457,2580,1661,454,798,1097,1892,338,1477,2141,285,1684,2557,201,371,933,2736,1029,3197,5303,3015,913,69,0,0,69
770,1932,6455,1403,529,256,480,407,789,123,677,726,406,1359,573,263,380,475,814,345,1074,2304,1826,906,11,0,0,11
771,2567,7703,2010,557,416,821,493,837,423,852,937,355,1845,722,545,366,704,952,493,1120,2469,2033,1588,21,0,0,21
772,1466,5252,811,655,212,348,276,630,176,345,602,343,803,663,260,464,471,271,332,895,2159,1296,570,137,0,0,137
773,1958,6444,869,1089,301,468,410,779,216,644,773,325,1131,827,260,424,584,690,402,1221,2583,1575,663,32,0,0,32
774,3099,9773,1418,1681,649,817,656,977,355,1485,1152,107,2149,950,722,826,629,922,618,1703,3951,2421,1080,870,0,0,870
775,2973,9181,1757,1216,393,820,637,1123,422,1315,917,319,1910,1063,646,534,637,1156,585,1784,3236,2408,1168,36,0,0,36
776,2379,7264,1397,982,366,598,522,893,324,1027,856,172,1443,936,444,392,587,956,466,1503,2741,1672,882,41,0,0,41
777,2395,6098,202,2193,605,664,575,551,344,1206,811,34,1460,935,402,558,737,698,570,891,3087,857,693,0,0,0,0
778,5551,14460,2027,3524,1003,1874,1342,1332,622,2615,1960,354,3779,1772,927,911,1477,2236,1259,2025,7353,2561,1262,26,0,0,26
779,1655,5260,1348,307,179,382,358,736,146,431,886,192,954,701,114,185,314,1042,134,1249,1340,1675,862,0,0,0,0
780,1043,3241,944,99,83,307,240,413,195,308,422,118,678,365,175,96,208,564,80,612,805,1145,599,19,0,0,19
781,1583,4436,1182,401,329,503,280,471,356,542,518,167,1174,409,397,221,295,670,195,721,1229,1276,1015,11,0,0,11
782,2526,7206,1597,929,462,776,501,787,274,1117,991,144,1451,1075,255,614,660,997,387,1371,2516,1924,1008,50,0,0,50
783,1053,2921,504,549,151,359,227,316,97,427,471,58,726,327,141,150,295,467,166,545,1161,662,387,0,0,0,0
784,1843,5701,1257,586,251,485,385,722,299,489,864,191,1053,790,241,242,290,1070,307,1130,1912,1425,927,11,0,0,11
785,2248,7238,1228,1020,332,573,511,832,263,706,1021,258,1281,967,534,505,448,761,449,1466,2723,1724,876,91,0,0,91
786,1418,4616,1087,331,174,401,275,568,189,609,417,203,963,455,192,187,348,691,248,874,1503,1302,689,21,0,0,21
787,2352,7319,1478,874,301,584,537,930,312,957,838,245,1137,1215,341,232,621,1158,469,1475,2603,1776,996,18,0,0,18
788,1810,5897,1414,396,235,415,385,775,212,587,691,320,988,822,266,239,275,1030,246,1237,1814,1581,1019,18,0,0,18
789,1394,4720,1071,323,146,304,310,634,195,356,654,189,663,731,195,234,311,654,261,944,1607,1183,725,8,0,0,8
790,1913,6464,1589,324,175,460,408,870,242,686,749,236,1279,634,230,257,432,994,286,1074,2044,1842,1218,33,0,0,33
791,1028,3971,665,363,68,211,222,527,135,276,337,280,678,350,108,413,204,303,201,770,1370,1094,536,21,0,0,21
792,871,3181,707,164,91,192,161,427,99,335,292,145,493,378,111,159,230,371,162,498,1045,795,681,60,0,0,60
793,1387,4895,893,494,135,329,308,615,235,240,593,319,917,470,222,349,322,494,268,891,1665,1239,832,20,0,0,20
794,863,3034,758,105,46,218,185,414,78,201,438,146,511,352,77,141,191,454,141,485,1038,949,421,0,0,0,0
795,886,3148,407,479,101,172,182,431,71,246,279,290,535,351,95,268,290,233,160,643,1133,831,381,21,0,0,21
796,1943,7018,1544,399,194,495,430,824,313,542,691,397,1217,726,292,442,572,637,379,1043,2292,1947,1357,81,0,0,81
797,2200,7185,1573,627,295,592,447,866,293,923,670,314,1370,830,485,519,352,844,352,1272,2450,2034,1077,34,0,0,34
798,1662,4459,1228,434,332,598,295,437,340,655,486,181,1274,388,430,409,277,546,165,567,1382,1202,1143,17,0,0,17
799,1709,5293,1239,470,190,450,420,649,292,570,685,162,1049,660,143,293,366,907,289,1002,1691,1437,874,14,0,0,14
800,1841,5739,965,876,374,561,306,600,417,628,429,367,1382,459,532,410,424,475,309,785,2038,1345,1262,183,0,0,183
801,3971,11620,1913,2058,677,1304,770,1220,336,1631,1588,416,2741,1230,473,655,1059,1784,629,1697,5102,2815,1377,118,0,0,118
802,1476,5803,774,702,142,292,291,751,146,519,443,368,812,664,227,441,484,324,332,1232,2189,1415,635,22,0,0,22
803,1083,2583,419,664,369,336,129,249,424,336,245,78,823,260,274,253,250,306,144,340,799,483,817,0,0,0,0
804,1138,3594,766,372,193,299,198,448,168,380,367,223,746,392,148,396,285,309,188,619,1267,972,548,31,0,0,31
805,2108,7622,1542,566,263,488,390,967,209,490,818,591,1209,899,231,440,622,815,418,1428,2737,2065,974,13,0,0,13
806,3154,10140,2427,727,552,852,612,1138,568,995,1024,567,2373,781,709,915,731,799,452,1411,3197,2947,2133,166,0,0,166
807,1239,4752,994,245,150,263,226,600,200,302,461,276,683,556,308,336,344,251,229,932,1631,1278,682,13,0,0,13
808,912,3865,681,231,84,180,176,472,83,204,331,294,461,451,123,252,297,240,214,699,1367,1030,555,26,0,0,26
809,734,2460,606,128,79,166,123,366,118,170,295,151,510,224,115,289,231,99,133,347,840,680,460,18,0,0,18
810,3597,12063,2480,1117,570,841,661,1525,454,1163,1063,917,2525,1072,901,980,598,1118,689,1980,4414,3175,1805,51,0,0,51
811,2879,8513,1724,1155,569,885,555,870,437,927,1031,484,1942,937,660,849,678,692,534,1145,3263,2086,1485,75,0,0,75
812,1244,3724,899,345,278,329,185,452,223,439,423,159,903,341,303,292,340,309,140,608,1286,1087,603,46,0,0,46
813,945,3356,507,438,122,209,175,439,121,404,205,215,647,298,426,192,178,149,189,674,1203,863,427,40,0,0,40
814,935,3508,759,176,123,199,188,425,178,268,234,255,606,329,197,319,227,192,182,674,1246,911,495,17,0,0,17
815,1194,4722,309,885,98,189,233,674,206,549,279,160,619,575,448,304,274,168,295,1256,1800,991,380,23,0,0,23
816,937,3269,534,403,160,189,177,411,165,266,274,232,588,349,198,276,282,181,168,578,1114,827,582,23,0,0,23
817,2156,8395,260,1896,208,400,379,1169,226,724,625,581,1040,1116,646,863,449,198,622,2215,3471,1595,492,79,0,0,79
818,1381,4781,971,410,182,320,258,621,201,289,328,563,953,428,201,347,334,499,264,842,1771,1239,665,0,0,0,0
819,705,2426,298,407,110,179,113,303,125,285,171,124,416,289,243,194,149,119,145,430,1031,594,226,18,0,0,18
820,5075,14790,2991,2084,861,1644,950,1620,618,1580,2269,608,3347,1728,725,949,1189,2212,824,2583,5518,4052,1813,67,0,0,67
821,1430,5003,1055,375,307,508,245,370,200,452,605,173,1040,390,198,304,460,468,161,1195,1876,1045,726,1111,1084,0,27
822,1367,3977,1138,229,238,513,247,369,246,561,377,183,989,378,58,261,503,545,177,516,1195,1154,935,204,175,0,29
823,2832,7628,1557,1275,696,897,511,728,369,1044,1101,318,2170,662,747,473,815,797,471,1165,2931,1907,1154,64,0,0,64
824,1912,5629,599,1313,402,619,317,574,162,873,677,200,1234,678,526,684,419,283,363,946,2852,1067,401,168,149,0,19
825,1879,6694,673,1206,276,405,390,808,292,571,688,328,1210,669,621,579,378,301,422,1472,2692,1463,645,31,0,0,31
826,1832,5402,500,1332,419,477,334,602,235,650,725,222,1020,812,536,559,529,208,363,1063,2267,1194,515,38,0,0,38
827,1360,4312,638,722,247,345,310,458,135,567,242,416,835,525,228,460,336,336,265,788,1765,1016,478,8,0,0,8
828,3082,9676,1291,1791,527,871,608,1076,346,1282,1150,304,1960,1122,584,930,673,895,637,1781,4241,2102,915,31,0,0,31
829,1117,3718,643,474,198,278,199,442,155,502,309,151,651,466,336,265,305,211,221,714,1462,893,428,20,0,0,20
830,1927,7099,799,1128,273,366,319,969,208,711,607,401,1031,896,718,388,492,329,446,1633,2679,1671,670,0,0,0,0
831,1277,4078,190,1087,309,258,224,486,193,467,330,287,827,450,436,448,246,147,245,918,1430,982,503,90,0,0,90
832,1789,5771,1047,742,323,454,338,674,294,472,487,536,1137,652,522,449,294,524,300,990,1947,1606,928,0,0,0,0
833,1544,5049,1244,300,232,419,296,597,187,388,707,262,1015,529,337,394,440,373,281,854,1743,1387,784,21,0,0,21
834,1671,5431,1314,357,270,458,336,607,252,411,551,457,1099,572,296,439,503,433,256,936,1754,1578,907,28,0,0,28
835,1735,5735,1234,501,287,462,332,654,186,622,594,333,1019,716,433,479,487,336,262,1089,1934,1558,892,21,0,0,21
836,1477,4904,958,519,248,390,218,621,226,526,601,124,1085,392,266,549,377,285,298,963,1753,1291,599,24,0,0,24
837,3323,10881,956,2367,678,827,553,1265,471,1188,1260,404,2074,1249,933,1368,691,331,674,2228,4163,2603,1213,168,0,0,168
838,1462,4104,459,1003,428,363,253,418,238,604,399,221,1055,407,554,415,291,202,220,714,1497,1037,636,50,0,0,50
839,1951,4817,575,1376,719,519,272,441,388,634,720,209,1417,534,651,563,390,347,278,783,1958,1099,699,122,0,0,122
840,2576,5930,1397,1179,862,793,422,499,513,1117,784,162,1971,605,541,850,702,483,310,719,2102,1579,1220,32,0,0,32
841,1720,4914,710,1010,392,488,296,544,130,748,679,163,1280,440,478,526,436,280,292,836,1888,1198,700,0,0,0,0
842,1344,3502,445,899,320,438,213,373,116,432,654,142,989,355,351,440,398,155,225,562,1463,868,384,20,0,0,20
843,1442,4449,1111,331,245,421,301,475,226,551,474,191,992,450,190,351,504,397,250,664,1541,1234,760,33,0,0,33
844,3238,9404,2815,423,464,1061,642,1071,460,1051,1184,543,2216,1022,423,369,680,1766,425,1730,2459,2933,1857,24,3,0,21
845,2495,7419,2179,316,365,808,491,831,371,646,1145,333,1322,1173,297,449,547,1202,373,1392,1992,2102,1560,3,0,0,3
846,2197,6185,1414,783,487,628,401,681,388,742,631,436,1504,693,695,557,472,473,308,1225,2052,1681,919,14,0,0,14
847,1201,3049,378,823,336,351,226,288,189,464,425,123,823,378,297,436,256,212,160,553,1122,780,434,0,0,0,0
848,1854,5068,400,1454,418,533,348,555,206,714,769,165,1062,792,546,445,485,378,347,1020,1955,1179,567,48,0,0,48
849,1393,4209,1082,311,220,414,260,499,177,502,600,114,805,588,378,284,311,420,223,880,1272,1147,687,17,0,0,17
850,1328,3940,1150,178,194,429,265,440,165,356,565,242,791,537,138,172,378,640,213,733,1115,1089,790,0,0,0,0
851,741,2183,672,69,89,257,146,249,77,214,396,54,500,241,43,86,188,424,121,426,587,587,462,0,0,0,0
852,2146,6373,1729,417,376,639,401,730,281,578,1037,250,1448,698,417,497,400,832,314,1211,1895,1746,1207,17,0,0,17
853,2168,6082,1211,957,456,769,410,533,299,719,859,291,1569,599,626,594,541,407,341,998,2337,1566,840,18,0,0,18
854,2327,6861,416,1911,483,647,418,779,305,908,1051,63,1205,1122,1009,703,484,131,483,1548,2781,1527,522,24,0,0,24
855,1795,5453,571,1224,409,460,344,582,244,806,457,288,1185,610,975,309,222,289,354,1161,2051,1272,615,65,0,0,65
856,2480,7727,1106,1374,521,594,491,874,207,854,1014,405,1632,848,758,639,671,412,431,1342,2953,2057,944,49,0,0,49
857,1096,3628,442,654,209,255,189,443,109,446,361,180,654,442,353,342,227,174,233,713,1428,912,342,27,0,0,27
858,2127,6307,1210,917,416,551,412,748,454,805,601,267,1487,640,647,683,473,324,254,1113,2067,1816,1057,33,0,0,33
859,1377,4480,1028,349,234,355,239,549,293,385,356,343,1083,294,585,231,267,294,196,753,1374,1333,824,10,0,0,10
860,2283,6521,1823,460,494,692,394,703,331,644,1051,257,1709,574,444,620,493,726,290,939,1854,2063,1375,23,0,0,23
861,2251,7559,1697,554,303,609,440,899,247,588,805,611,1539,712,469,718,703,361,337,1241,2382,2202,1397,30,0,0,30
862,2826,7583,1122,1704,798,754,573,701,431,1075,647,673,2090,736,1068,881,465,412,495,1241,2798,1822,1227,21,0,0,21
863,1308,3968,765,543,228,377,232,471,100,518,398,292,835,473,277,331,333,367,227,633,1364,1087,657,26,0,0,26
864,3372,8030,845,2527,1180,1043,468,681,541,1467,973,391,2591,781,1287,1122,576,387,407,1367,3225,2055,976,18,0,0,18
865,1449,4198,1080,369,326,414,271,438,201,579,452,217,1022,427,409,419,354,267,208,612,1391,1255,732,23,0,0,23
866,1457,3968,1128,329,335,508,235,379,332,466,392,267,1109,348,340,267,405,445,194,547,1175,1158,894,26,0,0,26
867,1085,2783,770,315,262,362,167,294,141,472,287,185,758,327,287,311,144,343,146,459,839,805,534,1,0,0,1
868,1373,3892,999,374,320,441,246,366,106,511,506,250,968,405,214,190,293,676,208,638,1260,1158,628,198,0,0,198
869,1636,4035,732,904,538,488,251,359,276,713,481,166,1236,400,535,390,330,381,196,611,1340,1020,868,57,0,0,57
870,1633,4768,1015,618,340,447,324,522,178,517,697,241,1225,408,398,203,383,649,245,840,1692,1353,638,40,0,0,40
871,3124,7360,896,2228,1103,905,443,673,365,1394,1079,286,2399,725,929,903,786,506,353,1010,2733,1872,1392,77,0,0,77
872,2935,9802,1564,1371,508,727,568,1132,203,946,940,846,1973,962,828,686,744,677,498,1744,3556,2671,1333,22,0,0,22
873,1911,6368,863,1048,335,475,380,721,245,565,697,404,1049,862,566,561,480,304,351,1183,2247,1738,849,25,0,0,25
874,0,0,0,0,0,0,0,0,0,0,0,0,0,0,0,0,0,0,0,0,0,0,0,0,0,0,0
875,1100,4991,579,521,164,236,170,530,91,434,330,245,525,575,407,368,190,135,279,1034,1760,1399,519,749,0,0,749
876,617,2360,359,258,75,133,112,297,73,223,156,165,412,205,210,229,110,68,172,583,902,512,191,0,0,0,0
877,940,3755,499,441,120,175,146,499,122,383,273,162,570,370,296,417,177,50,261,892,1457,851,294,65,0,0,65
878,1576,5696,688,888,276,320,254,726,304,541,389,342,775,801,724,587,179,86,410,1360,2059,1308,559,91,0,0,91
879,1255,3911,744,511,283,339,215,418,109,520,303,323,846,409,425,297,363,170,217,785,1474,964,471,13,0,0,13
880,1160,4449,448,712,161,204,213,582,126,395,389,250,526,634,575,315,212,58,264,1188,1790,886,321,14,0,0,14
881,1123,3455,502,621,227,297,212,387,126,454,396,147,727,396,387,394,201,141,233,729,1307,780,406,29,0,0,29
882,1187,3327,648,539,341,305,221,320,158,495,461,73,705,482,382,325,288,192,217,612,1233,807,458,6,0,0,6
883,1221,3215,1049,172,229,471,215,306,267,295,576,83,964,257,244,228,237,512,158,494,908,939,716,11,0,0,11
884,1399,3519,1228,171,323,517,241,318,195,437,706,61,995,404,198,275,354,572,175,488,925,1009,922,22,0,0,22
885,2770,6645,2224,546,684,1104,438,544,408,1006,1256,100,1997,773,373,526,583,1288,306,890,2020,1921,1508,0,0,0,0
886,1747,4740,1145,602,472,545,303,427,230,730,607,180,1435,312,473,343,426,505,292,800,1759,1227,662,32,0,0,32
887,1231,3268,782,449,350,371,198,312,160,593,319,159,813,418,289,332,273,337,185,554,1116,825,588,63,0,0,63
888,1652,5523,526,1126,316,394,314,628,343,661,470,178,1001,651,1010,428,155,59,370,1386,2093,1215,459,40,0,0,40
889,1200,3903,457,743,238,305,212,445,133,457,434,176,828,372,480,391,178,151,247,864,1573,859,360,16,0,0,16
890,1699,5991,687,1012,303,375,305,716,257,641,470,331,1065,634,758,446,301,194,399,1469,2294,1291,538,20,0,0,20
891,1479,5607,538,941,251,286,252,690,276,606,428,169,1093,386,779,377,120,203,379,1424,2176,1211,417,15,0,0,15
892,1234,5084,523,711,140,203,249,642,166,439,336,293,774,460,571,343,221,99,315,1362,2011,1093,303,102,0,0,102
893,981,4043,311,670,152,162,151,516,99,512,234,136,442,539,497,305,120,59,268,1083,1542,880,270,176,0,0,176
894,1133,4212,317,816,272,196,169,496,216,468,259,190,670,463,623,282,159,69,277,1019,1636,899,381,242,0,0,242
895,2209,7468,508,1701,537,504,362,806,340,969,511,389,1204,1005,1271,631,264,43,479,1908,2856,1472,753,219,0,0,219
896,779,3870,226,553,152,189,113,325,77,364,148,190,464,315,302,222,198,57,187,828,1709,892,254,1046,0,0,1046
897,1229,4472,358,871,265,245,228,491,256,400,310,263,726,503,603,355,223,48,310,1064,1840,899,359,74,0,0,74
898,1323,4344,315,1008,349,257,241,476,238,622,415,48,757,566,723,377,145,78,304,1058,1730,872,380,41,0,0,41
899,2461,7820,1006,1455,556,568,399,938,522,1218,297,424,1682,779,1335,606,271,249,472,1747,3087,1707,807,36,0,0,36
900,1815,6115,749,1066,418,436,288,673,217,647,577,374,1191,624,751,484,471,109,374,1362,2322,1417,640,158,0,0,158
901,1730,4418,818,912,506,544,273,407,266,711,583,170,1231,499,627,437,233,433,263,843,1671,1081,560,0,0,0,0
902,788,2426,513,275,181,290,126,191,104,289,366,29,551,237,240,146,171,231,144,416,1014,530,322,310,276,0,34
903,1782,4465,1355,427,467,602,340,373,249,702,729,102,1214,568,296,572,358,556,273,615,1473,1291,813,9,0,0,9
904,2182,6403,1059,1123,575,610,357,640,139,976,697,370,1376,806,697,632,479,374,367,1305,2490,1488,753,53,0,0,53
905,2465,8032,1026,1439,547,609,411,898,320,904,1011,230,1495,970,1149,601,333,382,474,1616,3132,1854,956,22,0,0,22
906,2126,6018,843,1283,565,619,371,571,227,729,969,201,1331,795,595,619,554,358,347,1100,2344,1493,734,28,0,0,28
907,1178,3088,839,339,240,412,253,273,91,602,450,35,701,477,173,305,279,421,189,481,1064,832,522,20,0,0,20
908,1431,3602,780,651,351,454,300,326,177,445,773,36,1148,283,261,299,453,418,195,614,1224,976,593,16,0,0,16
909,1502,3801,1020,482,356,491,302,353,177,538,733,54,1054,448,181,395,368,558,190,564,1261,1101,685,36,0,0,36
910,2280,5567,1542,738,716,764,374,426,248,757,943,332,1715,565,365,524,503,888,340,711,1843,1584,1089,237,0,0,237
911,989,2479,833,156,226,394,164,205,195,318,352,124,790,199,119,196,163,511,99,329,650,730,671,104,104,0,0
912,1832,4534,1654,178,357,734,351,390,361,647,722,102,1291,541,194,227,327,1084,235,635,1093,1443,1128,1,1,0,0
913,2497,6225,2105,392,534,915,488,560,375,855,1098,169,1792,705,233,295,447,1522,382,938,1728,1888,1289,29,0,0,29
914,2378,5710,1957,421,619,895,410,454,363,1050,829,136,1782,596,450,302,380,1246,316,865,1627,1746,1156,0,0,0,0
915,1498,3705,1142,356,382,506,263,347,248,474,701,75,1006,492,156,224,243,875,218,603,1021,1022,841,7,2,0,5
916,1612,4074,1217,395,392,568,305,347,255,585,673,99,1111,501,123,242,334,913,218,695,1129,1186,846,116,104,0,12
917,2230,5815,1550,680,499,659,355,717,327,805,994,104,1412,818,328,328,334,1240,239,1276,1471,1691,1138,1,0,0,1
918,2035,6084,1847,188,253,634,340,808,253,718,927,137,1180,855,57,175,235,1568,267,1517,1100,1821,1379,9,0,0,9
919,712,1837,615,97,154,260,105,193,78,272,308,54,461,251,31,76,149,456,87,346,391,554,459,0,0,0,0
920,798,2000,693,105,137,315,148,198,112,262,338,86,589,209,71,92,118,517,102,311,508,638,441,0,0,0,0
921,1239,2757,586,653,434,371,196,238,254,544,379,62,959,280,342,287,203,407,155,425,961,704,512,0,0,0,0
922,1997,4381,1078,919,726,643,288,340,216,598,1110,73,1509,488,445,270,521,761,250,602,1365,1235,929,0,0,0,0
923,2690,7388,999,1691,723,772,473,722,409,1195,880,206,2039,651,1087,781,387,435,425,1306,2921,1837,899,67,0,0,67
924,1954,6184,612,1342,412,514,346,682,154,711,743,346,1156,798,797,480,443,234,366,1274,2445,1380,719,46,0,0,46
925,1926,6715,466,1460,411,395,317,803,189,667,736,334,1140,786,859,649,273,145,458,1499,2724,1332,702,42,0,0,42
926,1873,5840,499,1374,611,522,282,458,303,745,636,189,1432,441,785,556,185,347,246,918,2493,1575,608,827,0,0,827
927,1366,4584,177,1189,283,287,207,589,228,503,308,327,875,491,693,422,135,116,256,1155,1846,864,463,0,0,0,0
928,1451,4846,317,1134,367,310,240,534,153,621,417,260,826,625,736,491,132,92,322,1012,2079,1020,413,39,0,0,39
929,1264,3952,463,801,320,324,197,423,144,473,405,242,756,508,575,307,185,197,180,839,1512,913,508,37,0,0,37
930,710,1904,355,355,201,210,120,179,114,335,167,94,417,293,295,184,105,126,79,249,621,406,549,56,0,0,56
931,1355,3370,387,968,462,381,195,317,93,679,476,107,1125,230,351,588,268,148,163,529,1417,834,427,9,0,0,9
932,1354,4357,505,849,265,338,272,479,154,634,353,213,840,514,562,439,201,152,262,858,1711,1003,523,0,0,0,0
933,2179,7592,556,1623,386,536,474,783,263,826,576,514,1286,893,1007,577,368,227,395,1566,2987,1747,897,217,0,0,217
934,3325,7999,383,2942,1155,1016,460,694,481,1400,1132,312,2716,609,1437,895,564,429,377,1100,3799,1736,987,25,0,0,25
935,1588,3826,355,1233,533,513,226,316,226,713,540,109,1330,258,596,402,290,300,169,467,1834,899,457,84,0,0,84
936,1425,3206,346,1079,549,403,197,276,119,772,347,187,1209,216,552,379,208,286,151,414,1473,754,414,0,0,0,0
937,1524,3414,948,576,488,501,250,285,156,519,789,60,1068,456,296,186,370,672,236,466,1092,946,674,8,0,0,8
938,1587,4363,1445,142,261,564,313,449,176,481,825,105,994,593,138,130,220,1099,289,813,1070,1193,998,10,0,0,10
939,1936,3805,681,1255,772,737,212,215,142,1047,712,35,1569,367,331,318,468,819,184,346,1720,952,603,12,0,0,12
940,2404,4278,762,1642,1173,822,214,195,404,1090,888,22,2074,330,560,603,519,722,163,294,2188,965,668,21,0,0,21
941,2852,5067,520,2332,1413,991,244,204,405,1353,1057,37,2384,468,573,1035,670,574,213,326,2843,1081,604,34,0,0,34
942,2814,4667,426,2388,1498,963,211,142,426,1296,1056,36,2481,333,635,900,715,564,156,210,2595,878,828,67,0,0,67
943,2565,5064,679,1886,1125,856,290,294,242,1278,932,113,2165,400,659,575,714,617,224,413,2501,1172,754,11,0,0,11
944,2539,4545,178,2361,1262,852,232,193,327,1232,823,157,2338,201,909,569,404,657,158,295,2295,951,846,49,0,0,49
945,3700,6121,389,3311,2179,1105,232,184,762,2202,704,32,3484,216,1655,874,545,626,187,317,2941,1195,1481,288,0,0,288
946,2476,5130,487,1989,1023,962,256,235,328,996,893,259,2133,343,828,289,645,714,163,329,2662,1234,742,319,0,0,319
947,1853,5270,236,1617,681,571,229,372,306,705,545,297,1445,408,883,410,242,318,178,680,2381,1241,790,881,0,107,774
948,1710,4481,688,1022,506,504,310,390,126,751,732,101,1008,702,487,340,460,423,236,707,1651,1297,590,122,0,104,18
949,1450,3884,1023,427,293,435,290,432,195,431,682,142,857,593,125,192,316,817,205,750,966,1147,816,0,0,0,0
950,2000,4905,1016,984,588,600,325,487,250,693,871,186,1340,660,307,380,516,797,233,914,1454,1489,815,0,0,0,0
951,2659,6619,1544,1115,727,845,468,619,550,947,998,164,1851,808,753,570,516,820,311,1200,1973,1915,1220,0,0,0,0
952,2470,7044,1903,567,492,690,488,800,263,678,1100,429,1511,959,193,443,552,1282,411,1385,2008,2066,1174,45,0,0,45
953,2583,7052,2248,335,438,877,478,790,465,675,1109,334,1672,911,336,221,501,1525,346,1206,1625,2086,1789,18,0,0,18
954,1909,4349,578,1331,636,638,294,341,218,879,721,91,1308,601,557,522,408,422,218,597,1551,1131,852,0,0,0,0
955,1344,2997,205,1139,500,385,211,248,164,727,438,15,907,437,358,447,369,170,149,444,1251,827,326,0,0,0,0
956,2081,4744,775,1306,726,651,308,396,319,757,851,154,1444,637,472,549,417,643,260,673,1663,1319,829,46,0,0,46
957,1450,3347,484,966,463,471,234,282,186,603,633,28,1122,328,255,270,415,510,159,534,1172,926,556,14,0,0,14
958,1521,3231,777,744,566,511,227,217,171,770,519,61,1245,276,268,375,366,512,155,373,1137,835,731,10,0,0,10
959,2068,4857,827,1241,653,681,323,411,220,989,726,133,1503,565,652,342,277,797,252,725,1705,1423,752,2,0,0,2
960,2124,5571,994,1130,650,665,330,479,272,789,941,122,1390,734,546,450,387,741,268,848,1818,1495,1142,306,0,0,306
961,1253,3828,710,543,177,338,245,493,217,380,566,90,685,568,367,129,165,592,350,812,1477,709,480,42,0,0,42
962,1761,4698,364,1397,420,588,306,447,234,720,695,112,1322,439,514,620,385,242,258,825,2035,1022,558,1,0,0,1
963,2358,5048,832,1526,886,810,289,373,262,990,972,134,1925,433,581,511,526,740,220,637,1974,1354,863,0,0,0,0
964,239,709,3,236,56,62,53,68,41,72,109,17,131,108,138,68,7,26,35,203,225,197,49,8,0,0,8
965,258,977,120,138,63,89,33,73,35,77,105,41,216,42,72,46,62,78,33,92,386,383,83,233,0,0,233
966,36,206,21,15,7,7,7,15,3,28,5,0,36,0,0,4,21,11,23,28,73,56,26,113,0,0,113
967,447,872,314,133,186,142,62,57,30,258,159,0,430,17,47,61,137,202,31,38,451,237,115,121,0,0,121
968,1264,2263,415,849,604,484,84,92,458,469,310,27,1173,91,693,239,199,133,43,124,694,468,934,94,0,0,94
969,1169,2238,260,909,525,419,120,105,200,622,324,23,1065,104,423,146,279,321,69,134,1112,494,429,148,0,0,148
970,2433,4632,179,2254,1393,685,195,160,491,1296,562,84,1936,497,1209,326,438,460,130,380,2353,1061,708,527,284,0,243
971,772,1225,3,769,479,246,23,24,250,355,165,2,735,37,385,109,138,140,24,55,649,223,274,38,9,0,29
972,4370,7705,512,3858,2187,1581,360,242,686,2166,1357,161,3814,556,1483,880,951,1056,280,444,4526,1359,1096,122,0,0,122
973,1403,2551,384,1019,664,519,116,104,166,782,428,27,1161,242,384,375,313,331,111,177,1377,542,344,9,0,0,9
974,2976,5057,755,2221,1588,945,256,187,546,1270,1121,39,2665,311,792,635,649,900,201,272,2326,978,1280,24,0,0,24
975,1269,2715,437,832,461,499,155,154,103,556,530,80,1080,189,270,311,200,488,131,225,1466,611,282,155,0,0,155
976,2370,4908,472,1898,1011,799,296,264,230,1249,719,172,1888,482,566,808,449,547,225,451,2956,917,359,188,0,0,188
977,2942,7027,935,2007,956,1050,460,476,249,1153,1160,380,2372,570,666,485,675,1116,325,819,3830,1399,654,199,0,0,199
978,1612,5057,339,1273,486,508,271,347,160,550,524,378,1288,324,499,508,321,284,230,680,2630,1108,409,672,0,0,672
979,2308,5600,227,2081,1145,775,229,159,196,1356,656,100,2054,254,677,581,609,441,200,360,3054,1306,680,1408,0,0,1408
980,510,1308,119,391,169,131,86,124,70,217,149,74,417,93,143,85,126,156,63,198,676,268,103,14,0,0,14
981,362,678,57,305,165,106,44,47,92,183,54,33,310,52,229,65,22,46,20,61,236,149,212,23,0,0,23
982,746,2010,109,637,248,196,129,173,192,319,209,26,537,209,433,197,81,35,137,497,813,407,156,7,0,0,7
983,1107,2449,206,901,459,342,134,172,307,544,154,102,906,201,768,124,114,101,104,258,1167,472,448,29,0,0,29
984,173,478,18,155,66,44,27,36,27,90,44,12,103,70,110,29,10,24,26,107,179,115,51,52,0,0,52
985,703,2075,88,615,235,188,110,170,112,365,179,47,417,286,411,119,59,114,134,462,821,458,200,213,0,0,213
986,706,2322,198,508,187,231,126,162,100,210,279,117,585,121,203,208,162,133,106,333,1164,480,239,406,0,0,406
987,774,1981,173,601,228,260,140,146,92,365,249,68,539,235,248,271,101,154,74,246,1102,407,152,22,0,0,22
988,1737,6040,773,964,584,637,268,248,25,927,653,132,1422,315,221,316,592,608,209,441,2913,2075,402,2099,0,0,2099
989,958,2979,214,744,280,305,175,198,93,448,298,119,663,295,311,213,134,300,134,468,1525,680,172,437,0,0,437
990,1143,2719,355,788,470,300,178,195,198,475,274,196,944,199,498,224,223,198,116,285,1423,627,268,107,0,0,107
991,6408,11784,1943,4465,2935,2209,695,569,679,3578,1881,270,5828,580,1515,1547,1375,1971,519,806,6753,2312,1394,254,0,0,254
992,1081,2474,417,664,355,370,167,189,80,377,440,184,754,327,164,373,191,353,128,300,1237,586,223,12,0,0,12
993,1812,4225,670,1142,641,640,243,288,164,810,699,139,1463,349,549,406,354,503,210,461,2136,867,551,122,0,0,122
994,915,2217,349,566,286,300,137,192,118,366,357,74,649,266,266,209,239,201,111,379,974,486,267,28,0,0,28
995,1532,4075,403,1129,475,526,249,282,171,783,415,163,1173,359,576,295,305,356,155,539,2154,826,401,395,42,0,353
996,1965,4606,803,1162,583,693,369,320,157,843,697,268,1545,420,474,528,470,493,240,464,2367,986,549,36,2,0,34
997,656,1628,268,388,161,227,126,142,42,236,328,50,486,170,102,97,192,265,114,182,820,335,177,17,0,0,17
998,2369,5079,999,1370,908,829,298,334,395,895,907,172,1838,531,414,488,398,1069,280,586,2040,1266,907,131,28,0,103
999,985,2333,564,421,271,392,113,209,114,444,361,66,754,231,108,135,187,555,119,311,863,530,510,66,0,0,66
1000,1798,4050,780,1018,556,671,250,321,245,583,834,136,1324,474,331,245,411,811,222,494,1886,873,575,25,0,0,25
1001,1610,3639,662,948,535,572,231,272,191,699,525,195,1323,287,503,361,331,415,212,377,1808,790,452,4,0,0,4
1002,864,1970,292,572,307,292,148,117,121,286,338,119,689,175,269,164,156,275,76,231,967,404,292,68,1,0,67
1003,716,1532,296,420,246,255,104,111,87,291,281,57,593,123,193,82,99,342,62,163,683,341,283,1,0,0,1
1004,1334,3138,978,356,355,500,218,261,213,654,425,42,1020,314,195,173,242,724,140,407,868,791,932,0,0,0,0
1005,1244,2925,1070,174,300,513,218,213,230,596,326,92,899,345,164,96,244,740,103,340,693,920,869,0,0,0,0
1006,1429,4234,481,948,543,431,206,249,283,545,476,125,1118,311,410,310,162,547,110,1275,1630,529,690,1032,1021,0,11
1007,1106,4868,131,975,482,299,154,171,339,434,189,144,1052,54,579,201,157,169,59,787,3684,183,155,2348,2340,0,8
1008,1848,11245,21,1827,869,503,281,195,470,1098,121,159,1848,0,1321,374,114,39,79,5204,5603,218,141,7441,7364,0,77
1009,2391,5504,317,2074,919,746,368,358,411,828,813,339,2174,217,1092,652,255,392,133,537,3942,496,396,165,113,0,52
1010,1283,2886,487,796,474,416,180,213,131,592,428,132,1061,222,253,233,284,513,108,299,1449,534,496,20,2,0,18
1011,1496,3366,426,1070,618,484,207,187,204,670,507,115,1168,328,498,352,253,393,136,303,1608,703,616,238,45,0,193
1012,2098,5057,778,1320,680,668,323,427,337,573,785,403,1610,488,640,415,386,657,214,742,2288,1159,654,54,0,0,54
1013,1581,3738,847,734,526,474,232,349,297,564,643,77,1151,430,582,309,218,472,198,606,1371,992,571,0,0,0,0
1014,1287,4141,323,964,527,458,153,149,88,590,559,50,1115,172,175,286,419,407,162,454,2013,1138,374,1527,0,0,1527
1015,1158,2879,352,806,383,343,192,240,188,505,375,90,867,291,487,234,164,273,143,466,1238,675,357,60,0,0,60
1016,1936,4289,768,1168,760,555,296,325,495,959,415,67,1397,539,919,343,357,317,192,582,1704,1024,787,142,122,0,20
1017,2034,4562,819,1215,741,751,266,276,219,936,592,287,1688,346,658,488,267,621,161,490,2110,1019,782,178,36,0,142
1018,2279,5262,56,2223,1048,579,314,338,399,1318,431,131,2054,225,1187,589,345,158,163,627,3390,729,353,539,137,0,402
1019,199,1273,14,185,86,52,23,38,46,96,39,18,178,21,115,56,12,16,13,159,1010,68,23,888,852,0,36
1020,1821,5572,290,1531,835,565,236,185,237,1012,429,143,1698,123,885,393,270,273,85,1279,3334,485,389,1987,1910,0,77
1021,1837,3740,262,1575,781,625,240,191,361,793,515,168,1737,100,685,462,238,452,93,321,2416,483,427,59,0,0,59
1022,1720,3687,546,1174,629,610,256,225,381,812,399,128,1441,279,453,497,354,416,143,434,1684,771,655,35,0,0,35
1023,1586,3392,676,910,622,518,204,242,193,774,550,69,1144,442,365,445,274,502,163,438,1472,767,552,42,0,0,42
1024,1117,2724,469,648,351,356,194,216,117,466,490,44,832,285,266,238,259,354,125,423,1083,698,395,0,0,0,0
1025,1703,3928,1061,642,507,619,259,318,193,633,700,177,1169,534,343,295,335,730,188,599,1251,1062,828,15,0,0,15
1026,774,1862,525,249,203,250,153,168,112,340,253,69,609,165,112,114,213,335,63,293,528,514,464,0,0,0,0
1027,1677,3634,602,1075,592,608,241,236,354,753,458,112,1403,274,539,304,402,432,108,426,1626,751,723,38,0,0,38
1028,1576,3826,1175,401,446,621,238,271,313,628,562,73,1249,327,193,178,294,911,146,509,1034,1002,1135,96,8,0,88
1029,1510,3659,1230,280,360,601,251,298,243,578,635,54,1138,372,182,186,310,832,131,528,861,1037,1102,46,27,0,19
1030,833,2015,749,84,154,368,140,171,135,327,314,57,645,188,77,98,130,528,74,268,403,610,660,20,0,0,20
1031,1449,3657,1305,144,259,602,272,316,264,477,639,69,1067,382,70,247,233,899,127,557,736,1012,1225,0,0,0,0
1032,652,1679,536,116,159,206,113,174,159,121,301,71,517,135,82,112,117,341,65,263,433,438,480,0,0,0,0
1033,1705,4086,1380,325,437,628,295,345,374,653,563,115,1333,372,459,272,275,699,146,694,828,1198,1220,0,0,0,0
1034,1307,3399,972,335,271,428,218,390,148,599,507,53,796,511,279,239,186,603,147,694,855,962,741,13,0,0,13
1035,854,2295,635,219,135,282,150,287,154,225,453,22,509,345,111,153,155,435,84,506,521,709,475,0,0,0,0
1036,1254,3234,506,748,286,380,252,336,156,379,528,191,791,463,206,285,317,446,182,653,1110,841,448,13,0,0,13
1037,939,2443,453,486,217,249,194,279,100,418,341,80,575,364,169,240,194,336,125,499,800,654,365,13,0,0,13
1038,1064,3752,9,1055,227,468,167,202,180,463,409,12,696,368,472,262,194,136,244,1168,1984,136,220,1327,1223,0,104
1039,2033,5019,1048,985,574,545,403,511,246,907,807,73,1254,779,312,613,475,633,270,973,1696,1324,756,19,0,0,19
1040,731,1801,77,654,214,225,123,169,60,315,273,83,503,228,242,228,212,49,104,221,937,358,181,10,0,0,10
1041,1020,2434,403,617,290,339,179,212,159,426,304,131,815,205,280,254,237,249,146,325,1057,566,340,2,0,0,2
1042,722,1728,607,115,173,255,148,146,146,291,254,31,560,162,104,121,128,369,92,241,432,506,457,49,39,0,10
1043,1164,2869,938,226,284,426,188,266,304,421,395,44,824,340,128,177,266,593,109,451,692,799,818,13,3,0,10
1044,1008,2428,850,158,243,362,158,245,265,186,478,79,732,276,79,198,181,550,114,370,545,692,707,0,0,0,0
1045,1128,2865,968,160,252,433,197,246,338,384,352,54,887,241,185,234,171,538,119,373,714,803,856,0,0,0,0
1046,914,2376,773,141,190,312,179,233,219,364,297,34,702,212,153,131,218,412,120,379,559,744,574,0,0,0,0
1047,1229,2993,555,674,336,406,231,256,249,443,409,128,807,422,345,298,239,347,185,445,1126,716,521,8,0,0,8
1048,1155,2819,550,605,308,363,243,241,172,483,465,35,740,415,238,312,298,307,144,412,1022,761,480,12,0,0,12
1049,2068,5105,1116,952,595,699,355,419,261,737,907,163,1380,688,702,424,455,487,267,662,1920,1327,929,34,0,0,34
1050,2739,8308,949,1790,662,720,492,865,500,1214,687,338,1584,1155,1348,746,404,241,539,1744,3270,1784,971,259,0,0,259
1051,1407,3478,426,981,432,424,241,310,379,373,477,178,1111,296,637,338,260,172,158,481,1458,786,595,13,0,0,13
1052,578,1453,474,104,106,227,94,151,166,173,203,36,363,215,126,90,139,223,64,220,352,428,389,0,0,0,0
1053,1614,4028,1351,263,350,563,295,406,279,640,654,41,1180,434,242,301,308,763,188,611,1134,1176,919,1,0,0,1
1054,1145,2975,836,309,269,400,202,274,140,333,589,83,778,367,145,200,345,455,152,407,965,851,600,46,0,0,46
1055,1987,5995,1066,921,447,549,309,682,203,843,536,405,1393,594,295,869,517,306,311,1024,2255,1540,865,52,0,0,52
1056,1758,4994,900,858,486,478,268,526,423,623,615,97,1156,602,720,399,488,151,256,911,1817,1288,722,3,0,0,3
1057,1256,4866,428,828,147,189,234,686,262,310,336,348,516,740,509,359,298,90,330,1299,1977,977,283,10,0,0,10
1058,2168,7250,904,1264,493,526,379,770,580,773,544,271,1305,863,892,567,435,274,445,1569,2759,1652,825,283,0,0,283
1059,3199,7422,1974,1225,1149,1076,459,515,568,1728,845,58,2666,533,1005,710,765,719,399,972,2973,1986,1092,289,0,0,289
1060,1956,7176,875,1081,336,384,340,896,196,755,570,435,770,1186,803,680,375,98,505,1773,2771,1500,627,31,0,0,31
1061,2413,7725,862,1551,598,518,416,881,788,832,542,251,1332,1081,1437,586,296,94,539,1878,2910,1584,814,31,0,0,31
1062,1924,3892,1080,844,742,715,225,242,428,720,638,138,1611,313,351,410,481,682,146,392,1065,1168,1121,10,0,0,10
1063,1896,6941,664,1232,314,344,362,876,311,635,577,373,1008,888,811,617,317,151,452,1727,2732,1463,567,40,0,0,40
1064,1199,4676,642,557,174,180,217,628,139,356,510,194,611,588,323,422,324,130,254,1142,1782,1025,473,0,0,0,0
1065,2341,8004,1396,945,409,587,390,955,148,944,903,346,1548,793,514,1002,597,228,437,1592,2950,2099,926,53,0,0,53
1066,2334,6443,798,1536,679,545,356,754,467,1126,496,245,1463,871,926,967,365,76,323,1180,2276,1514,1150,46,0,0,46
1067,2487,9615,1020,1467,231,472,466,1318,347,984,881,275,1163,1324,881,923,528,155,658,2357,3762,2093,745,9,0,0,9
1068,1452,6085,647,805,208,260,258,726,158,476,490,328,620,832,451,491,349,161,406,1472,2402,1366,439,385,0,0,385
1069,4090,11227,1612,2478,1100,1215,666,1109,690,1620,1538,242,2855,1235,1117,1457,831,685,599,1867,4589,2851,1321,0,0,0,0
1070,1272,4492,736,536,203,227,238,604,143,510,373,246,688,584,421,379,307,165,237,923,1665,1139,528,0,0,0,0
1071,1805,6525,878,927,253,361,338,853,341,544,548,372,854,951,693,597,385,130,383,1546,2424,1488,684,0,0,0,0
1072,1731,5909,871,860,262,410,338,721,249,724,433,325,1048,683,578,453,420,280,339,1203,2189,1532,646,0,0,0,0
1073,2046,5868,964,1082,578,549,327,592,368,919,476,283,1335,711,732,678,490,146,358,1043,2212,1441,814,23,0,0,23
1074,2679,7612,1710,969,613,817,514,735,407,1052,833,387,1936,743,473,1033,731,442,425,1179,2667,2080,1261,64,0,0,64
1075,1084,2889,601,483,294,289,182,319,148,469,406,61,731,353,314,438,181,151,151,480,1061,741,456,33,0,0,33
1076,1226,3023,978,248,313,417,234,262,218,442,419,147,1002,224,285,295,362,284,148,419,853,872,731,10,0,0,10
1077,1929,5245,1225,704,457,597,309,566,292,710,747,180,1267,662,442,485,580,422,248,817,1730,1527,923,3,0,0,3
1078,1627,4588,955,672,371,511,297,448,252,520,534,321,1025,602,324,439,527,337,217,744,1554,1246,827,15,0,0,15
1079,3256,9264,2746,510,559,1181,630,886,866,1186,617,587,2389,867,778,635,900,943,377,1350,2588,2608,2341,1,0,0,1
1080,1860,5774,1242,618,382,510,323,645,389,452,779,240,1075,785,430,500,580,350,301,1020,1968,1581,904,11,0,0,11
1081,1448,4830,1113,335,303,375,220,550,229,420,377,422,971,477,260,426,442,320,227,904,1517,1293,889,19,0,0,19
1082,1922,5532,1193,729,399,567,355,601,309,841,579,193,1301,621,509,463,611,339,245,953,1896,1483,955,33,0,0,33
1083,5877,16465,4173,1704,1259,1695,1113,1810,865,2340,1959,713,4025,1852,1447,1351,1359,1720,840,2738,5605,4721,2561,17,0,0,17
1084,2174,5921,1857,317,465,803,337,569,455,646,811,262,1633,541,250,656,561,707,245,855,1668,1645,1508,26,0,0,26
1085,1457,4555,1167,290,243,466,261,487,370,334,404,349,1044,413,301,309,423,424,201,612,1337,1286,1119,9,0,0,9
1086,2374,7107,1845,529,427,720,410,817,329,805,846,394,1584,790,412,575,614,773,324,1202,2218,1878,1485,18,0,0,18
1087,2183,5880,1816,367,420,764,375,624,449,643,676,415,1579,604,448,362,518,855,259,842,1657,1802,1320,4,1,0,3
1088,1236,4039,985,251,180,388,206,462,202,535,237,262,803,433,234,303,332,367,190,680,1257,1101,811,14,0,0,14
1089,2097,6101,1067,1030,536,556,428,577,426,803,750,118,1368,729,920,512,440,225,347,1290,2090,1518,856,163,0,0,163
1090,1521,3202,795,726,567,532,212,210,420,529,446,126,1258,263,405,463,328,325,127,370,1054,974,677,0,0,0,0
1091,1492,3358,782,710,515,500,214,263,306,744,330,112,1128,364,436,386,267,403,172,488,1120,940,638,0,0,0,0
1092,510,1031,84,426,248,138,58,66,195,244,71,0,412,98,263,167,59,21,25,94,512,281,119,103,0,0,103
1093,1028,2078,399,629,435,299,140,154,249,459,309,11,755,273,457,206,222,143,94,267,727,655,335,11,0,0,11
1094,3285,8340,1987,1298,875,1003,593,814,396,1197,1510,182,1983,1302,560,832,1062,831,457,1463,2917,2306,1197,11,0,0,11
1095,1213,3626,843,370,228,331,259,395,167,480,445,121,903,310,194,431,340,248,203,744,1226,959,494,18,0,0,18
1096,3784,9848,2779,1005,860,1234,684,1006,627,1349,1492,316,2508,1276,518,1033,919,1314,581,1778,3291,2842,1356,29,0,0,29
1097,1209,3425,985,224,235,378,233,363,199,340,399,271,812,397,167,523,227,292,167,540,1179,1067,472,24,0,0,24
1098,3671,12879,2563,1108,421,872,756,1622,378,1206,1217,870,1976,1695,441,726,1287,1217,786,2453,4832,3469,1339,0,0,0,0
1099,3020,8297,2190,830,542,1069,584,825,637,1066,891,426,2134,886,561,798,881,780,390,1412,2545,2424,1526,29,0,0,29
1100,3084,8014,2600,484,669,1070,526,819,728,1104,1022,230,2067,1017,438,616,812,1218,357,1449,1920,2573,1715,16,0,0,16
1101,1445,4048,1329,116,218,534,221,472,358,417,527,143,962,483,196,258,408,583,197,791,926,1239,895,0,0,0,0
1102,382,952,333,49,69,134,84,95,95,110,139,38,254,128,70,81,89,142,41,160,187,339,225,0,0,0,0
1103,2813,7932,2371,442,448,951,546,868,592,764,1012,445,1915,898,559,514,718,1022,371,1483,2171,2425,1482,9,0,0,9
1104,1277,3707,1064,213,178,448,236,415,213,486,457,121,797,480,188,136,355,598,168,759,989,1021,770,0,0,0,0
1105,437,1173,343,94,85,157,81,114,73,167,156,41,273,164,69,83,196,89,55,172,380,346,220,0,0,0,0
1106,3289,8016,1679,1610,986,1015,551,737,832,1308,1010,139,2602,687,1008,585,975,721,430,1271,2694,2093,1528,147,0,0,147
1107,1491,3803,832,659,393,467,290,341,326,513,461,191,1140,351,410,365,405,311,236,555,1332,954,726,14,0,0,14
1108,2183,5955,1678,505,478,746,405,554,394,732,831,226,1502,681,247,683,545,708,304,959,1760,1719,1213,39,0,0,39
1109,2806,7691,2094,712,545,972,544,745,401,863,1259,283,1790,1016,472,717,792,825,431,1263,2513,2089,1395,21,0,0,21
1110,2719,7225,1617,1102,668,902,451,698,588,1012,853,266,2103,616,921,513,596,689,387,1204,2521,1928,1185,36,0,0,36
1111,2047,5761,1486,561,423,707,388,529,384,541,790,332,1407,640,380,467,761,439,382,875,2088,1568,848,16,0,0,16
1112,2227,6423,1443,784,478,723,414,612,439,530,945,313,1561,666,566,549,503,609,354,963,2346,1769,991,90,0,0,90
1113,1363,2306,66,1297,761,393,100,109,497,495,328,43,1276,87,698,343,283,39,82,128,958,512,626,28,0,0,28
1114,2582,7452,474,2108,596,675,484,827,318,1236,834,194,1483,1099,966,893,577,146,569,1627,3320,1478,458,0,0,0,0
1115,1574,4808,247,1327,320,395,282,577,188,554,553,279,1026,548,508,558,300,208,341,1120,2087,930,330,0,0,0,0
1116,1237,3463,849,388,253,438,218,328,177,383,496,181,803,434,227,248,299,463,205,512,1229,985,532,37,0,0,37
1117,1216,3241,892,324,220,487,183,326,249,335,398,234,874,342,207,324,212,473,150,480,967,957,687,17,0,0,17
1118,3068,7406,1899,1169,860,1037,514,657,455,1418,885,310,2174,894,1104,784,618,562,404,1084,2461,2019,1438,18,0,0,18
1119,3134,8642,1879,1255,654,1012,592,876,535,1348,694,557,2069,1065,675,1112,644,703,521,1500,3025,2256,1340,15,0,0,15
1120,2897,9834,1047,1850,515,685,494,1203,477,1172,779,469,1897,1000,1052,849,679,317,702,2241,4088,1971,832,32,0,0,32
1121,5563,11330,1426,4137,2241,1830,704,788,796,3010,1468,289,4565,998,1404,1431,1247,1481,666,1272,4925,2533,1934,42,0,0,42
1122,2876,7672,1932,944,883,836,440,717,566,949,1022,339,2067,809,774,1034,635,433,413,1250,2695,1985,1329,159,0,0,159
1123,2288,5589,1081,1207,677,750,389,472,455,789,805,239,1484,804,552,570,720,446,263,927,2193,1456,750,38,0,0,38
1124,2513,6335,1880,633,652,839,492,530,378,892,968,275,1580,933,307,547,778,881,332,985,1861,1769,1388,0,0,0,0
1125,1898,4862,1526,372,410,727,267,494,472,542,684,200,1311,587,266,363,417,852,249,851,1314,1351,1097,0,0,0,0
1126,2781,6921,2421,360,629,1044,504,604,572,1193,884,132,2103,678,539,579,711,952,318,1029,1768,2129,1677,10,0,0,10
1127,2549,6523,1821,728,572,866,458,653,520,920,761,348,1673,876,599,340,489,1121,338,1116,1853,1861,1355,17,0,0,17
1128,1717,4605,1367,350,360,542,335,480,225,612,797,83,1061,656,208,403,562,544,351,813,1439,1239,763,56,0,0,56
1129,2162,5559,1548,614,542,702,358,560,504,636,765,257,1529,633,365,365,744,688,344,906,1611,1513,1185,97,0,0,97
1130,1352,3492,1137,215,284,459,254,355,368,457,393,134,879,473,281,233,343,495,221,574,867,991,839,6,0,0,6
1131,2218,6090,1941,277,339,831,381,667,423,665,788,342,1316,902,189,219,295,1515,257,1192,1265,1877,1499,1,0,0,1
1132,1644,4817,1474,170,221,589,257,577,349,452,718,125,914,730,161,155,171,1157,208,1167,913,1444,1085,21,0,0,21
1133,3042,7699,2383,659,690,1072,611,669,772,1069,986,215,2157,885,665,455,559,1363,429,1261,2082,2210,1717,52,0,0,52
1134,2463,6259,1341,1122,638,815,464,546,342,1032,913,176,1690,773,613,498,415,937,432,1046,2217,1529,1035,32,0,0,32
1135,2893,6269,1686,1207,995,1010,403,485,511,1138,1030,214,2280,613,579,521,853,940,361,875,2292,1571,1170,10,0,0,10
1136,2584,5344,1054,1530,939,925,361,359,348,1062,1031,143,2152,432,371,445,914,854,287,623,2575,1200,659,12,0,0,12
1137,1422,3764,1205,217,284,543,279,316,277,566,447,132,1009,413,162,195,286,779,207,563,996,1011,987,85,0,0,85
1138,2274,6134,1731,543,397,835,446,596,564,862,730,118,1630,644,397,408,445,1024,331,1070,1661,1788,1284,2,0,0,2
1139,1211,3464,1114,97,150,454,228,379,285,404,456,66,722,489,90,148,177,796,152,689,698,1107,818,3,0,0,3
1140,1047,3051,975,72,157,376,185,329,210,371,366,100,736,311,59,141,206,641,137,623,555,894,842,74,0,0,74
1141,2151,5981,1844,307,356,774,387,634,437,709,909,96,1575,576,248,343,416,1144,316,1154,1351,1768,1392,7,0,0,7
1142,1514,4045,1257,257,254,560,270,430,320,511,538,145,1045,469,142,323,371,678,186,746,934,1240,939,0,0,0,0
1143,1981,4492,1278,703,643,699,261,378,354,721,801,105,1330,651,462,213,459,847,211,707,1173,1157,1244,0,0,0,0
1144,2126,5059,1142,984,617,745,330,434,399,762,696,269,1533,593,272,375,541,938,256,835,1628,1399,941,10,0,0,10
1145,4120,7663,922,3198,1817,1475,422,406,661,2119,1129,211,3533,587,849,932,1086,1253,355,736,3903,1605,1064,60,0,0,60
1146,1919,3603,140,1779,907,599,186,227,137,1249,497,36,1655,264,423,737,538,221,150,429,1952,714,358,11,0,0,11
1147,2262,5780,1722,540,616,702,378,566,751,625,699,187,1528,734,406,344,451,1061,258,1087,1157,1623,1655,0,0,0,0
1148,6213,8652,5841,372,3921,2040,139,113,5142,887,184,0,6203,10,2382,1927,1175,729,32,83,115,843,7579,6,0,0,6
1149,2105,5355,1463,642,537,722,320,526,384,989,597,135,1490,615,334,473,443,855,262,942,1504,1571,1076,135,0,0,135
1150,2112,5187,1195,917,569,676,331,536,557,885,542,128,1432,680,581,330,425,776,260,1098,1328,1428,1073,1,0,0,1
1151,2040,5937,1897,143,264,670,357,749,351,553,1129,7,1188,852,181,220,363,1276,274,1379,1220,1808,1256,0,0,0,0
1152,2547,6181,1381,1166,633,899,369,646,324,1009,1118,96,1750,797,211,488,410,1438,306,1193,1834,1707,1141,0,0,0,0
1153,1473,4237,1367,106,193,509,246,525,266,541,638,28,865,608,71,190,240,972,227,964,862,1218,966,0,0,0,0
1154,2691,7165,2293,398,544,941,405,801,809,903,882,97,1987,704,409,116,364,1802,301,1517,1276,2058,2013,4,0,0,4
1155,746,2001,650,96,125,262,124,235,119,325,292,10,381,365,90,94,115,447,100,404,432,611,454,0,0,0,0
1156,1472,4354,1302,170,184,468,286,534,284,343,660,185,800,672,140,168,276,888,274,963,1056,1248,813,0,0,0,0
1157,1013,2559,809,204,237,320,161,295,292,291,300,130,709,304,189,138,212,474,119,527,531,751,631,0,0,0,0
1158,2327,6219,1665,662,446,751,429,701,402,982,764,179,1568,759,508,361,377,1081,282,1357,1540,1827,1213,0,0,0,0
1159,880,3344,794,86,121,310,140,309,236,292,297,55,579,301,86,108,146,540,118,1037,892,722,575,911,895,0,16
1160,1839,5724,1661,178,267,620,316,636,396,558,810,75,1043,796,150,218,290,1181,204,1371,1343,1668,1138,535,524,0,11
1161,4468,11675,3384,1084,1022,1545,686,1215,823,1702,1481,462,2938,1530,792,628,684,2364,484,2419,2607,3770,2395,10,0,0,10
1162,467,1141,342,125,111,163,88,105,155,129,144,39,315,152,78,145,78,166,50,215,242,361,273,0,0,0,0
1163,1315,3555,1180,135,212,514,210,379,376,401,428,110,898,417,109,219,246,741,169,695,736,1047,908,0,0,0,0
1164,1964,5748,1822,142,243,728,342,651,349,648,756,211,1426,538,141,71,176,1576,202,1223,1033,1876,1414,50,0,0,50
1165,2670,7673,2483,187,344,987,452,887,841,706,922,201,1796,874,399,298,353,1620,309,1682,1500,2426,1756,42,0,0,42
1166,3959,11284,3557,402,559,1359,742,1299,807,1349,1529,274,2409,1550,252,388,821,2498,442,2617,2265,3671,2289,22,0,0,22
1167,4116,11168,3629,487,707,1498,637,1274,904,1626,1335,251,2511,1605,637,533,721,2225,446,2454,2180,3469,2619,16,0,0,16
1168,3433,8271,2440,993,970,1050,607,806,561,1586,1114,172,2327,1106,519,608,707,1599,360,1645,2323,2673,1270,0,0,0,0
1169,2202,6473,1799,403,348,666,410,778,347,848,839,168,1271,931,171,262,661,1108,294,1567,1605,1928,1079,28,0,0,28
1170,3157,8164,1812,1345,705,972,607,873,335,1511,1050,261,1894,1263,258,605,970,1324,495,1616,2862,2269,922,0,0,0,0
1171,3015,9290,2446,569,322,907,587,1199,508,779,1487,241,1603,1412,373,346,505,1791,347,2232,2227,3038,1446,16,0,0,16
1172,2127,6255,1568,559,349,643,371,764,306,602,968,251,1133,994,265,348,430,1084,345,1394,1929,1757,830,13,0,0,13
1173,1436,4441,1233,203,177,400,316,543,135,502,619,180,730,706,175,155,345,761,192,1099,1178,1327,645,13,0,0,13
1174,1879,5112,1455,424,387,572,351,569,503,435,676,265,1258,621,315,235,288,1041,178,1070,1163,1584,1117,11,0,0,11
1175,5545,16250,3105,2440,917,1391,1190,2047,647,2533,1994,371,2807,2738,782,969,1161,2633,930,4056,5358,4287,1619,0,0,0,0
1176,15155,48906,11694,3461,1624,3496,3163,6872,1725,5786,6337,1307,7406,7749,1655,1724,2697,9079,1919,13768,12205,15491,5523,140,0,0,140
1177,6538,17733,5453,1085,1138,2651,1015,1734,1487,2350,1989,712,4353,2185,1009,1313,1655,2561,817,3363,4343,5265,3945,0,0,0,0
1178,14843,45721,11570,3273,2472,4164,2518,5689,2816,5246,4438,2343,8704,6139,2300,3763,3775,5005,2349,10575,13009,12446,7342,147,0,0,147
1179,8262,27244,5722,2540,1084,2110,1499,3569,1092,3384,2520,1266,3882,4380,1640,1970,2232,2420,1729,6739,8926,6722,3128,67,0,0,67
1180,5171,18187,4018,1153,552,1224,994,2401,728,1915,1976,552,2837,2334,1165,1083,1613,1310,1231,4476,6494,4280,1706,15,0,0,15
1181,2034,5516,1590,444,508,631,310,585,438,871,573,152,1437,597,457,600,493,484,314,1039,1730,1534,899,23,0,0,23
1182,3771,11124,2436,1335,845,963,689,1274,597,1109,1126,939,2205,1566,1103,860,956,852,688,2373,3765,2835,1463,51,0,0,51
1183,1179,3678,909,270,192,321,236,430,243,631,184,121,772,407,319,391,291,178,224,731,1211,946,566,16,0,0,16
1184,1564,5289,1219,345,169,457,289,649,214,534,648,168,983,581,297,381,435,451,230,1011,1777,1595,676,18,0,0,18
1185,5644,19197,4540,1104,637,1535,1066,2406,667,1669,2491,817,3215,2429,852,1172,1947,1673,1084,4158,6288,5429,2238,45,0,0,45
1186,5514,18763,3919,1595,766,1362,1084,2302,784,2200,1517,1013,3511,2003,1346,1470,1380,1318,974,3872,6090,5267,2560,21,0,0,21
1187,2542,7821,1709,833,498,755,450,839,689,1116,392,345,1552,990,531,1011,634,366,452,1568,2512,2027,1262,0,0,0,0
1188,2966,9161,1516,1450,632,771,511,1052,831,1021,634,480,1879,1087,1210,895,515,346,633,2027,3203,2102,1196,30,0,0,30
1189,2422,7014,687,1735,558,601,455,808,436,1189,584,213,1450,972,1206,695,264,257,505,1519,2617,1618,755,58,0,0,58
1190,1559,4355,257,1302,367,435,292,465,319,699,387,154,782,777,851,467,183,58,354,1094,1691,912,304,8,0,0,8
1191,1809,5874,831,978,311,449,345,704,365,567,587,290,1131,678,735,603,309,162,445,1424,2063,1301,641,0,0,0,0
1192,1339,4526,966,373,197,386,237,519,243,394,542,160,916,423,217,538,373,211,249,917,1556,1150,654,15,0,0,15
1193,2641,7474,1131,1510,610,730,518,783,375,1008,1007,251,1714,927,822,1108,374,337,504,1534,2739,1752,945,29,0,0,29
1194,1638,4503,973,665,460,444,270,464,456,492,380,310,1150,488,677,348,397,216,210,835,1353,1163,942,0,0,0,0
1195,5167,18247,4093,1074,594,1407,931,2235,616,1848,1616,1087,3456,1711,1180,1091,1202,1694,876,3857,5641,5276,2597,122,0,0,122
1196,2778,8950,1766,1012,455,789,506,1028,344,898,930,606,1706,1072,350,654,1015,759,489,1665,3141,2330,1325,22,0,0,22
1197,1123,3794,478,645,171,257,239,456,105,506,315,197,562,561,515,253,175,180,278,992,1342,776,406,10,0,0,10
1198,1502,4485,666,836,318,465,276,443,255,683,372,192,948,554,398,513,374,217,263,844,1591,1179,608,211,0,0,211
1199,3263,9244,1294,1969,873,805,537,1048,550,1045,1530,138,2177,1086,1107,1166,776,214,630,1960,3218,1980,1456,21,0,0,21
1200,2835,9058,1819,1016,450,866,507,1012,357,1176,886,416,1725,1110,507,927,916,485,526,1746,3115,2398,1273,42,0,0,42
1201,1239,4626,904,335,120,293,261,565,181,397,403,258,663,576,228,421,419,171,306,1011,1673,1086,550,7,0,0,7
1202,977,3538,433,544,118,198,201,460,154,302,309,212,512,465,410,299,242,26,236,889,1302,756,355,9,0,0,9
1203,1591,5668,771,820,244,332,283,732,272,518,517,284,903,688,626,413,243,309,379,1352,2107,1269,561,22,0,0,22
1204,935,2936,389,546,214,213,142,366,299,263,230,143,609,326,501,186,185,63,186,636,1059,673,382,0,0,0,0
1205,1367,3699,799,568,393,396,196,382,378,477,411,101,1001,366,479,480,252,156,198,664,1224,1022,591,1,0,0,1
1206,1795,6106,838,957,310,393,329,763,409,586,458,342,1148,647,760,417,338,280,440,1431,2254,1439,542,8,0,0,8
1207,1784,6418,1290,494,238,420,289,837,143,705,462,474,1094,690,298,774,489,223,376,1473,2254,1576,739,0,0,0,0
1208,2497,8266,1132,1365,497,591,428,981,374,1008,612,503,1486,1011,919,746,459,373,566,2051,3077,1831,741,18,0,0,18
1209,1680,5907,690,990,262,373,332,713,181,623,576,300,871,809,516,723,315,126,393,1439,2272,1278,525,22,0,0,22
1210,1813,7168,1176,637,186,363,313,951,209,639,731,234,840,973,715,552,340,206,421,1817,2698,1627,605,3,0,0,3
1211,1642,3992,1002,640,433,540,276,393,364,642,578,58,1201,441,439,423,365,415,225,711,1230,1155,671,6,0,0,6
1212,2105,4361,1282,823,815,787,219,284,547,988,468,102,1788,317,752,442,572,339,142,589,1039,1291,1300,0,0,0,0
1213,1097,2669,774,323,266,394,180,257,186,476,395,40,845,252,196,147,305,449,85,449,722,783,630,17,0,0,17
1214,1472,3700,1025,447,340,527,235,370,339,533,440,160,1042,430,413,249,318,492,185,693,1030,993,799,15,0,0,15
1215,1911,4790,1214,697,485,632,313,481,392,848,519,152,1240,671,409,494,398,610,207,878,1374,1353,978,1,0,0,1
1216,1261,3079,1007,254,319,444,178,320,205,549,379,128,963,298,191,290,414,366,131,490,815,908,735,0,0,0,0
1217,1792,5560,1623,169,151,635,339,667,250,551,806,185,980,812,219,327,448,798,253,1142,1450,1776,939,0,0,0,0
1218,2108,5755,1174,934,462,680,422,544,385,635,824,264,1308,800,527,609,526,446,304,869,2013,1438,1131,11,0,0,11
1219,1156,3254,852,304,230,429,188,309,245,553,288,70,869,287,280,328,237,311,135,508,950,938,723,35,0,0,35
1220,2988,7860,2260,728,728,1021,524,715,607,1031,1027,323,2333,655,655,702,835,796,314,1043,2348,2433,1722,0,0,0,0
1221,1533,4833,937,596,311,432,299,491,230,577,429,297,896,637,487,475,334,237,283,987,1732,1172,659,0,0,0,0
1222,1263,3744,507,756,392,405,184,282,225,625,309,104,1023,240,302,412,383,166,168,757,1581,759,479,629,626,0,3
1223,1138,3482,640,498,296,233,209,400,121,714,269,34,729,409,572,332,196,38,219,723,1203,902,435,20,0,0,20
1224,1513,2925,141,1372,809,364,144,196,616,694,173,30,1238,275,1112,272,90,39,181,441,939,684,680,107,0,0,107
1225,1169,2703,332,837,423,332,192,222,177,775,194,23,792,377,613,288,141,127,165,444,996,723,375,0,0,0,0
1226,1157,3490,498,659,277,303,195,382,324,306,321,206,908,249,424,467,200,66,232,692,1343,822,401,8,0,0,8
1227,1241,3372,692,549,313,391,197,340,179,618,335,109,825,416,373,490,337,41,206,588,1190,882,506,5,0,0,5
1228,755,2215,472,283,169,236,112,238,104,250,323,78,462,293,188,211,191,165,122,391,711,633,358,35,0,0,35
1229,1488,4235,781,707,315,445,252,476,235,520,546,187,929,559,480,507,316,185,276,851,1450,972,686,9,0,0,9
1230,2440,7045,1498,942,591,725,420,704,634,785,595,426,1889,551,731,613,645,451,328,1218,2096,1873,1530,37,0,0,37
1231,1165,3496,691,474,255,349,180,381,205,495,314,151,820,345,307,573,197,88,197,643,1208,884,564,26,0,0,26
1232,1178,3639,515,663,270,325,216,367,211,497,264,206,853,325,470,411,173,124,201,735,1292,943,468,90,0,0,90
1233,1238,3168,874,364,302,439,189,308,226,488,478,46,873,365,251,471,308,208,169,488,963,916,632,0,0,0,0
1234,1479,4031,457,1022,445,403,219,412,336,743,248,152,1005,474,769,394,181,135,258,810,1558,974,431,28,0,0,28
1235,1134,2722,290,844,401,346,137,250,269,686,164,15,794,340,632,316,122,64,164,488,980,751,339,10,0,0,10
1236,1515,3772,515,1000,479,473,213,350,265,761,429,60,1151,364,611,535,312,57,252,679,1389,953,499,28,0,0,28
1237,1012,2819,592,420,231,287,178,316,131,311,425,145,648,364,321,340,261,90,167,560,1026,749,317,0,0,0,0
1238,343,1172,225,118,37,130,75,101,61,170,84,28,278,65,22,105,126,90,61,177,495,287,152,177,176,0,1
1239,1000,3529,720,280,103,235,249,413,81,234,556,129,741,259,58,357,328,257,141,548,1153,972,715,25,0,0,25
1240,1394,5310,946,448,203,303,242,646,204,667,269,254,914,480,279,600,352,163,335,1055,1786,1339,795,119,0,0,119
1241,1250,3121,415,835,493,344,125,288,333,578,311,28,924,326,835,229,100,86,143,550,912,790,726,181,0,0,181
1242,2213,6010,1288,925,533,727,389,564,441,836,701,235,1671,542,587,718,453,455,326,1042,1918,1619,1105,13,0,0,13
1243,1777,5015,873,904,473,467,342,495,558,542,505,172,1229,548,679,563,339,196,281,905,1646,1232,951,70,0,0,70
1244,1685,6135,1125,560,262,409,332,682,313,485,622,265,1030,655,423,649,404,209,345,1277,2026,1549,938,68,0,0,68
1245,1642,5906,1160,482,238,375,344,685,318,617,523,184,902,740,507,497,362,276,325,1195,2035,1467,884,14,0,0,14
1246,3531,10908,2581,950,522,1155,677,1177,617,1360,1185,369,2342,1189,599,800,1128,1004,450,1668,3366,3246,2178,51,0,0,51
1247,4135,13577,3538,597,451,1129,796,1759,429,1179,1924,603,2529,1606,551,928,1134,1522,814,2802,4475,3812,1674,50,0,0,50
1248,3541,10231,2984,557,657,1099,603,1182,568,960,1731,282,1935,1606,399,726,1066,1350,518,2104,2798,2974,1837,0,0,0,0
1249,2137,6084,1312,825,420,676,336,705,302,577,952,306,1410,727,341,560,751,485,344,1153,2117,1578,892,15,0,0,15
1250,1730,5419,818,912,337,455,336,602,282,853,497,98,924,806,597,694,300,139,363,1127,2013,1358,558,47,0,0,47
1251,2348,7028,1554,794,419,664,461,804,516,1163,515,154,1630,718,987,651,355,355,397,1340,2330,1922,1039,21,0,0,21
1252,838,3750,17,821,21,215,198,404,0,461,372,5,258,580,160,459,171,48,493,920,2199,128,10,917,0,917,0
1253,1283,4182,1037,246,163,359,229,532,91,379,503,310,694,589,216,344,447,276,238,848,1478,1102,516,0,0,0,0
1254,1865,6137,1440,425,230,521,409,705,181,643,734,307,1231,634,245,715,579,326,334,1218,2085,1548,952,9,0,0,9
1255,1751,5325,889,862,365,489,278,619,296,636,584,235,1137,614,550,496,460,245,329,1022,2015,1268,691,0,0,0,0
1256,1690,5044,1166,524,359,422,349,560,397,591,430,272,1315,375,676,463,405,146,277,990,1671,1238,868,0,0,0,0
1257,2228,6876,1183,1045,459,608,402,759,444,773,619,392,1390,838,605,971,537,115,420,1482,2445,1618,911,0,0,0,0
1258,1293,4190,548,745,226,343,234,490,154,602,437,100,752,541,410,579,212,92,273,1047,1508,947,415,0,0,0,0
1259,1765,5423,699,1066,403,441,287,634,408,601,484,272,1050,715,790,574,283,118,402,1267,2040,1074,640,18,0,0,18
1260,1130,3758,398,732,165,259,253,453,166,683,241,40,550,580,521,456,116,37,309,938,1451,751,309,3,0,0,3
1261,1310,4263,921,389,195,354,289,472,306,337,495,172,871,439,365,442,306,197,253,878,1593,1030,509,21,0,0,21
1262,669,1844,134,535,188,181,90,210,92,320,203,54,451,218,227,316,92,34,126,385,724,414,195,38,0,0,38
1263,969,2866,361,608,272,191,171,335,209,341,341,78,584,385,449,355,136,29,165,587,982,694,438,22,0,0,22
1264,1936,5985,660,1276,367,542,360,667,232,947,546,211,1038,898,802,608,363,163,482,1379,2292,1282,550,0,0,0,0
1265,1221,3530,494,727,269,379,210,363,86,526,357,252,688,533,305,376,379,161,254,747,1268,802,459,35,21,0,14
1266,1450,4826,779,671,251,369,262,568,303,518,345,284,783,667,475,561,332,82,276,1116,1786,1114,534,4,0,0,4
1267,1277,3523,953,324,288,407,188,394,306,421,311,239,966,311,252,366,405,254,175,626,1021,911,790,0,0,0,0
1268,4244,11133,2958,1286,928,1568,662,1086,965,1290,1551,438,3077,1167,732,1025,1067,1420,453,1754,3062,3470,2394,19,0,0,19
1269,3913,10538,2248,1665,1049,1197,661,1006,1185,1384,804,540,3049,864,1124,1203,855,731,546,1761,3263,2666,2302,48,0,0,48
1270,6065,19962,4662,1403,763,1744,1232,2326,968,1824,1968,1305,3540,2525,924,1399,1971,1771,1150,4189,6873,5193,2557,11,0,0,11
1271,5381,16533,4263,1118,723,1636,1036,1986,607,2058,2131,585,3111,2270,715,1362,1683,1621,1019,3631,5526,4424,1933,16,0,0,16
1272,4,22,3,1,0,1,2,1,4,0,0,0,0,4,4,0,0,0,0,0,11,8,3,0,0,0,0
1273,1585,4353,958,627,361,475,321,428,321,771,332,161,1184,401,587,513,253,232,218,821,1457,1210,647,18,0,0,18
1274,2375,5999,1083,1292,696,757,392,530,541,668,848,318,1704,671,743,908,494,230,378,1066,2192,1419,944,0,0,0,0
1275,1293,3427,626,667,318,390,252,333,231,573,375,114,951,342,343,494,295,161,211,650,1425,751,390,0,0,0,0
1276,1292,3825,649,643,234,442,222,394,136,528,462,166,820,472,213,506,429,144,224,810,1517,842,432,0,0,0,0
1277,2043,6011,1474,569,359,623,424,637,374,626,870,173,1268,775,292,622,713,416,391,1217,1970,1557,876,10,0,0,10
1278,1469,4381,1231,238,191,481,304,493,282,251,564,372,891,578,168,394,449,458,348,842,1599,1075,517,0,0,0,0
1279,3270,9205,2121,1149,651,1137,523,959,539,1170,1265,296,2140,1130,554,950,932,834,562,1625,3398,2308,1312,25,0,0,25
1280,4832,10599,3168,1664,1834,1620,511,867,1416,1846,834,736,3976,856,1253,1270,1231,1078,404,1460,2480,2738,3517,0,0,0,0
1281,2488,6489,935,1553,615,815,428,630,289,916,1086,197,1659,829,505,1051,637,295,448,1218,2901,1287,635,0,0,0,0
1282,4734,14286,3125,1609,686,1461,949,1638,665,1722,1881,466,2945,1789,1111,1069,1197,1357,869,3300,4471,3919,1727,75,0,0,75
1283,1573,4121,933,640,380,484,285,424,283,746,442,102,997,576,546,491,375,161,238,892,1400,979,612,0,0,0,0
1284,2082,5302,1272,810,532,705,332,513,580,560,596,346,1594,488,508,538,541,495,259,998,1777,1345,923,23,0,0,23
1285,1845,4821,1617,228,341,711,307,486,407,813,433,192,1239,606,276,430,483,656,230,859,1196,1346,1190,0,0,0,0
1286,1701,4619,1391,310,275,700,320,406,483,483,607,128,1371,330,260,522,373,546,148,698,1095,1496,1182,6,0,0,6
1287,331,942,164,167,64,115,49,103,87,112,88,44,245,86,81,118,42,90,46,156,274,285,181,1,0,0,1
1288,3801,11306,2725,1076,546,1156,773,1326,504,1366,1084,847,2077,1724,851,1344,1130,476,618,2352,3642,3033,1661,4,0,0,4
1289,2879,8606,1680,1199,613,730,491,1045,354,1151,1025,349,1703,1176,838,913,557,571,588,1880,2991,2040,1107,0,0,0,0
1290,5287,11177,4158,1129,1643,2384,522,738,2629,1832,578,248,4859,428,1792,1841,1090,564,416,1174,2189,2678,4720,6,0,0,6
1291,3543,12283,2598,945,507,788,635,1613,400,1030,1314,799,1916,1627,654,912,893,1084,527,2895,3851,3369,1641,14,0,0,14
1292,2986,10577,2300,686,355,754,518,1359,359,762,1215,650,1718,1268,624,708,853,801,503,2266,3306,2965,1537,68,0,0,68
1293,2186,5553,1118,1068,594,770,342,480,378,890,585,333,1369,817,609,536,526,515,274,948,1829,1311,1191,25,0,0,25
1294,24,67,3,21,12,3,4,5,3,21,0,0,18,6,24,0,0,0,5,16,13,33,0,22,0,0,22
1295,2938,8323,1671,1267,664,956,493,825,445,1210,947,336,1967,971,824,845,726,543,436,1648,2920,2168,1151,104,0,0,104
1296,1575,3579,979,596,433,684,226,232,413,723,405,34,1297,278,340,333,316,586,151,494,1031,1034,869,16,0,0,16
1297,3413,8999,1363,2050,989,1025,546,853,376,1269,1361,407,2265,1148,1000,1046,846,521,482,1710,3273,2074,1460,28,0,0,28
1298,679,2588,188,491,235,214,104,126,51,250,325,53,544,135,113,209,193,164,63,300,1088,913,224,990,0,0,990
1299,1078,2283,293,785,479,327,112,160,245,556,222,55,855,223,440,337,193,108,97,285,953,546,402,57,0,0,57
1300,829,2312,398,431,242,232,115,240,137,372,248,72,539,290,312,251,147,119,129,431,841,602,309,52,0,0,52
1301,1275,3257,584,691,382,404,186,303,157,573,487,58,865,410,340,483,212,240,156,614,1116,898,473,20,0,0,20
1302,2443,7584,1318,1125,458,658,400,927,357,833,940,313,1455,988,487,792,589,575,482,1684,2644,1805,969,23,0,0,23
1303,1215,3078,1075,140,245,487,185,298,320,413,321,161,847,368,169,218,430,398,129,495,638,935,881,0,0,0,0
1304,2740,7359,1440,1300,776,820,394,750,603,952,720,465,1979,761,1010,743,595,392,388,1383,2331,1840,1417,0,0,0,0
1305,1727,5121,816,911,353,498,295,581,167,562,794,204,968,759,416,621,470,220,258,1106,1877,1342,538,9,0,0,9
1306,4971,12937,3511,1460,1300,1668,771,1232,1277,1513,1569,612,3692,1279,1376,1206,1040,1349,547,2198,3565,3552,3075,25,0,0,25
1307,2763,7065,1896,867,712,1011,390,650,640,835,1012,276,2038,725,639,521,797,806,307,1160,1919,2039,1640,44,34,0,10
1308,1548,3921,1282,266,293,670,210,375,410,554,388,196,1250,298,252,392,430,474,174,591,842,1231,1083,34,0,0,34
1309,155,294,128,27,63,60,17,15,55,44,50,6,122,33,71,29,29,26,7,27,38,75,147,0,0,0,0
1310,1063,2407,679,384,460,415,73,115,373,481,182,27,950,113,412,288,171,192,36,107,261,408,1595,463,0,0,463
1311,2611,6329,2149,462,570,1164,379,498,768,764,881,198,2236,375,440,447,660,1064,190,809,1273,1937,2120,105,0,0,105
1312,753,1849,567,186,200,278,124,151,128,373,216,36,586,167,257,211,195,90,84,297,534,590,344,39,4,0,35
1313,1678,4835,942,736,446,658,234,340,225,789,604,60,1236,442,412,334,532,400,149,844,1586,1163,1093,673,560,0,113
1314,2337,5430,1283,1054,760,775,256,546,474,1250,523,90,1750,587,581,424,444,888,185,985,1330,1474,1456,45,21,0,24
1315,801,1946,504,297,195,360,79,167,185,291,247,78,622,179,207,150,170,274,60,254,457,528,647,20,0,0,20
1316,275,651,183,92,72,120,26,57,36,99,97,43,230,45,46,59,73,97,16,73,154,199,209,42,0,0,42
1317,2225,5507,1236,989,672,722,251,580,361,1114,500,250,1751,474,674,596,492,463,256,968,1508,1431,1344,37,0,0,37
1318,2035,4689,1427,608,594,805,269,367,458,1069,419,89,1800,235,329,307,469,930,157,590,1107,1317,1518,53,0,0,53
1319,3432,9371,1817,1615,880,1123,477,952,624,1218,828,762,2262,1170,867,877,888,800,520,1939,2966,2416,1530,43,0,0,43
1320,2540,5416,1473,1067,908,913,318,401,640,1028,737,135,2176,364,641,764,459,676,205,693,1217,1548,1753,46,0,0,46
1321,2559,6667,1544,1015,681,933,367,578,724,1147,484,204,2178,381,748,773,564,474,297,1169,1896,1890,1415,16,0,0,16
1322,34,64,29,5,12,18,2,2,14,14,4,2,32,2,6,4,3,21,1,5,7,17,34,0,0,0,0
1323,3779,8047,2299,1480,1382,1362,418,617,1463,1284,923,109,3094,685,1101,981,761,936,243,1114,1708,2161,2821,3,0,0,3
1324,1835,3662,1449,386,676,797,169,193,558,750,365,162,1662,173,609,402,318,506,86,365,514,942,1755,4,0,0,4
1325,3536,9108,2129,1407,781,1308,571,876,728,1091,1266,451,2434,1102,503,971,892,1170,411,1652,2764,2506,1775,12,0,0,12
1326,1971,5181,1628,343,352,721,363,535,382,744,718,127,1448,523,420,461,301,789,214,1003,1174,1581,1209,23,0,0,23
1327,1988,4682,1111,877,573,711,317,387,430,818,584,156,1477,511,557,506,418,507,203,757,1267,1351,1104,0,0,0,0
1328,1711,4866,1084,627,349,646,299,417,314,584,616,197,1083,628,364,423,319,605,220,811,1543,1268,1024,278,0,278,0
1329,1376,3359,889,487,347,536,189,304,242,676,357,101,967,409,451,251,264,410,109,488,841,1044,877,0,0,0,0
1330,1420,3406,987,433,359,511,242,308,335,579,283,223,1052,368,296,331,359,434,156,558,935,988,769,20,0,0,20
1331,2000,5104,911,1089,576,618,319,487,293,782,794,131,1311,689,521,549,607,323,266,1025,1812,1232,769,9,0,0,9
1332,2098,4744,856,1242,773,698,281,346,512,558,905,123,1565,533,508,590,476,524,183,671,1591,1351,948,151,0,0,151
1333,1507,4411,997,510,284,441,285,497,237,686,414,170,1093,414,244,674,387,202,225,915,1469,1115,687,32,0,0,32
1334,1538,4347,1224,314,266,528,293,451,299,487,440,312,1012,526,248,425,435,430,220,744,1263,1228,892,0,0,0,0
1335,2863,7200,1569,1294,905,837,429,692,934,877,745,307,2167,696,1003,707,636,517,390,1088,2243,1785,1694,20,0,0,20
1336,5354,14101,3985,1369,1271,1746,883,1454,1380,1708,1752,514,3851,1503,1135,1381,1206,1632,632,2744,3728,4224,2773,4,0,0,4
1337,3163,7966,1695,1468,904,1052,460,747,844,1290,562,467,2516,647,1084,965,460,654,399,1304,2713,2178,1372,23,0,0,23
1338,1490,3651,855,635,438,490,233,329,246,647,444,153,1097,393,555,408,276,251,177,607,1290,991,586,7,0,0,7
1339,2062,5269,1204,858,514,676,312,560,326,1062,558,116,1574,488,544,577,658,283,250,884,1961,1322,852,3,0,0,3
1340,2461,6774,1442,1019,467,827,487,680,231,635,1362,233,1708,753,486,701,620,654,362,1165,2821,1696,730,11,0,0,11
1341,2363,6462,1660,703,493,794,468,608,498,920,809,136,1751,612,538,545,616,664,318,1057,2340,1652,1095,98,97,0,1
1342,1479,6858,764,715,324,489,286,380,208,467,608,196,1155,324,428,506,346,199,212,1401,3623,1086,536,2791,2776,0,15
1343,1576,4467,816,760,363,444,281,488,273,805,374,124,988,588,562,586,281,147,256,779,1800,1121,511,39,0,0,39
1344,2251,5533,628,1623,771,631,329,520,525,737,717,272,1635,616,817,828,464,142,350,1017,2232,1201,733,9,0,0,9
1345,1606,3795,907,699,485,506,278,337,328,557,536,185,1133,473,411,588,424,183,230,542,1380,884,759,0,0,0,0
1346,2054,4861,1152,902,625,750,257,422,434,379,1015,226,1529,525,497,520,534,503,185,705,1581,1144,1246,5,0,0,5
1347,1885,5218,1388,497,336,658,377,514,297,775,511,302,1316,569,331,482,586,486,259,889,1743,1441,886,30,0,0,30
1348,3678,10408,1380,2298,1026,912,608,1132,708,1283,1413,274,2481,1197,1698,1268,503,209,669,2345,3995,2280,1119,39,0,0,39
1349,2560,8222,1322,1238,492,692,458,918,355,976,884,345,1422,1138,643,1083,558,276,531,1885,3054,1967,785,102,0,0,102
1350,2982,6920,1640,1342,973,1035,412,562,574,1131,1106,171,2137,845,774,725,831,652,316,1064,2040,1868,1632,42,0,0,42
1351,1344,3623,1049,295,288,504,241,311,220,515,450,159,930,414,135,314,366,529,150,612,991,926,944,120,0,0,120
1352,1225,3054,1151,74,177,608,203,237,329,332,447,117,957,268,232,177,286,530,84,464,512,900,1094,20,0,0,20
1353,3713,6209,2861,852,1647,1734,154,178,2454,898,247,114,3581,132,1043,1047,800,823,42,212,379,1057,4519,0,0,0,0
1354,2914,7688,2444,470,556,1131,430,797,642,1290,770,212,2122,792,444,644,683,1143,273,1456,1661,2361,1937,36,0,0,36
1355,1484,3480,1032,452,418,533,261,272,416,594,321,153,1077,407,532,385,366,201,112,560,981,933,894,20,0,0,20
1356,2985,7121,1622,1363,994,915,450,626,908,926,997,154,2235,750,941,755,572,717,347,1301,2145,1637,1691,58,0,0,58
1357,1700,4361,833,867,431,576,269,424,281,635,579,205,1136,564,497,346,448,409,221,843,1526,1072,699,31,0,0,31
1358,3148,7428,1383,1765,983,1118,419,628,966,921,1003,258,2457,691,981,915,879,373,345,1235,2250,1779,1819,53,0,0,53
1359,2137,5077,1413,724,582,827,358,370,269,924,852,92,1482,655,230,702,618,587,260,761,1581,1442,1033,24,0,0,24
1360,1363,2894,466,897,554,411,199,199,360,490,447,66,1009,354,576,388,255,144,115,417,1117,739,506,35,0,0,35
1361,1069,2108,129,940,534,324,94,117,151,603,206,109,841,228,429,440,128,72,115,323,972,470,228,27,0,0,27
1362,1842,3628,683,1159,800,617,198,227,508,890,363,81,1570,272,773,405,412,252,115,480,1168,883,982,8,0,0,8
1363,891,2134,370,521,259,293,144,195,141,315,307,128,697,194,234,312,220,125,84,257,884,659,250,5,0,0,5
1364,1710,3821,627,1083,549,606,269,286,218,689,677,126,1262,448,590,495,446,179,195,590,1509,976,551,20,0,0,20
1365,1754,4103,1386,368,482,667,277,328,568,711,360,115,1416,338,289,463,440,562,157,596,918,1158,1274,40,0,0,40
1366,3041,7267,2070,971,787,1280,408,566,1148,794,920,179,2400,641,581,612,698,1150,205,990,1469,2066,2537,259,0,0,259
1367,2001,5105,1423,578,539,698,310,454,730,538,654,79,1554,447,642,634,333,392,224,858,1417,1419,1187,56,0,0,56
1368,1896,4857,931,965,515,637,284,460,288,876,594,138,1272,624,468,508,502,418,228,989,1555,1319,766,40,0,0,40
1369,1620,4526,1233,387,317,533,311,459,334,529,572,185,1217,403,543,437,434,206,229,757,1531,1305,704,50,0,0,50
1370,3714,10142,2446,1268,826,1211,652,1025,662,1325,1229,498,2652,1062,953,656,1020,1085,565,1788,3386,2694,1709,37,0,0,37
1371,1954,5294,1232,722,436,622,358,538,270,596,666,422,1299,655,302,527,699,426,260,961,1853,1382,838,19,0,0,19
1372,1554,5257,730,824,270,373,280,631,288,487,537,242,930,624,433,466,496,159,329,1208,1919,1180,621,48,0,0,48
1373,2680,6936,632,2048,856,704,421,699,443,991,1083,163,1658,1022,962,1063,537,118,451,1427,2781,1470,807,55,0,0,55
1374,2808,7389,785,2023,783,860,473,692,549,932,815,512,2187,621,1025,754,631,398,439,1489,3138,1474,849,21,0,0,21
1375,2846,7343,1824,1022,826,910,409,701,426,1116,991,313,1962,884,665,1043,713,425,375,1218,2324,1801,1625,77,0,0,77
1376,2033,6578,1035,998,452,574,336,671,275,734,611,413,1305,728,699,756,445,133,380,1335,2436,1681,746,176,0,0,176
1377,2019,5834,969,1050,468,609,387,555,314,856,672,177,1291,728,758,646,471,144,337,1159,2296,1364,678,21,0,0,21
1378,2732,8953,1051,1681,558,630,421,1123,511,845,933,443,1627,1105,1107,931,512,182,537,2159,3355,2047,855,70,0,0,70
1379,1416,5519,660,756,162,291,256,707,130,311,493,482,567,849,388,460,430,138,329,1380,2061,1216,533,40,0,0,40
1380,2400,8608,1323,1077,342,583,422,1053,459,617,1012,312,1400,1000,757,785,616,242,533,2060,3056,2194,765,126,0,0,126
1381,3684,12233,2135,1549,698,1006,637,1343,623,1142,1314,605,2200,1484,968,1344,783,589,682,2435,4552,3234,1330,374,0,0,374
1382,2386,6601,1873,513,528,854,402,602,491,830,803,262,1726,660,552,568,646,620,278,1127,1919,1798,1479,20,0,0,20
1383,2376,6009,1733,643,520,1017,384,455,616,804,700,256,2024,352,618,323,519,916,195,805,1406,1706,1897,14,0,0,14
1384,2609,6109,1493,1116,755,882,435,537,583,797,895,334,1804,805,597,759,805,448,196,1048,1563,1713,1589,16,0,0,16
1385,1996,4788,1298,698,583,721,318,374,553,709,524,210,1586,410,637,438,467,454,168,700,1069,1347,1504,0,0,0,0
1386,1682,3964,1089,593,526,588,218,350,523,636,392,131,1330,352,530,436,371,345,153,607,1001,1122,1081,39,0,0,39
1387,1865,4786,1334,531,410,781,287,387,487,653,540,185,1311,554,465,471,554,375,177,625,1192,1392,1400,0,0,0,0
1388,446,1137,331,115,104,184,67,91,146,179,74,47,338,108,68,107,127,144,40,154,289,296,358,0,0,0,0
1389,1856,4171,1320,536,527,818,245,266,574,746,386,150,1551,305,331,478,444,603,137,449,928,1218,1439,14,0,0,14
1390,1556,3167,1021,535,609,589,190,168,588,551,350,67,1353,203,617,450,245,244,106,289,754,1119,899,38,0,0,38
1391,1717,3860,991,726,604,662,190,261,647,471,453,146,1464,253,577,498,332,310,125,532,1074,1234,895,123,0,0,123
1392,1817,4177,1324,493,564,689,254,310,544,469,722,82,1221,596,470,565,423,359,157,573,1016,1225,1206,0,0,0,0
1393,1474,3347,1100,374,453,585,220,216,376,459,504,135,1188,286,404,378,341,351,129,396,877,1009,936,0,0,0,0
1394,2908,9265,2208,700,384,887,564,1073,352,726,1426,404,1472,1436,437,566,899,1006,460,2033,2827,2656,1289,67,0,0,67
1395,3231,8823,2240,991,784,1009,502,936,800,1119,790,522,2139,1092,902,713,969,647,402,1701,2610,2347,1763,45,0,0,45
1396,3584,9888,2939,645,708,1212,607,1057,785,1026,1312,461,2454,1130,735,840,945,1064,431,1885,2495,3054,2023,88,0,0,88
1397,2138,5114,1396,742,611,789,243,495,667,714,595,162,1724,414,559,651,494,434,202,780,1312,1435,1385,0,0,0,0
1398,1534,3608,978,556,365,654,212,303,348,584,527,75,1156,378,431,392,300,411,155,512,895,1043,1003,0,0,0,0
1399,1621,4382,725,896,419,526,205,471,296,636,587,102,1161,460,463,465,323,370,236,811,1521,1096,718,25,0,0,25
1400,927,2216,677,250,230,402,126,169,268,317,266,76,724,203,169,185,213,360,68,252,460,645,791,39,0,0,39
1401,1298,3421,861,437,291,572,175,260,344,334,491,129,1090,208,267,263,332,436,108,457,866,1073,917,33,0,0,33
1402,3921,10342,2497,1424,962,1309,575,1075,788,1443,1329,361,2898,1023,1183,1000,1016,722,513,1826,3155,2660,2188,24,0,0,24
1403,1829,3759,1402,427,619,834,181,195,744,664,412,9,1584,245,593,628,306,302,105,297,721,1081,1555,43,0,0,43
1404,1060,2689,905,155,234,450,175,201,325,322,340,73,886,174,213,173,172,502,79,385,537,823,865,55,0,0,55
1405,1091,2924,862,229,213,399,181,298,178,435,338,140,706,385,179,214,201,497,125,495,775,908,621,35,0,0,35
1406,679,1563,569,110,155,302,100,122,129,184,329,37,542,137,97,88,160,334,59,179,280,564,481,0,0,0,0
1407,2656,6843,1692,964,800,719,474,663,724,955,757,220,1835,821,734,721,507,694,348,1395,1830,1933,1337,127,0,0,127
1408,2305,5575,1585,720,616,896,298,495,473,830,790,212,1812,493,344,840,511,610,228,910,1418,1520,1499,0,0,0,0
1409,3106,7912,2175,931,832,1028,492,754,590,1162,1111,243,2305,801,440,799,682,1185,362,1356,2057,2315,1822,21,0,0,21
1410,2074,5321,1100,974,567,654,373,480,506,640,694,234,1330,744,697,438,461,478,282,1022,1809,1436,772,29,0,0,29
1411,2596,6561,1500,1096,795,806,397,598,985,627,692,292,1973,623,896,498,515,687,326,1094,1815,1770,1556,82,0,0,82
1412,4137,11138,2374,1763,967,1374,704,1092,1063,1470,1340,264,3005,1132,1157,1137,737,1106,566,2129,3180,3078,2185,128,0,0,128
1413,939,2290,807,132,212,390,146,191,328,247,325,39,776,163,238,207,227,267,65,380,449,712,684,15,0,0,15
1414,2738,7376,2370,368,457,1092,459,730,669,966,839,264,1915,823,530,496,466,1246,288,1340,1577,2207,1964,41,0,0,41
1415,1621,3809,960,661,518,596,217,290,343,704,489,85,1345,276,418,286,376,541,141,523,892,1097,1156,27,0,0,27
1416,637,1332,367,270,240,244,72,81,242,254,118,23,596,41,238,164,128,107,40,164,273,354,501,3,0,0,3
1417,144,359,87,57,36,55,26,27,25,66,47,6,94,50,36,13,25,70,15,62,95,109,78,8,2,0,6
1418,1652,3919,1179,473,469,626,267,290,403,627,386,236,1407,245,359,327,412,554,123,577,824,1247,1148,19,0,0,19
1419,1321,3124,858,463,356,435,227,303,299,565,371,86,1000,321,374,259,284,404,117,594,713,979,721,3,0,0,3
1420,2764,7489,2230,534,507,926,509,822,514,1177,846,227,1687,1077,251,636,603,1274,301,1748,1398,2448,1594,32,10,0,22
1421,3182,7598,1756,1426,1138,913,427,704,1149,1059,676,298,2550,632,1013,818,608,743,358,1280,1958,1915,2087,190,24,0,166
1422,2300,5937,1993,307,516,783,415,586,518,814,787,181,1586,714,358,605,557,780,270,1104,1311,1811,1441,43,0,0,43
1423,2404,6296,1967,437,531,836,420,617,566,730,931,177,1693,711,352,275,429,1348,256,1255,1296,1902,1587,65,0,0,65
1424,1909,4111,816,1093,808,637,226,238,301,715,514,379,1618,291,456,396,543,514,178,557,1482,957,937,17,0,0,17
1425,2420,5937,1615,805,742,839,368,471,689,739,713,279,1841,579,621,471,491,837,238,823,1608,1740,1528,56,0,0,56
1426,2166,5338,1975,191,429,966,325,446,544,581,946,95,1655,511,249,232,434,1251,199,852,934,1581,1772,0,0,0,0
1427,2855,8182,1346,1509,806,884,415,750,768,1153,685,249,2066,789,773,730,386,966,432,1693,2622,1945,1490,607,481,0,126
1428,2654,10496,646,2008,419,472,341,1422,262,785,724,883,1309,1345,830,795,547,482,663,2304,4482,2218,829,68,0,0,68
1429,1856,4611,935,921,508,640,304,404,282,754,715,105,1341,515,416,469,371,600,303,671,1575,1272,790,31,0,0,31
1430,2745,6121,828,1917,1093,809,374,469,517,1345,767,116,2409,336,858,771,478,638,292,795,2255,1764,1015,195,0,0,195
1431,3721,8648,1766,1955,1231,1232,510,748,738,1384,1431,168,2808,913,879,821,815,1206,430,1362,2656,2391,1809,48,4,0,44
1432,2072,4800,1210,862,658,711,256,447,372,676,935,89,1369,703,363,323,391,995,180,865,1124,1543,1088,43,0,0,43
1433,1310,3150,881,429,374,403,241,292,200,514,477,119,895,415,235,258,176,641,156,644,665,1089,596,14,0,0,14
1434,2257,5300,1529,728,617,822,391,427,522,633,983,119,1687,570,547,379,561,770,195,855,1199,1813,1238,14,0,0,14
1435,796,2320,695,101,128,238,122,308,148,350,254,44,435,361,80,75,129,512,117,592,418,677,516,50,0,0,50
1436,1827,4757,1301,526,432,611,283,501,373,872,554,28,1208,619,367,258,257,945,187,1105,941,1462,1062,18,0,0,18
1437,3175,7122,1714,1461,1078,1070,398,629,767,1347,845,216,2413,762,707,629,489,1350,301,1263,1538,2064,1956,0,0,0,0
1438,2068,5003,1156,912,561,641,333,533,352,821,828,67,1548,520,178,457,275,1158,183,667,1623,1746,784,15,0,0,15
1439,0,0,0,0,0,0,0,0,0,0,0,0,0,0,0,0,0,0,0,0,0,0,0,0,0,0,0
1440,2940,6604,1754,1186,987,989,395,569,714,1200,806,220,1963,977,656,422,474,1388,236,1231,1389,2133,1615,13,0,0,13
1441,2505,6116,1550,955,693,780,418,614,691,965,794,55,1506,999,336,498,395,1276,308,1269,1509,1889,1141,4,0,0,4
1442,2331,5955,1669,662,586,695,399,651,440,983,763,145,1454,877,250,296,363,1422,258,1426,1116,1956,1199,11,0,0,11
1443,2038,4469,1152,886,836,586,240,376,636,844,470,88,1515,523,304,355,472,907,164,804,887,1328,1286,115,0,0,115
1444,1913,4220,878,1035,747,637,215,314,494,743,595,81,1421,492,380,516,293,724,179,735,1037,1224,1045,109,103,0,6
1445,2500,6273,1546,954,651,767,405,677,368,1050,925,157,1719,781,334,235,463,1468,240,1459,1296,1959,1319,2,0,0,2
1446,2472,5830,1582,890,666,941,316,549,597,1284,535,56,1758,714,286,308,523,1355,233,1051,1130,1707,1709,0,0,0,0
1447,901,2131,645,256,246,323,106,226,268,356,247,30,601,300,120,109,111,561,65,437,299,615,715,0,0,0,0
1448,4393,7935,2287,2106,1914,1734,412,333,1132,2133,1042,86,3982,411,772,761,1093,1767,266,544,2163,2699,2263,158,0,0,158
1449,1143,2734,274,869,343,388,197,215,164,652,309,18,722,421,491,196,161,295,139,536,996,696,367,19,0,0,19
1450,2740,6877,1991,749,654,965,468,653,417,1124,1026,173,1585,1155,224,419,425,1672,341,1377,1597,2195,1367,22,0,0,22
1451,1927,4876,1548,379,483,628,294,522,431,658,733,105,1147,780,294,225,262,1146,210,1059,941,1629,1037,0,0,0,0
1452,1923,4560,1296,627,576,641,260,446,332,867,609,115,1347,576,238,286,285,1114,190,867,993,1534,976,13,0,0,13
1453,273,681,166,107,68,104,50,51,47,126,89,11,178,95,68,25,47,133,28,118,181,206,148,15,4,0,11
1454,991,2127,587,404,379,356,131,125,291,437,162,101,878,113,376,183,126,306,57,247,455,553,815,27,0,0,27
