TAZ1454,AGREMPN,FPSEMPN,HEREMPN,MWTEMPN,OTHEMPN,RETEMPN,TOTEMP
1,6,16960,1464,589,1778,397,21194
2,23,21297,3002,1568,5044,372,31306
3,0,1065,400,3,470,34,1972
4,2,16088,3222,852,3779,523,24466
5,0,7384,4398,1242,1879,3391,18294
6,0,587,3306,36,192,82,4203
7,0,1999,5370,1344,79,389,9181
8,0,1011,3288,92,529,118,5038
9,0,1162,5556,7,2164,118,9007
10,0,5566,15457,1543,12414,297,35277
11,0,4127,4170,209,3032,2691,14229
12,0,11143,6821,1214,1564,2694,23436
13,4,16078,1673,585,2374,196,20910
14,5,23837,954,9308,4809,75,38988
15,0,9251,1101,7127,2903,122,20504
16,16,18907,2568,2872,9061,346,33770
17,6,7844,1727,2769,5672,418,18436
18,1,3216,2425,559,3045,322,9568
19,0,5768,5556,593,3077,1332,16326
20,0,2640,1705,816,1539,608,7308
21,16,9201,2784,3971,1676,321,17969
22,8,9838,2789,299,2596,269,15799
23,0,6630,1264,611,2184,210,10899
24,4,9738,2807,326,4382,593,17850
25,0,242,1548,17,28,159,1994
26,0,3019,1266,199,1111,46,5641
27,0,74,1607,0,0,104,1785
28,0,153,574,3,33,25,788
29,0,582,1572,35,8,17,2214
30,0,222,830,532,79,114,1777
31,0,407,1992,13,15,17,2444
32,0,242,1343,12,50,355,2002
33,0,310,850,82,57,96,1395
34,0,226,771,24,32,170,1223
35,2,167,346,8,2,24,549
36,11,307,1786,24,72,269,2469
37,0,770,1617,165,243,83,2878
38,0,661,681,255,128,160,1885
39,4,135,666,13,25,24,867
40,4,830,1102,472,42,217,2667
41,0,3312,2511,401,54,1004,7282
42,3,29,457,27,186,1,703
43,0,648,1319,50,37,276,2330
44,0,350,877,14,169,74,1484
45,3,674,1508,161,296,228,2870
46,0,817,1622,23,198,46,2706
47,0,710,2288,93,65,113,3269
48,0,147,716,72,18,88,1041
49,0,177,1087,7,21,3,1295
50,1,281,1235,32,123,419,2091
51,0,68,351,37,23,111,590
52,20,1863,2495,566,1493,352,6789
53,0,17,1334,0,60,2,1413
54,0,62,726,15,37,190,1030
55,0,42,240,19,19,42,362
56,0,197,3539,0,2,0,3738
57,0,36,221,10,5,0,272
58,0,70,647,30,22,46,815
59,0,124,825,69,90,18,1126
60,0,22,770,1,9,10,812
61,0,749,436,2,11,26,1224
62,0,174,1001,42,78,155,1450
63,0,129,566,4,76,90,865
64,0,82,421,9,48,131,691
65,2,299,850,28,124,281,1584
66,0,192,1202,35,45,267,1741
67,0,78,577,10,28,42,735
68,0,256,775,0,44,49,1124
69,0,265,11232,21,54,322,11894
70,0,493,1327,23,149,535,2527
71,11,373,2205,16,35,134,2774
72,0,282,1033,20,10,67,1412
73,0,118,1223,25,59,322,1747
74,0,453,2729,21,16,199,3418
75,0,800,4073,47,41,416,5377
76,0,385,1043,20,1704,142,3294
77,0,181,1628,7,59,149,2024
78,0,90,1308,23,3,6,1430
79,0,475,7759,387,4121,169,12911
80,0,181,455,14,18,16,684
81,8,438,12013,52,107,62,12680
82,0,524,593,15,37,267,1436
83,0,423,133,14,20,19,609
84,0,247,1438,42,65,30,1822
85,0,195,678,54,188,174,1289
86,0,48,982,5,31,52,1118
87,0,119,1865,8,21,26,2039
88,12,197,657,40,200,439,1545
89,0,164,856,62,54,103,1239
90,0,183,420,0,39,9,651
91,1,82,388,7,45,8,531
92,0,38,147,0,16,5,206
93,0,143,211,52,49,4,459
94,0,160,572,10,14,195,951
95,0,205,322,8,73,13,621
96,0,109,109,8,26,6,258
97,0,102,966,109,30,104,1311
98,0,177,430,11,37,180,835
99,0,89,504,180,18,14,805
100,0,813,1312,57,104,240,2526
101,0,560,2033,163,234,384,3374
102,0,171,922,224,76,222,1615
103,0,251,558,28,23,122,982
104,0,414,967,5,61,340,1787
105,1,182,1421,58,106,151,1919
106,0,1134,2567,97,404,498,4700
107,0,2446,26163,15406,11719,1557,57291
108,0,1172,2853,561,478,235,5299
109,0,3301,1236,449,2645,140,7771
110,0,4564,3019,1621,118,259,9581
111,0,2069,2855,1093,1586,506,8109
112,0,301,266,261,89,47,964
113,0,184,446,137,233,19,1019
114,0,281,419,111,125,328,1264
115,0,212,416,15,1,13,657
116,0,3569,2258,530,982,1028,8367
117,0,361,468,34,27,21,911
118,0,53,430,3,27,73,586
119,0,26,310,2,18,78,434
120,0,150,441,33,153,55,832
121,0,103,231,95,94,111,634
122,0,301,395,73,111,39,919
123,0,369,1509,103,94,224,2299
124,0,35,184,4,23,86,332
125,0,21,124,1,14,6,166
126,0,45,208,7,43,0,303
127,0,71,488,1,44,107,711
128,0,216,358,64,36,38,712
129,0,109,158,23,31,1,322
130,6,278,398,2,21,157,862
131,0,75,193,85,70,2,425
132,0,94,327,42,14,188,665
133,0,172,2689,23,105,67,3056
134,0,120,604,74,83,54,935
135,0,95,419,10,32,114,670
136,0,49,1072,2,43,0,1166
137,0,33,282,1,50,65,431
138,0,157,1172,27,1412,227,2995
139,0,149,551,66,119,119,1004
140,0,0,206,51,16,42,315
141,0,38,206,8,94,13,359
142,0,1851,1464,4290,3880,807,12292
143,0,89,655,94,224,42,1104
144,0,188,523,2,12,0,725
145,0,84,671,25,360,0,1140
146,0,30,44,44,1,0,119
147,0,224,446,597,536,40,1843
148,0,160,422,663,1000,292,2537
149,0,434,289,57,230,2,1012
150,2,387,718,184,770,204,2265
151,0,1,122,8,5,25,161
152,0,575,285,1,20,10,891
153,0,17,211,25,22,0,275
154,0,57,441,33,8,162,701
155,0,24,305,0,30,3,362
156,0,5,180,0,10,2,197
157,0,0,173,7,4,5,189
158,0,9,326,0,3,0,338
159,0,16,322,3,28,32,401
160,0,31,211,7,10,0,259
161,0,28,341,4,26,13,412
162,0,63,376,14,70,63,586
163,0,12,379,7,34,12,444
164,4,2547,453,27,31,106,3168
165,0,74,944,5,57,145,1225
166,0,36,904,7,116,12,1075
167,0,20,355,3,53,14,445
168,0,44,527,14,74,1,660
169,0,221,763,27,154,53,1218
170,0,416,1345,43,169,124,2097
171,18,37,311,144,36,120,666
172,3,47,474,37,80,115,756
173,0,31,109,7,36,32,215
174,0,55,309,8,85,6,463
175,0,207,876,23,34,161,1301
176,0,79,335,10,18,51,493
177,0,285,1010,51,60,187,1593
178,0,86,372,15,60,12,545
179,0,57,607,19,94,4,781
180,0,33,385,14,30,70,532
181,0,37,691,51,84,30,893
182,0,24,405,17,113,37,596
183,0,32,1361,15,55,127,1590
184,0,135,483,30,71,114,833
185,0,280,1435,19,90,130,1954
186,1,201,1114,34,125,70,1545
187,26,656,222,9,55,266,1234
188,0,130,6782,1,11,862,7786
189,0,282,592,4,0,8,886
190,0,17,924,80,5,0,1026
191,0,107,248,6,42,23,426
192,0,197,540,5,14,716,1472
193,4,287,1334,122,504,85,2336
194,0,39,2707,15,115,45,2921
195,0,29,210,6,32,0,277
196,0,30,225,5,17,5,282
197,0,34,246,0,4,158,442
198,0,28,758,31,0,17,834
199,0,138,513,5,32,1249,1937
200,41,278,926,95,89,2602,4031
201,0,97,562,137,129,272,1197
202,0,21,355,12,56,8,452
203,0,405,887,61,859,232,2444
204,0,68,371,11,36,134,620
205,0,50,223,5,15,1,294
206,0,58,69,2,22,3,154
207,0,43,349,283,8,43,726
208,45,2958,741,2899,980,516,8139
209,0,53,371,38,54,2,518
210,0,146,257,144,148,69,764
211,54,437,641,98,149,191,1570
212,258,11989,5966,31937,3497,1319,54966
213,0,112,951,16,116,168,1363
214,0,83,431,6,314,71,905
215,0,66,296,5,1,78,446
216,0,33,3124,2,32,139,3330
217,0,120,261,9,49,62,501
218,0,322,1416,47,92,276,2153
219,0,0,220,1,18,67,306
220,0,30,260,0,36,14,340
221,0,28,180,3,23,80,314
222,0,62,488,33,32,122,737
223,0,164,567,56,324,103,1214
224,0,30,245,23,80,15,393
225,0,108,521,24,93,90,836
226,3,117,479,3,102,186,890
227,6,41,171,45,63,4,330
228,0,0,21,0,0,0,21
229,0,37,950,4,11,15,1017
230,0,41,766,200,13,378,1398
231,0,23,167,29,8,1,228
232,0,87,305,5,33,8,438
233,0,54,264,12,53,94,477
234,0,1447,1111,362,2670,1475,7065
235,0,24,400,17,384,9,834
236,0,438,512,21,62,107,1140
237,0,200,805,32,37,159,1233
238,0,107,395,483,100,37,1122
239,0,1253,2655,1924,56,425,6313
240,0,368,1894,158,137,293,2850
241,0,113,331,9,120,0,573
242,0,28,240,3,13,5,289
243,0,30,76,8,11,1,126
244,0,138,504,45,189,251,1127
245,0,21,294,8,34,0,357
246,0,719,3883,65,136,179,4982
247,0,23,138,4,27,0,192
248,0,9294,3768,3372,1290,381,18105
249,0,1717,1479,1377,541,254,5368
250,0,94,431,18,146,56,745
251,0,1199,1376,131,641,982,4329
252,0,462,885,87,191,0,1625
253,0,43,92,24,24,28,211
254,8,128,377,12,40,0,565
255,0,81,349,19,8,14,471
256,0,1155,945,31,72,2,2205
257,1,1921,3756,168,1035,670,7551
258,0,179,724,18,117,13,1051
259,0,115,1190,167,104,125,1701
260,0,423,566,104,191,87,1371
261,0,72,370,25,71,22,560
262,0,139,434,27,75,64,739
263,0,4,165,48,55,2,274
264,0,419,431,24,90,110,1074
265,0,4299,892,299,3390,747,9627
266,0,9839,1999,2319,2201,614,16972
267,0,56,407,23,26,0,512
268,0,26,625,37,5,0,693
269,0,43,341,28,10,74,496
270,0,25,40,3,151,0,219
271,0,140,202,70,5,168,585
272,0,23,131,1,5,7,167
273,0,24,47,4,10,7,92
274,0,1655,320,16,326,68,2385
275,0,736,455,177,383,192,1943
276,0,34,167,58,17,20,296
277,0,73,472,49,41,22,657
278,0,2739,1114,91,2060,559,6563
279,0,2859,1398,312,1272,534,6375
280,0,1366,926,91,164,287,2834
281,0,871,1155,143,499,224,2892
282,12,4945,500,61,171,95,5784
283,0,10,276,10,7,2,305
284,0,425,2103,20,79,1409,4036
285,0,12,233,10,5,0,260
286,0,134,838,48,87,230,1337
287,0,359,632,26,178,31,1226
288,0,139,1082,27,50,138,1436
289,0,73,285,15,26,43,442
290,0,30,44,53,31,0,158
291,0,279,1438,424,292,109,2542
292,0,51,192,11,23,24,301
293,23,89,230,168,88,55,653
294,12,114,594,66,122,96,1004
295,57,91,505,348,127,176,1304
296,183,592,2073,130,258,342,3578
297,520,73,625,54,84,47,1403
298,128,497,1101,79,81,80,1966
299,25,226,504,11,214,147,1127
300,0,128,839,38,61,4,1070
301,0,83,405,4,93,68,653
302,10,167,84,10,50,5,326
303,0,126,520,16,34,4,700
304,10,63,1090,21,45,0,1229
305,0,11,99,4,3,0,117
306,0,45,123,4,25,2,199
307,0,169,339,93,26,5,632
308,0,58,208,68,89,3,426
309,0,1249,1956,50,206,467,3928
310,0,4350,2427,2148,2196,1285,12406
311,1,6635,3093,2065,5261,150,17205
312,0,169,181,175,186,2,713
313,9,3265,2319,1475,2644,519,10231
314,0,1093,4238,1112,1059,261,7763
315,0,3860,5853,512,13503,970,24698
316,0,89,92,15,61,80,337
317,0,286,1291,104,94,43,1818
318,0,143,288,5,90,10,536
319,0,57,193,0,58,6,314
320,0,59,400,6,103,1,569
321,0,229,377,13,69,150,838
322,0,194,316,52,24,32,618
323,0,167,555,149,85,458,1414
324,0,101,338,0,126,162,727
325,0,91,105,0,80,234,510
326,0,108,450,99,260,514,1431
327,0,121,503,52,25,157,858
328,0,202,180,46,42,21,491
329,0,1077,650,435,760,155,3077
330,0,121,269,21,121,48,580
331,24,4470,973,3313,28631,97,37508
332,19,2816,1315,610,730,34,5524
333,0,69,738,16,45,454,1322
334,0,180,574,20,100,77,951
335,4,961,209,24,13,372,1583
336,0,390,276,25,13,208,912
337,0,34,194,5,155,0,388
338,0,50,56,0,24,0,130
339,0,49,833,0,116,0,998
340,10,2300,827,166,1605,30,4938
341,0,1577,2539,61,602,819,5598
342,0,145,1751,20,33,24,1973
343,0,65,558,0,18,3,644
344,0,35,171,42,10,0,258
345,0,353,369,16,26,31,795
346,6,4638,1215,908,948,90,7805
347,117,392,2231,188,106,13,3047
348,0,3691,215,223,6410,0,10539
349,0,7757,4532,4059,1136,151,17635
350,0,728,180,14,3,101,1026
351,20,2425,2598,134,516,197,5890
352,0,0,126,0,61,0,187
353,0,37,145,1,10,47,240
354,1,532,19777,1,5,35,20351
355,2,407,25793,126,48,1907,28283
356,0,7678,4502,605,9212,847,22844
357,0,296,413,39,95,3,846
358,0,278,573,24,57,10,942
359,0,288,389,69,67,17,830
360,3,215,277,7,48,16,566
361,0,187,446,43,36,114,826
362,0,954,882,1964,97,62,3959
363,0,66,678,3,9,155,911
364,0,28,349,10,0,92,479
365,0,280,314,25,181,81,881
366,0,1523,1303,1534,649,311,5320
367,0,4394,1271,66,106,94,5931
368,1,132,370,40,18,2,563
369,0,313,753,14,48,7,1135
370,12,1608,1322,53,591,309,3895
371,0,520,1410,15,141,196,2282
372,0,498,1303,72,213,963,3049
373,0,2034,509,41,611,113,3308
374,8,1587,850,731,866,671,4713
375,0,102,300,0,13,5,420
376,19,882,872,736,165,116,2790
377,0,505,170,214,2221,40,3150
378,0,5109,2543,70,1555,109,9386
379,9,83,533,8,289,10,932
380,0,23,303,66,32,45,469
381,0,280,552,93,353,236,1514
382,0,109,277,11,2,24,423
383,0,152,4301,146,114,88,4801
384,0,128,581,10,17,25,761
385,0,87,65,15,14,0,181
386,0,32,136,22,8,14,212
387,0,83,436,8,80,203,810
388,0,259,1534,36,53,19,1901
389,0,200,1193,53,53,277,1776
390,0,170,258,95,47,40,610
391,0,431,2007,4,23,484,2949
392,0,158,164,0,5,27,354
393,0,47,396,383,60,69,955
394,0,180,586,44,222,23,1055
395,0,5122,179,866,489,14,6670
396,0,1809,578,984,231,2,3604
397,0,1737,253,494,628,151,3263
398,0,549,353,210,449,240,1801
399,0,6791,301,1097,3806,229,12224
400,0,86,307,12,17,9,431
401,2,7486,4074,3553,31484,465,47064
402,0,1561,363,4936,1185,0,8045
403,0,7651,773,3699,18078,23,30224
404,0,939,496,1238,3314,7,5994
405,0,2219,633,969,280,762,4863
406,0,4928,961,7020,1146,165,14220
407,1,2826,1390,4849,2913,681,12660
408,0,13233,565,3346,1643,237,19024
409,0,7035,1623,6942,791,51,16442
410,0,4643,493,3011,511,19,8677
411,0,1,0,749,0,0,750
412,2,3854,1220,16518,110,284,21988
413,0,187,511,1745,22,138,2603
414,0,2310,1316,4055,2300,258,10239
415,6,10417,3031,3310,1620,237,18621
416,0,3322,413,756,642,28,5161
417,0,2068,135,3475,209,14,5901
418,0,944,374,2107,398,63,3886
419,0,51,210,11,14,12,298
420,0,4,179,1,8,34,226
421,0,125,210,57,37,252,681
422,0,229,343,183,928,17,1700
423,0,26,210,32,6,55,329
424,0,97,421,68,15,47,648
425,0,27,201,3,365,75,671
426,0,138,203,1114,7,225,1687
427,0,7512,1474,2915,946,300,13147
428,1,6085,1041,1782,385,568,9862
429,1,3189,748,6283,212,13,10446
430,0,9542,819,8079,1480,283,20203
431,0,1703,311,1848,907,92,4861
432,0,5190,908,3396,2883,470,12847
433,0,621,922,476,1220,61,3300
434,0,588,1327,2571,722,717,5925
435,2,11048,1764,2606,2995,253,18668
436,0,131,1075,90,33,325,1654
437,0,26,257,10,28,124,445
438,0,52,509,5,18,61,645
439,34,97,610,8,7,239,995
440,0,90,893,18,13,37,1051
441,0,190,594,9,64,127,984
442,0,48,437,8,17,47,557
443,0,29,170,1,51,8,259
444,4,194,839,110,54,41,1242
445,0,130,437,8,14,95,684
446,0,99,193,27,7,81,407
447,0,216,331,13,7,93,660
448,0,299,767,26,22,387,1501
449,0,192,1111,13,18,387,1721
450,0,2189,1630,340,429,512,5100
451,2,114,748,9,66,328,1267
452,0,20,1235,15,11,3,1284
453,0,190,884,275,34,354,1737
454,0,96,1175,54,50,14,1389
455,0,25,539,11,14,114,703
456,0,200,346,41,17,12,616
457,0,84,166,0,18,0,268
458,0,47,208,0,3,12,270
459,0,145,743,6,44,130,1068
460,3,328,6285,36899,218,377,44110
461,0,107,165,5,56,13,346
462,0,309,1238,13,45,369,1974
463,0,134,88,21,64,24,331
464,0,115,166,2,10,6,299
465,0,264,1187,63,24,778,2316
466,0,167,976,172,23,4041,5379
467,3,2602,2179,83,1269,765,6901
468,0,220,750,28,103,179,1280
469,0,327,647,4,35,90,1103
470,0,150,600,125,72,83,1030
471,2,163,1157,52,63,504,1941
472,0,508,974,162,128,28,1800
473,0,114,574,38,10,33,769
474,0,13,238,11,62,8,332
475,0,165,789,36,47,762,1799
476,0,371,1633,31,89,362,2486
477,2,67,761,10,78,84,1002
478,0,831,617,73,53,1135,2709
479,0,498,797,49,60,25,1429
480,0,42,251,9,1,8,311
481,0,48,265,2,13,72,400
482,0,52,106,7,18,13,196
483,0,582,643,16,55,156,1452
484,0,943,1190,280,344,180,2937
485,0,915,1847,163,57,413,3395
486,0,377,559,74,36,487,1533
487,0,151,632,8,36,95,922
488,0,213,716,222,13,6,1170
489,0,78,502,1,35,6,622
490,0,289,2130,458,103,328,3308
491,0,77,144,18,9,259,507
492,0,315,265,20,85,166,851
493,0,214,497,6,21,3,741
494,0,386,488,29,39,90,1032
495,26,98,349,51,49,7,580
496,0,236,704,24,96,22,1082
497,37,173,1955,50,100,0,2315
498,0,320,810,33,68,139,1370
499,0,277,970,10,43,367,1667
500,0,14,209,2,37,0,262
501,0,2,131,0,34,45,212
502,0,75,503,2,14,303,897
503,0,175,1501,73,25,153,1927
504,0,1744,3656,1855,2232,664,10151
505,0,23,243,3,59,32,360
506,0,295,1393,450,38,36,2212
507,2,84,643,18,128,76,951
508,0,4542,565,941,606,0,6654
509,0,1006,559,106,300,183,2154
510,5,48,136,31,18,0,238
511,15,834,2697,255,846,327,4974
512,2,113,188,36,67,1,407
513,6,53,256,6,16,5,342
514,1,177,1085,23,64,231,1581
515,0,67,357,1,56,27,508
516,0,28,228,3,10,1,270
517,0,29,872,43,148,120,1212
518,0,410,2545,75,118,647,3795
519,0,679,5927,1611,109,39,8365
520,0,236,686,43,52,73,1090
521,1,456,1841,126,439,309,3172
522,0,194,508,9,203,69,983
523,0,131,476,9,68,643,1327
524,0,98,48,33,45,9,233
525,0,67,542,50,18,25,702
526,11,96,623,16,51,38,835
527,0,272,822,25,103,125,1347
528,17,451,918,20,133,110,1649
529,2,135,371,48,68,250,874
530,0,3678,2135,461,828,982,8084
531,0,913,1250,39,37,2517,4756
532,0,108,783,8,17,118,1034
533,0,617,7347,8,33,67,8072
534,0,382,590,421,39,73,1505
535,0,356,827,23,13,196,1415
536,0,49,506,28,58,149,790
537,0,711,1352,1138,299,264,3764
538,62,333,263,7,36,13,714
539,0,1059,2789,588,926,677,6039
540,1,1341,2074,162,107,206,3891
541,0,183,1471,20,53,180,1907
542,0,819,1567,64,767,3,3220
543,61,472,3548,132,983,99,5295
544,0,161,334,14,39,73,621
545,0,401,1012,18,37,39,1507
546,0,2368,11040,479,12215,44,26146
547,0,3182,1040,536,2493,212,7463
548,0,142,675,49,24,46,936
549,1,1643,1130,60,166,153,3153
550,0,174,404,2,24,24,628
551,0,143,630,323,188,81,1365
552,0,26,141,0,196,0,363
553,0,20,177,12,18,26,253
554,0,116,354,0,40,60,570
555,0,132,640,65,24,62,923
556,0,12,632,0,0,0,644
557,0,766,7342,172,3053,73,11406
558,14,12515,3152,320,7846,174,24021
559,0,121,416,14,49,33,633
560,0,2056,1126,207,57,5,3451
561,13,39,418,163,78,71,782
562,2,11,206,10,99,50,378
563,6,1879,3332,5136,3566,1560,15479
564,0,46,882,15,63,863,1869
565,0,751,609,166,161,6,1693
566,0,87,497,126,396,100,1206
567,0,203,695,503,281,212,1894
568,0,27,429,114,64,78,712
569,0,3,194,4,10,8,219
570,0,78,258,0,5,127,468
571,2,4,148,2,23,0,179
572,8,9,652,6,2,7,684
573,0,2,173,9,18,39,241
574,0,20,311,0,22,26,379
575,0,26,668,52,42,90,878
576,0,60,300,36,99,28,523
577,0,4,436,1,2,3,446
578,0,72,343,13,11,109,548
579,0,62,731,312,449,680,2234
580,0,32,285,128,161,57,663
581,0,18,288,1,19,126,452
582,0,136,1381,179,41,386,2123
583,0,266,1974,24,68,1229,3561
584,0,46,415,20,26,87,594
585,0,78,282,3,40,86,489
586,0,43,460,3,37,278,821
587,0,14,415,0,0,6,435
588,0,27,350,4,11,35,427
589,0,44,338,47,33,52,514
590,0,35,227,42,2,271,577
591,0,82,616,15,83,79,875
592,12,22,298,90,50,45,517
593,0,142,241,1152,1326,108,2969
594,0,81,295,12,96,19,503
595,0,166,3862,0,0,76,4104
596,0,31,576,15,11,138,771
597,0,114,583,448,32,5,1182
598,1,302,414,38,31,66,852
599,0,17,132,7,11,0,167
600,0,19,237,3,10,8,277
601,0,689,631,45,54,84,1503
602,0,1163,358,954,1919,267,4661
603,12,900,951,1504,1104,425,4896
604,0,542,2585,3079,938,108,7252
605,0,1766,1772,7395,1011,1002,12946
606,4,1395,868,1220,99,29,3615
607,0,388,1614,141,722,2521,5386
608,0,2023,1305,4865,1536,353,10082
609,0,409,644,97,781,147,2078
610,0,62,296,86,55,38,537
611,0,118,922,82,58,91,1271
612,0,483,755,798,25,69,2130
613,0,18,387,61,2,132,600
614,0,24,575,3,8,19,629
615,0,61,284,10,22,7,384
616,0,10,719,6,3,0,738
617,0,14,347,16,6,70,453
618,0,11,112,6,2,4,135
619,0,31,327,3,2,1,364
620,0,108,795,59,140,103,1205
621,0,23,421,22,8,240,714
622,0,2,394,1,6,7,410
623,0,10,229,8,20,4,271
624,0,15,88,0,0,0,103
625,0,139,637,1,17,113,907
626,0,35,356,0,1,11,403
627,0,89,509,4,90,170,862
628,73,103,550,20,27,15,788
629,0,45,272,10,44,4,375
630,0,99,651,12,24,130,916
631,0,7,865,3,15,2,892
632,0,70,737,24,33,725,1589
633,0,96,1551,51,77,18,1793
634,2,72,562,41,556,308,1541
635,0,55,368,23,68,14,528
636,0,74,458,7,40,203,782
637,5,132,117,22,121,2,399
638,0,17,295,1,21,31,365
639,0,10,255,0,65,164,494
640,0,7,236,3,32,10,288
641,0,4,367,0,13,18,402
642,3,32,91,0,36,0,162
643,0,6,320,2,15,5,348
644,0,27,572,38,8,205,850
645,0,137,880,3,16,8,1044
646,0,6,270,0,0,0,276
647,9,52,93,0,13,4,171
648,0,50,251,6,11,11,329
649,0,12,504,3,44,192,755
650,0,69,708,14,13,69,873
651,0,26,913,31,24,71,1065
652,0,236,422,14,71,54,797
653,2,144,1526,30,27,116,1845
654,0,90,390,0,23,4,507
655,0,323,619,101,68,2,1113
656,3,1755,1199,3272,933,105,7267
657,0,126,334,16,22,88,586
658,0,42,98,4,30,2,176
659,0,264,357,20,9,42,692
660,0,1589,1654,1670,642,323,5878
661,0,714,6530,2578,56,531,10409
662,0,18,185,0,33,0,236
663,0,11,203,4,28,7,253
664,0,47,281,5,68,25,426
665,0,224,492,4,22,112,854
666,0,112,196,13,16,10,347
667,0,64,357,11,12,70,514
668,0,22,249,29,51,8,359
669,0,18,567,46,43,49,723
670,0,27,694,15,49,23,808
671,0,248,324,9,37,152,770
672,0,138,232,33,15,19,437
673,0,50,399,10,18,52,529
674,0,138,654,3,57,142,994
675,0,293,500,8,42,141,984
676,0,329,1326,1253,100,582,3590
677,0,280,1461,31,61,1280,3113
678,0,22,192,9,19,5,247
679,37,41,624,49,16,394,1161
680,0,143,433,5,73,841,1495
681,0,213,657,38,39,167,1114
682,0,234,583,5,43,47,912
683,0,23,164,2,9,183,381
684,0,48,535,17,102,162,864
685,0,80,417,37,26,25,585
686,0,350,379,3,11,132,875
687,0,146,845,0,19,2150,3160
688,0,53,2050,32,27,134,2296
689,0,40,208,2,21,82,353
690,0,152,499,7,70,178,906
691,0,13,246,7,27,18,311
692,0,179,324,16,17,175,711
693,0,41,372,6,9,16,444
694,0,45,178,0,30,1,254
695,0,179,194,7,87,0,467
696,40,161,439,688,135,16,1479
697,251,1875,181,153,76,47,2583
698,84,134,804,55,78,413,1568
699,198,138,106,68,33,48,591
700,54,1687,2325,5648,971,978,11663
701,1,213,581,183,370,148,1496
702,8,595,1623,112,488,253,3079
703,10,110,196,18,62,24,420
704,33,42,173,88,88,5,429
705,86,102,1580,121,186,48,2123
706,822,364,2055,1743,657,2499,8140
707,60,519,2386,590,637,622,4814
708,0,75,666,1,237,60,1039
709,5,293,897,41,192,362,1790
710,0,261,619,3,22,119,1024
711,14,117,287,23,115,12,568
712,130,130,636,179,264,63,1402
713,61,266,241,138,259,58,1023
714,5,4,37,0,7,170,223
715,17,12725,1206,6393,2911,872,24124
716,0,571,311,457,973,42,2354
717,0,82,862,106,228,27,1305
718,0,722,631,924,1774,356,4407
719,14,76,251,25,46,22,434
720,1,447,344,672,129,49,1642
721,0,403,1278,37,307,1250,3275
722,0,76,261,47,113,39,536
723,0,332,923,69,115,73,1512
724,1,268,1887,39,76,475,2746
725,0,99,181,95,95,37,507
726,0,121,224,15,194,177,731
727,0,23,303,0,10,0,336
728,0,1867,1342,2407,1506,1956,9078
729,8,1041,2133,554,1082,985,5803
730,12,3414,2402,978,902,1604,9312
731,0,81,70,7,8,19,185
732,0,1001,2190,891,676,876,5634
733,0,568,2625,179,54,1183,4609
734,1,617,727,250,832,147,2574
735,1,45,361,65,102,6,580
736,0,4404,1439,231,6273,1586,13933
737,0,1246,1035,2124,681,439,5525
738,0,21,617,5,13,0,656
739,1,2764,2155,941,1759,311,7931
740,0,53,548,11,65,17,694
741,0,129,522,28,37,197,913
742,8,10598,7136,1982,2739,2112,24575
743,120,1486,949,738,879,185,4357
744,0,77,1541,69,344,28,2059
745,0,42,113,14,44,30,243
746,71,528,567,169,194,142,1671
747,4,39,78,5,5,3,134
748,0,34,53,2,12,5,106
749,0,165,412,731,4,44,1356
750,2,1526,773,9048,645,510,12504
751,0,4643,2144,18104,3203,4092,32186
752,0,3634,2920,20404,2220,783,29961
753,0,62,164,10,7,5,248
754,9,100,1098,37,7,42,1293
755,3,378,546,205,495,29,1656
756,0,614,543,311,596,160,2224
757,0,3,183,0,11,6,203
758,0,21,697,2,82,140,942
759,0,60,195,64,38,26,383
760,0,39,307,4,22,26,398
761,0,391,1504,21,59,301,2276
762,0,44,124,8,66,11,253
763,0,1579,2362,3,95,28,4067
764,0,96,1133,32,56,641,1958
765,0,114,560,19,20,164,877
766,0,103,382,35,78,45,643
767,0,1338,2264,5294,282,1304,10482
768,17,3534,517,3305,306,95,7774
769,2,1806,394,537,519,12,3270
770,0,210,761,117,64,236,1388
771,0,356,934,15,38,327,1670
772,0,56,67,16,57,83,279
773,0,171,486,318,367,174,1516
774,0,386,1013,435,86,196,2116
775,0,74,384,16,68,39,581
776,0,131,784,25,45,8,993
777,0,3016,3622,91,879,943,8551
778,0,1501,5869,29,265,11,7675
779,0,31,145,26,5,3,210
780,2,288,596,1,14,52,953
781,0,45,121,36,44,5,251
782,0,127,336,38,25,7,533
783,0,163,27,17,227,0,434
784,0,71,458,10,11,172,722
785,0,33,285,46,11,32,407
786,0,19,110,2,2,28,161
787,0,72,448,22,21,149,712
788,0,65,355,46,5,8,479
789,0,29,199,16,10,9,263
790,0,29,343,30,11,2,415
791,0,199,661,86,8,166,1120
792,0,11,107,1,7,0,126
793,0,87,313,19,18,60,497
794,0,70,76,20,0,26,192
795,2,611,470,972,168,17,2240
796,20,527,2130,2775,265,1336,7053
797,0,5655,792,4738,1293,294,12772
798,0,84,490,351,82,23,1030
799,0,55,120,23,9,0,207
800,0,53,1328,29,292,88,1790
801,0,519,770,343,88,319,2039
802,0,219,185,17,13,5,439
803,4,27,589,10,0,9,639
804,0,56,330,13,25,40,464
805,0,61,256,7,60,72,456
806,23,1021,1205,6183,1097,641,10170
807,0,24,129,39,11,74,277
808,0,2,138,0,5,0,145
809,0,265,406,1683,720,9,3083
810,14,6391,2531,12405,3790,2838,27969
811,0,263,1875,727,309,444,3618
812,0,676,845,21,38,567,2147
813,0,4,1593,3,3,0,1603
814,0,13,219,13,6,63,314
815,0,21,221,1,0,5,248
816,0,5,543,0,12,139,699
817,0,8,305,20,20,8,361
818,0,2,544,1,31,4,582
819,0,74,135,29,56,124,418
820,0,97,715,121,12,48,993
821,0,41,2858,12,10,46,2967
822,0,10,189,2,44,0,245
823,0,47,518,6,252,13,836
824,0,316,520,49,386,513,1784
825,0,25,156,5,11,16,213
826,0,104,274,93,182,143,796
827,0,106,1133,16,546,167,1968
828,0,357,647,55,434,539,2032
829,0,62,464,7,450,8,991
830,0,15,330,7,31,208,591
831,0,13,425,64,10,59,571
832,0,60,460,8,19,29,576
833,0,6,107,2,1,0,116
834,0,77,250,712,30,37,1106
835,0,74,267,14,9,80,444
836,0,31,128,185,103,356,803
837,0,56,575,23,183,20,857
838,0,140,589,2,25,160,916
839,0,517,1667,31,526,260,3001
840,0,197,774,23,67,226,1287
841,0,65,590,13,18,44,730
842,0,279,266,0,31,207,783
843,0,20,229,6,4,12,271
844,5,212,682,31,98,100,1128
845,0,39,610,19,47,19,734
846,0,120,507,114,29,103,873
847,0,342,433,10,123,23,931
848,0,352,2994,33,66,550,3995
849,0,44,404,13,28,64,553
850,0,71,70,28,31,1,201
851,0,51,223,5,20,0,299
852,1,25,216,5,45,44,336
853,0,34,1707,31,12,29,1813
854,0,23,328,2,11,66,430
855,0,24,588,14,23,18,667
856,0,101,664,19,84,699,1567
857,0,38,777,3,23,146,987
858,0,150,496,28,23,385,1082
859,0,18,213,4,10,42,287
860,2,482,1039,2851,1282,133,5789
861,1,409,5760,327,58,9,6564
862,0,1479,1098,1752,1965,1338,7632
863,0,120,366,32,42,397,957
864,0,245,2064,968,78,383,3738
865,1,12,436,5,36,3,493
866,0,34,697,2,33,5,771
867,0,10,123,20,15,51,219
868,0,49,251,0,34,7,341
869,0,77,623,24,504,111,1339
870,0,70,236,142,453,77,978
871,0,1297,2346,146,157,401,4347
872,0,950,567,223,254,290,2284
873,0,1498,1442,5461,2118,1764,12283
874,0,324,140,3436,0,0,3900
875,65,4754,4553,8031,2395,739,20537
876,7,0,73,11,28,0,119
877,0,54,336,36,20,71,517
878,0,115,254,221,64,51,705
879,0,26,131,161,85,56,459
880,0,0,502,3,34,32,571
881,0,6,130,3,28,11,178
882,0,89,480,1,22,118,710
883,0,21,1308,0,5,0,1334
884,0,53,230,11,31,6,331
885,0,538,935,34,10,6,1523
886,0,107,214,3,41,14,379
887,0,6,833,1,0,27,867
888,0,1,231,4,12,7,255
889,0,9,262,1,0,4,276
890,0,46,307,0,18,16,387
891,0,17,187,6,8,31,249
892,0,226,160,818,56,10,1270
893,5,208,181,137,161,14,706
894,0,260,297,425,97,0,1079
895,0,580,1083,668,164,3,2498
896,139,307,168,2086,270,554,3524
897,0,122,223,24,5,222,596
898,0,36,294,125,6,12,473
899,0,5,672,6,17,39,739
900,0,84,612,6,14,170,886
901,0,23,171,1,3,0,198
902,0,10,664,0,5,56,735
903,0,22,140,1,9,8,180
904,0,6,329,21,39,16,411
905,0,17,378,8,14,9,426
906,0,34,2136,18,6,294,2488
907,0,52,210,14,36,12,324
908,0,43,161,0,17,42,263
909,0,37,297,3,31,12,380
910,0,86,687,26,23,0,822
911,0,75,755,57,26,123,1036
912,0,61,312,46,29,14,462
913,0,509,537,133,59,290,1528
914,0,132,115,97,19,9,372
915,0,130,649,4,29,23,835
916,0,156,1382,19,3,299,1859
917,1,104,298,7,213,111,734
918,0,102,712,12,30,18,874
919,0,43,45,18,17,0,123
920,0,9,355,69,5,13,451
921,0,96,207,7,14,4,328
922,0,155,297,21,33,19,525
923,0,87,346,16,21,223,693
924,0,8,372,0,11,147,538
925,0,370,603,11,27,102,1113
926,5,750,2163,711,214,542,4385
927,0,65,837,7,2,28,939
928,0,7,350,0,10,3,370
929,0,5,479,11,23,10,528
930,0,10,935,1,26,1,973
931,0,40,2621,8,18,5,2692
932,4,0,193,7,9,2,215
933,0,11,601,57,20,34,723
934,0,91,757,10,15,58,931
935,0,8,228,0,0,2,238
936,0,14,193,0,2,3,212
937,0,46,299,22,62,219,648
938,3,130,84,10,4,2,233
939,0,329,464,59,26,156,1034
940,0,98,390,18,31,57,594
941,0,6,518,32,41,11,608
942,0,311,928,18,49,64,1370
943,0,57,385,32,4,26,504
944,0,105,332,1,9,127,574
945,0,2977,1605,23,9523,5,14133
946,0,472,1856,463,1002,127,3920
947,27,761,1935,710,592,413,4438
948,0,193,497,86,753,123,1652
949,16,40,736,125,47,189,1153
950,4,267,833,5,61,171,1341
951,0,40,425,37,5,35,542
952,0,1355,1145,2212,1033,49,5794
953,0,130,453,21,22,121,747
954,0,128,871,14,3,798,1814
955,0,49,1913,11,570,77,2620
956,0,38,371,2,25,14,450
957,0,59,822,4,5,0,890
958,0,31,260,5,2,25,323
959,0,89,307,18,13,181,608
960,0,1371,1402,500,727,139,4139
961,0,1105,631,417,31,253,2437
962,16,12,467,8,5,13,521
963,0,91,589,37,340,12,1069
964,0,234,155,435,260,62,1146
965,0,39,124,2635,43,32,2873
966,0,161,594,647,66,6,1474
967,0,1058,1787,578,656,517,4596
968,0,2016,3998,8850,2879,276,18019
969,0,6302,2426,1811,1641,393,12573
970,0,1363,1643,162,4633,179,7980
971,14,12907,5001,595,4339,69,22925
972,0,938,1403,108,205,800,3454
973,0,121,8866,13,26,24,9050
974,3,251,1426,39,32,411,2162
975,0,55,636,0,15,45,751
976,0,284,832,84,217,319,1736
977,0,139,3609,75,239,23,4085
978,0,54,315,84,109,58,620
979,0,481,5412,108,132,563,6696
980,0,11,91,0,1,11,114
981,0,4,254,0,0,5,263
982,0,105,365,0,26,0,496
983,0,9,226,0,20,2,257
984,0,76,378,216,115,47,832
985,0,22,281,32,0,4,339
986,0,19,105,0,1,15,140
987,0,23,150,12,2,4,191
988,0,369,195,2311,553,1195,4623
989,2,92,288,447,397,19,1245
990,0,66,186,356,74,26,708
991,20,12138,3203,2967,3464,1564,23356
992,0,14,136,64,91,8,313
993,0,199,455,397,238,41,1330
994,0,10,210,0,13,7,240
995,0,39,394,57,30,0,520
996,0,520,289,88,59,28,984
997,0,22,44,29,189,8,292
998,0,157,1276,72,147,153,1805
999,1,250,606,0,28,385,1270
1000,0,123,404,75,83,57,742
1001,0,46,220,2,23,30,321
1002,0,281,580,6,47,64,978
1003,0,105,3047,12,33,216,3413
1004,2,108,223,12,119,73,537
1005,0,90,396,15,32,7,540
1006,0,66,406,62,29,34,597
1007,0,4,274,0,10,0,288
1008,0,203,992,7,81,250,1533
1009,0,62,369,23,3,131,588
1010,0,441,965,28,354,49,1837
1011,0,324,740,8,59,510,1641
1012,0,87,379,15,40,8,529
1013,0,36,165,44,42,55,342
1014,107,3623,3720,3584,1613,1749,14396
1015,0,166,1073,36,9,179,1463
1016,0,166,579,79,29,61,914
1017,0,104,1659,17,24,22,1826
1018,21,3010,3565,122,1445,478,8641
1019,0,193,179,2,113,0,487
1020,0,50,332,15,12,1,410
1021,0,349,783,2,220,46,1400
1022,0,4495,163,71,7,131,4867
1023,0,47,636,36,47,141,907
1024,0,55,152,14,11,24,256
1025,0,47,427,36,85,52,647
1026,0,20,221,57,22,118,438
1027,0,212,902,8,45,217,1384
1028,0,52,76,6,35,0,169
1029,0,71,88,14,61,0,234
1030,8,12,122,5,6,10,163
1031,0,66,151,1,26,0,244
1032,0,7,120,0,23,3,153
1033,0,216,555,40,33,111,955
1034,0,167,256,8,15,144,590
1035,0,56,567,0,20,16,659
1036,0,88,469,8,52,27,644
1037,0,116,384,44,42,65,651
1038,14,85,564,1,142,305,1111
1039,0,120,454,38,96,137,845
1040,0,12,231,4,5,48,300
1041,0,275,634,11,25,554,1499
1042,0,15,279,0,13,0,307
1043,0,1087,476,21,28,15,1627
1044,0,93,164,2,5,21,285
1045,0,39,87,40,46,0,212
1046,0,3,178,2,17,2,202
1047,0,36,361,1,28,117,543
1048,0,106,254,10,12,40,422
1049,0,316,281,12,80,289,978
1050,0,243,738,76,84,215,1356
1051,0,183,1318,9,335,619,2464
1052,0,8,98,0,5,0,111
1053,0,26,430,0,30,0,486
1054,0,22,305,6,9,68,410
1055,0,64,415,26,59,57,621
1056,0,58,455,4,480,45,1042
1057,0,15,147,6,0,41,209
1058,0,163,740,147,144,263,1457
1059,70,1082,772,2653,986,1125,6688
1060,5,114,862,548,53,25,1607
1061,0,42,778,67,117,159,1163
1062,19,1447,771,4593,913,170,7913
1063,0,77,2225,12,52,36,2402
1064,0,16,334,15,25,14,404
1065,0,32,517,12,14,50,625
1066,0,137,2344,4,240,556,3281
1067,0,45,413,50,63,80,651
1068,0,255,280,782,625,5,1947
1069,0,1161,1678,2495,1896,1058,8288
1070,0,6,220,40,31,20,317
1071,0,95,238,50,50,41,474
1072,0,16,1285,10,13,164,1488
1073,0,13,349,125,5,4,496
1074,0,165,1152,16,113,1002,2448
1075,0,83,613,0,10,116,822
1076,0,5,317,0,8,1,331
1077,0,61,269,1,75,15,421
1078,0,59,443,32,14,33,581
1079,0,69,713,1,63,192,1038
1080,0,50,620,4,15,115,804
1081,0,10,163,18,16,0,207
1082,0,186,554,270,16,33,1059
1083,0,897,1856,1399,345,193,4690
1084,2,63,371,0,40,59,535
1085,0,50,517,5,31,106,709
1086,0,49,445,5,127,213,839
1087,25,41,139,22,16,7,250
1088,0,21,71,107,2,0,201
1089,0,41,361,700,25,75,1202
1090,0,100,148,690,87,17,1042
1091,0,77,5551,26,20,144,5818
1092,0,253,822,38,636,36,1785
1093,0,84,371,11,3808,6,4280
1094,0,143,193,132,3355,21,3844
1095,0,558,212,1593,1571,119,4053
1096,0,819,817,958,1038,594,4226
1097,1,3021,1364,3399,4948,518,13251
1098,0,176,311,54,51,217,809
1099,0,498,401,55,81,27,1062
1100,2,91,434,7,66,252,852
1101,0,130,157,11,44,21,363
1102,43,2,20,4,42,0,111
1103,0,146,462,10,171,182,971
1104,0,56,114,0,2,0,172
1105,0,2,44,0,2,0,48
1106,4,224,1149,17,60,164,1618
1107,0,107,503,2,23,15,650
1108,0,66,430,37,52,439,1024
1109,0,41,2152,34,73,6,2306
1110,38,454,742,21,31,289,1575
1111,0,59,446,31,384,2,922
1112,0,239,1419,37,105,40,1840
1113,0,6372,2158,417,465,1034,10446
1114,0,37,140,21,14,134,346
1115,0,63,190,64,56,119,492
1116,0,2304,816,21,37,25,3203
1117,0,93,193,2,43,3,334
1118,0,588,1297,432,649,823,3789
1119,0,218,613,34,88,186,1139
1120,0,109,367,32,10,240,758
1121,0,6218,3808,483,606,1320,12435
1122,0,4976,6346,2428,1781,3693,19224
1123,0,539,809,65,309,758,2480
1124,0,277,3072,16,291,121,3777
1125,0,44,273,21,41,162,541
1126,0,144,296,6,19,8,473
1127,1,468,3669,20,107,57,4322
1128,0,92,391,37,123,68,711
1129,1,159,1328,12,494,119,2113
1130,0,94,190,6,33,4,327
1131,1,116,123,12,43,53,348
1132,1,136,773,28,52,7,997
1133,9,453,401,208,196,199,1466
1134,0,665,1169,146,268,599,2847
1135,7,45,542,21,14,0,629
1136,0,1500,1467,26,530,14,3537
1137,6,2823,6058,1124,518,546,11075
1138,0,236,513,22,89,73,933
1139,14,26,95,6,8,3,152
1140,0,219,1174,36,8,223,1660
1141,2,176,5705,141,27,120,6171
1142,0,71,147,0,36,1,255
1143,0,140,1614,25,67,12,1858
1144,0,439,609,58,50,39,1195
1145,4,9406,4256,1319,1316,1872,18173
1146,4,1889,8633,116,114,2654,13410
1147,0,501,1186,37,236,128,2088
1148,0,85,716,11,0,0,812
1149,0,209,363,0,98,38,708
1150,0,776,1525,45,211,470,3027
1151,0,106,410,27,27,6,576
1152,0,1184,3230,170,250,553,5387
1153,0,314,571,13,36,12,946
1154,14,420,1296,87,203,152,2172
1155,0,125,86,2,29,16,258
1156,4,130,166,28,26,60,414
1157,0,172,676,6,29,53,936
1158,0,209,730,17,112,313,1381
1159,0,45,1179,5,20,27,1276
1160,6,156,613,6,40,0,821
1161,1,2025,4022,288,1039,918,8293
1162,0,42,30,15,28,12,127
1163,17,32,120,15,4,14,202
1164,7,222,442,29,126,7,833
1165,1,174,618,43,189,19,1044
1166,2,211,1819,70,73,54,2229
1167,0,244,552,33,100,46,975
1168,7,13139,4461,2700,3982,845,25134
1169,0,1606,759,158,588,800,3911
1170,12,1342,2708,272,676,689,5699
1171,0,212,694,29,35,138,1108
1172,0,49,327,37,12,128,553
1173,0,18,438,1,26,12,495
1174,0,53,378,130,25,4,590
1175,1178,2287,864,1204,234,153,5920
1176,63,1099,3702,173,473,553,6063
1177,66,356,966,242,368,48,2046
1178,21,849,5949,233,701,2075,9828
1179,303,995,3208,589,1782,817,7694
1180,32,122,809,150,349,66,1528
1181,6,30,140,42,48,7,273
1182,37,329,902,186,304,318,2076
1183,0,194,226,1348,393,51,2212
1184,0,39,339,29,26,86,519
1185,5,341,1697,51,284,1098,3476
1186,0,234,2863,43,49,508,3697
1187,0,139,1608,11,68,298,2124
1188,0,105,777,259,483,106,1730
1189,0,759,2227,690,981,1545,6202
1190,0,36,436,0,8,172,652
1191,0,46,737,1,6,30,820
1192,0,13,288,2,19,0,322
1193,0,104,601,11,33,263,1012
1194,0,30,334,1,6,3,374
1195,0,140,677,29,128,116,1090
1196,0,53,197,23,53,0,326
1197,0,54,876,0,12,249,1191
1198,0,21,1382,0,78,367,1848
1199,0,284,1638,822,842,401,3987
1200,0,66,420,2,74,12,574
1201,0,30,189,139,8,0,366
1202,0,43,208,0,16,112,379
1203,0,22,1012,39,378,5,1456
1204,0,41,363,201,313,318,1236
1205,0,123,311,985,290,1,1710
1206,0,16,317,316,168,135,952
1207,0,136,109,50,24,1,320
1208,0,26,336,10,12,93,477
1209,0,8,92,336,3,39,478
1210,0,22,261,54,41,38,416
1211,94,1588,732,3990,2105,448,8957
1212,0,233,800,61,434,39,1567
1213,0,85,388,0,26,114,613
1214,0,76,125,3,12,23,239
1215,0,84,479,11,9,217,800
1216,0,50,97,6,25,15,193
1217,59,273,112,23,265,12,744
1218,0,17,92,0,6,2,117
1219,0,99,289,4,342,33,767
1220,0,170,240,63,36,109,618
1221,0,8,202,6,29,6,251
1222,0,16,1924,37,10,0,1987
1223,0,65,200,715,1130,16,2126
1224,0,122,901,149,360,71,1603
1225,3,16,73,5,147,33,277
1226,1,189,69,360,1,85,705
1227,0,0,158,27,2,39,226
1228,0,5,117,1,29,0,152
1229,0,88,686,6,12,125,917
1230,0,30,336,12,6,49,433
1231,0,34,341,12,7,52,446
1232,0,237,596,10,47,166,1056
1233,0,72,238,3,3,15,331
1234,0,215,1603,104,303,204,2429
1235,0,24,168,3,0,29,224
1236,0,16,431,1,2,53,503
1237,0,5,86,0,4,0,95
1238,0,238,700,388,284,0,1610
1239,0,10,44,1,0,0,55
1240,0,4,369,25,12,57,467
1241,0,241,2606,361,69,549,3826
1242,0,81,4946,6,9,29,5071
1243,0,27,1309,0,4,23,1363
1244,1,70,418,5,25,6,525
1245,0,4,113,4,6,5,132
1246,54,251,1296,51,56,1833,3541
1247,0,369,819,1044,1158,234,3624
1248,18,2257,1983,177,576,505,5516
1249,19,757,1165,748,524,405,3618
1250,5,262,982,2576,334,809,4968
1251,0,101,731,118,471,366,1787
1252,0,457,856,83,255,35,1686
1253,0,0,60,4,22,7,93
1254,0,15,179,40,39,1,274
1255,22,27,387,0,5,55,496
1256,0,48,215,109,94,11,477
1257,0,17,205,2,4,3,231
1258,0,5,142,0,13,31,191
1259,0,200,569,557,35,134,1495
1260,0,16,142,2,46,9,215
1261,0,92,164,7,39,138,440
1262,0,301,845,98,3808,45,5097
1263,0,97,679,8,785,21,1590
1264,0,188,462,51,1,177,879
1265,0,104,3414,20,37,1216,4791
1266,0,144,537,21,35,197,934
1267,0,92,442,0,167,158,859
1268,9,476,1548,42,94,85,2254
1269,0,70,1604,24,105,743,2546
1270,0,504,1300,1090,320,31,3245
1271,0,84,406,65,43,68,666
1272,0,0,2497,0,1438,0,3935
1273,0,177,481,23,51,135,867
1274,0,212,844,56,110,467,1689
1275,0,41,190,6,11,67,315
1276,0,124,345,7,3,97,576
1277,0,20,160,5,19,10,214
1278,0,46,193,2,13,114,368
1279,82,628,2639,2758,2235,447,8789
1280,4,252,3183,218,176,2551,6384
1281,0,709,542,182,53,550,2036
1282,4,314,1342,145,832,604,3241
1283,0,84,864,59,11,13,1031
1284,0,600,1631,94,1107,371,3803
1285,0,159,296,9,44,15,523
1286,587,78,75,22,414,4,1180
1287,226,106,13,272,187,44,848
1288,253,193,867,51,236,345,1945
1289,85,378,1184,1534,474,531,4186
1290,336,90,664,208,382,252,1932
1291,51,295,1057,122,25,619,2169
1292,113,2635,1699,3651,1650,266,10014
1293,335,76,410,66,131,91,1109
1294,31,190,3565,213,207,19,4225
1295,40,344,1196,153,238,803,2774
1296,230,50,263,98,71,41,753
1297,135,274,2041,75,186,242,2953
1298,30,1344,1887,691,125,583,4660
1299,51,654,1645,201,2677,185,5413
1300,6,81,324,195,156,14,776
1301,0,413,518,147,312,39,1429
1302,0,36,386,45,97,458,1022
1303,4,14,72,17,30,4,141
1304,47,85,459,2,88,21,702
1305,100,508,2147,378,126,515,3774
1306,233,434,3405,218,206,648,5144
1307,29,66,823,38,55,29,1040
1308,303,169,711,540,116,11,1850
1309,249,4,20,110,0,1,384
1310,42,29,1860,299,78,168,2476
1311,627,223,837,1743,201,22,3653
1312,205,20,58,37,53,6,379
1313,503,159,1980,2240,175,54,5111
1314,584,516,1720,1329,316,412,4877
1315,623,87,288,2981,425,74,4478
1316,140,26,21,262,21,0,470
1317,169,223,1433,495,212,194,2726
1318,183,223,533,458,97,72,1566
1319,55,197,799,68,237,96,1452
1320,95,1028,1466,335,133,289,3346
1321,49,175,277,94,133,33,761
1322,0,0,0,0,5,0,5
1323,212,675,2763,225,503,610,4988
1324,384,1065,231,2134,480,166,4460
1325,78,2686,1779,4340,570,398,9851
1326,13,99,195,3,63,22,395
1327,18,86,1728,57,460,10,2359
1328,248,124,281,87,134,14,888
1329,239,195,460,390,225,499,2008
1330,0,42,275,39,208,74,638
1331,5,223,653,327,260,529,1997
1332,8,1106,2355,874,486,926,5755
1333,0,20,125,5,57,13,220
1334,0,28,194,21,61,10,314
1335,0,110,848,16,103,341,1418
1336,22,1292,2762,1616,620,489,6801
1337,31,1678,4241,1645,1498,1066,10159
1338,1,33,315,12,99,83,543
1339,0,57,313,36,54,319,779
1340,0,58,413,323,223,8,1025
1341,5,35,336,19,61,6,462
1342,0,24,1967,15,30,9,2045
1343,0,31,477,0,26,9,543
1344,0,226,786,24,317,291,1644
1345,0,31,80,9,16,17,153
1346,0,534,1949,425,356,61,3325
1347,2,233,414,16,186,83,934
1348,16,576,1290,607,473,2071,5033
1349,5,242,734,53,94,258,1386
1350,8,284,649,28,157,218,1344
1351,0,55,438,0,75,2,570
1352,0,18,48,46,43,0,155
1353,39,64,210,242,28,43,626
1354,63,113,308,122,265,148,1019
1355,0,29,390,3,69,31,522
1356,0,81,682,18,63,368,1212
1357,0,138,282,10,43,62,535
1358,0,146,1957,29,45,194,2371
1359,0,159,4265,28,61,477,4990
1360,5,287,293,2,76,51,714
1361,16,2088,1748,88,1272,811,6023
1362,0,570,853,44,221,128,1816
1363,0,340,7713,0,2812,236,11101
1364,0,121,480,21,21,116,759
1365,0,144,602,39,1964,50,2799
1366,20,785,2427,2439,270,210,6151
1367,35,85,713,27,239,21,1120
1368,133,2539,3233,4798,1282,287,12272
1369,12,289,1635,698,522,526,3682
1370,173,75,424,165,223,93,1153
1371,16,33,474,3,96,44,666
1372,2,34,339,4,40,17,436
1373,0,1117,1422,491,356,223,3609
1374,0,1210,1693,533,655,795,4886
1375,0,572,893,408,56,132,2061
1376,2,912,910,143,238,187,2392
1377,18,527,731,36,113,381,1806
1378,0,136,874,280,130,240,1660
1379,0,11,261,0,58,80,410
1380,25,924,1290,1232,1520,1778,6769
1381,77,1152,1575,1067,1156,214,5241
1382,142,84,1034,248,151,38,1697
1383,246,106,283,402,202,66,1305
1384,20,756,1583,627,543,482,4011
1385,32,74,359,131,92,22,710
1386,82,421,831,201,188,278,2001
1387,73,100,117,44,178,6,518
1388,6,24,22,0,44,0,96
1389,44,104,618,61,153,76,1056
1390,47,28,252,21,44,17,409
1391,17,50,589,22,69,127,874
1392,87,53,215,434,79,31,899
1393,14,53,312,429,52,21,881
1394,31,472,698,348,163,11,1723
1395,62,1160,1193,752,778,653,4598
1396,87,129,978,105,105,152,1556
1397,85,138,206,523,291,263,1506
1398,366,37,255,10,49,6,723
1399,18,630,2465,848,576,573,5110
1400,207,47,130,677,47,28,1136
1401,1199,115,756,1544,143,27,3784
1402,411,182,950,763,389,239,2934
1403,56,64,348,58,54,35,615
1404,4,117,88,53,37,1,300
1405,0,270,1069,121,184,897,2541
1406,0,528,560,205,1208,245,2746
1407,8,2544,1252,2936,699,165,7604
1408,0,117,554,139,73,16,899
1409,65,494,780,152,97,174,1762
1410,0,230,422,13,400,284,1349
1411,6,127,1045,12,154,12,1356
1412,0,721,2267,301,698,507,4494
1413,0,524,442,116,24,57,1163
1414,0,86,322,27,87,37,559
1415,329,147,801,282,233,108,1900
1416,36,9,222,11,48,2,328
1417,0,10,95,0,5,0,110
1418,5,43,342,19,49,24,482
1419,0,48,262,115,58,58,541
1420,3,89,558,28,208,94,980
1421,0,860,4305,269,224,557,6215
1422,0,338,1283,162,216,89,2088
1423,7,115,441,44,59,41,707
1424,1,1410,1944,274,486,103,4218
1425,0,915,1069,12,2282,37,4315
1426,0,85,199,68,60,129,541
1427,0,594,1882,60,138,458,3132
1428,0,1851,1679,1405,1867,2422,9224
1429,0,400,625,402,632,606,2665
1430,0,1272,3002,366,1026,511,6177
1431,0,282,529,24,113,89,1037
1432,2,363,1141,52,241,189,1988
1433,0,244,292,14,39,4,593
1434,0,97,403,13,164,390,1067
1435,1,212,465,0,32,4,714
1436,0,164,2059,13,91,215,2542
1437,0,399,3794,37,61,227,4518
1438,0,1794,1267,292,228,1084,4665
1439,0,0,15,0,2063,0,2078
1440,0,288,1288,85,160,137,1958
1441,0,450,1563,416,352,922,3703
1442,4,288,704,57,109,286,1448
1443,3,236,1259,34,101,279,1912
1444,0,294,670,79,203,415,1661
1445,4,276,679,32,74,59,1124
1446,6,324,689,54,201,48,1322
1447,0,139,174,1,55,49,418
1448,2,1484,1690,649,451,614,4890
1449,0,21,305,0,5,91,422
1450,0,162,506,7,27,266,968
1451,0,753,331,99,72,47,1302
1452,0,457,799,86,374,157,1873
1453,4,70,537,0,15,0,626
1454,62,70,232,18,58,50,490
