COUNTY_NAME,TAZ1454,AGREMPN,FPSEMPN,HEREMPN,MWTEMPN,RETEMPN,OTHEMPN,TOTEMP
San Francisco,1,1,12820,1748,468,188,1501,16726
San Francisco,2,10,16740,2647,1053,69,4078,24597
San Francisco,3,0,1118,476,2,40,337,1973
San Francisco,4,0,13473,2784,440,517,4375,21589
San Francisco,5,0,5245,3317,592,2159,1492,12805
San Francisco,6,0,378,2736,31,62,96,3303
San Francisco,7,0,1131,4071,6,415,135,5758
San Francisco,8,0,614,2421,38,23,715,3811
San Francisco,9,0,693,3675,6,127,1861,6362
San Francisco,10,7,3925,10277,618,134,9563,24524
San Francisco,11,4,3053,4004,250,1754,1585,10650
San Francisco,12,0,7886,4855,633,1137,1466,15977
San Francisco,13,1,13692,1280,291,151,1942,17357
San Francisco,14,0,17184,438,4833,38,2883,25376
San Francisco,15,12,7619,952,2845,325,2379,14132
San Francisco,16,0,17161,1593,1036,538,11852,32180
San Francisco,17,0,5045,1261,1895,228,5346,13775
San Francisco,18,0,2893,1990,485,238,2488,8094
San Francisco,19,0,6596,1020,309,981,2304,11210
San Francisco,20,0,2422,1542,642,326,1608,6540
San Francisco,21,15,4415,2483,1463,221,1855,10452
San Francisco,22,13,9287,2204,142,259,1539,13444
San Francisco,23,0,4095,780,506,104,1442,6927
San Francisco,24,5,6737,2492,252,523,5261,15270
San Francisco,25,0,277,1297,22,167,23,1786
San Francisco,26,0,2314,966,113,36,927,4356
San Francisco,27,0,48,1202,19,121,3,1393
San Francisco,28,0,158,586,26,7,34,811
San Francisco,29,0,489,890,20,8,1,1408
San Francisco,30,0,202,695,4,106,48,1055
San Francisco,31,0,375,1707,9,15,31,2137
San Francisco,32,0,215,1712,8,241,68,2244
San Francisco,33,0,294,980,31,76,78,1459
San Francisco,34,0,194,718,32,106,25,1075
San Francisco,35,4,264,250,4,20,0,542
San Francisco,36,10,219,1690,49,251,17,2236
San Francisco,37,0,728,1534,122,103,169,2656
San Francisco,38,0,464,571,151,217,117,1520
San Francisco,39,1,77,451,12,26,7,574
San Francisco,40,14,772,945,296,178,40,2245
San Francisco,41,0,2051,2273,205,829,84,5442
San Francisco,42,0,86,382,50,3,77,598
San Francisco,43,0,251,867,142,254,39,1553
San Francisco,44,0,363,645,16,81,85,1190
San Francisco,45,2,659,1698,89,227,257,2932
San Francisco,46,0,582,865,40,28,68,1583
San Francisco,47,0,801,1528,22,95,134,2580
San Francisco,48,0,181,522,43,81,23,850
San Francisco,49,0,120,694,4,2,13,833
San Francisco,50,0,340,1283,12,388,125,2148
San Francisco,51,0,45,325,44,6,89,509
San Francisco,52,1,1693,1944,300,324,1399,5661
San Francisco,53,0,25,968,0,2,30,1025
San Francisco,54,0,65,414,30,186,28,723
San Francisco,55,0,25,200,2,29,17,273
San Francisco,56,0,152,2722,0,16,0,2890
San Francisco,57,0,24,194,5,0,14,237
San Francisco,58,0,69,597,9,36,29,740
San Francisco,59,1,92,691,31,32,72,919
San Francisco,60,0,30,483,3,8,23,547
San Francisco,61,0,229,446,5,20,17,717
San Francisco,62,0,174,931,51,107,51,1314
San Francisco,63,0,130,392,4,68,95,689
San Francisco,64,0,52,393,4,121,63,633
San Francisco,65,3,247,824,25,180,94,1373
San Francisco,66,18,140,904,35,288,56,1441
San Francisco,67,0,54,608,10,70,40,782
San Francisco,68,0,212,475,0,41,40,768
San Francisco,69,0,252,7078,17,255,24,7626
San Francisco,70,0,471,922,23,425,156,1997
San Francisco,71,30,411,1538,15,112,43,2149
San Francisco,72,0,213,816,4,60,29,1122
San Francisco,73,0,150,948,22,202,56,1378
San Francisco,74,0,355,2369,20,163,23,2930
San Francisco,75,0,646,2852,4,362,45,3909
San Francisco,76,0,316,754,6,39,1532,2647
San Francisco,77,0,91,1550,37,149,35,1862
San Francisco,78,0,58,982,5,5,0,1050
San Francisco,79,0,376,4341,277,176,3415,8585
San Francisco,80,0,173,307,6,11,9,506
San Francisco,81,0,459,14433,8,59,98,15057
San Francisco,82,0,387,551,17,284,43,1282
San Francisco,83,0,469,242,4,17,10,742
San Francisco,84,0,181,986,26,27,53,1273
San Francisco,85,0,183,666,26,144,197,1216
San Francisco,86,0,62,839,3,29,29,962
San Francisco,87,0,96,1239,5,38,16,1394
San Francisco,88,20,151,591,27,417,138,1344
San Francisco,89,0,118,720,20,72,92,1022
San Francisco,90,0,107,16255,2,67,28,16459
San Francisco,91,0,63,277,3,14,28,385
San Francisco,92,0,41,112,0,7,23,183
San Francisco,93,0,105,184,64,12,58,423
San Francisco,94,0,225,475,22,136,24,882
San Francisco,95,0,191,310,15,6,31,553
San Francisco,96,1,97,116,5,11,19,249
San Francisco,97,0,115,428,71,87,28,729
San Francisco,98,0,224,416,12,144,18,814
San Francisco,99,0,68,387,215,13,72,755
San Francisco,100,0,557,1151,40,169,143,2060
San Francisco,101,23,420,1784,330,244,302,3103
San Francisco,102,0,107,992,140,170,248,1657
San Francisco,103,0,212,619,60,91,63,1045
San Francisco,104,0,522,815,40,307,127,1811
San Francisco,105,3,117,1212,27,149,73,1581
San Francisco,106,0,645,1877,88,388,576,3574
San Francisco,107,0,2383,4304,9747,1173,9175,26782
San Francisco,108,0,1122,2265,567,272,279,4505
San Francisco,109,0,2416,1137,396,107,1502,5558
San Francisco,110,0,2807,2622,989,132,178,6728
San Francisco,111,0,1829,2401,1250,263,1125,6868
San Francisco,112,0,234,278,138,26,66,742
San Francisco,113,0,241,441,117,14,118,931
San Francisco,114,0,288,449,50,356,186,1329
San Francisco,115,0,173,402,14,12,7,608
San Francisco,116,0,1999,1211,294,640,765,4909
San Francisco,117,0,472,418,24,9,31,954
San Francisco,118,0,214,319,2,45,22,602
San Francisco,119,0,24,251,10,63,21,369
San Francisco,120,0,89,377,20,62,109,657
San Francisco,121,0,124,159,67,56,52,458
San Francisco,122,0,471,447,47,31,83,1079
San Francisco,123,0,231,1072,136,221,135,1795
San Francisco,124,0,21,154,1,80,30,286
San Francisco,125,0,36,142,0,6,23,207
San Francisco,126,0,50,177,7,0,32,266
San Francisco,127,0,39,402,12,113,36,602
San Francisco,128,0,156,268,3,36,48,511
San Francisco,129,0,72,148,9,0,40,269
San Francisco,130,11,191,345,4,167,27,745
San Francisco,131,0,56,131,88,4,48,327
San Francisco,132,0,57,294,18,132,17,518
San Francisco,133,0,94,1637,16,49,102,1898
San Francisco,134,0,114,507,35,32,63,751
San Francisco,135,0,65,420,13,59,26,583
San Francisco,136,0,77,621,2,0,38,738
San Francisco,137,0,23,269,1,46,44,383
San Francisco,138,0,115,1034,29,191,975,2344
San Francisco,139,14,173,478,48,83,125,921
San Francisco,140,0,2,175,33,27,9,246
San Francisco,141,0,46,207,25,9,20,307
San Francisco,142,4,1504,1101,2154,822,2773,8358
San Francisco,143,0,48,498,67,30,173,816
San Francisco,144,0,139,388,6,0,23,556
San Francisco,145,0,60,413,19,0,254,746
San Francisco,146,0,10,41,13,0,0,64
San Francisco,147,5,127,400,455,36,485,1508
San Francisco,148,0,96,338,574,16,752,1776
San Francisco,149,0,510,264,11,5,133,923
San Francisco,150,0,402,611,176,204,551,1944
San Francisco,151,0,5,84,6,25,1,121
San Francisco,152,0,444,284,4,5,30,767
San Francisco,153,0,9,186,23,0,27,245
San Francisco,154,0,69,345,15,149,11,589
San Francisco,155,0,34,255,0,9,38,336
San Francisco,156,0,0,152,6,5,19,182
San Francisco,157,0,0,151,10,1,3,165
San Francisco,158,0,8,324,0,0,6,338
San Francisco,159,0,3,215,3,23,28,272
San Francisco,160,0,48,185,0,5,25,263
San Francisco,161,0,29,307,10,20,35,401
San Francisco,162,0,47,330,8,72,37,494
San Francisco,163,0,26,296,7,5,43,377
San Francisco,164,0,3481,374,18,83,62,4018
San Francisco,165,0,48,815,1,166,51,1081
San Francisco,166,0,42,716,14,10,79,861
San Francisco,167,0,36,364,4,8,74,486
San Francisco,168,0,88,463,17,81,77,726
San Francisco,169,0,111,731,18,28,110,998
San Francisco,170,0,333,1158,46,132,115,1784
San Francisco,171,8,45,166,61,119,22,421
San Francisco,172,4,40,314,7,100,78,543
San Francisco,173,0,94,76,3,55,25,253
San Francisco,174,0,50,273,12,2,76,413
San Francisco,175,0,137,1020,18,70,63,1308
San Francisco,176,0,48,257,5,75,36,421
San Francisco,177,0,214,804,46,169,70,1303
San Francisco,178,0,103,328,3,12,43,489
San Francisco,179,0,30,410,15,7,49,511
San Francisco,180,0,20,365,18,50,39,492
San Francisco,181,9,24,448,30,67,63,641
San Francisco,182,0,14,323,10,30,102,479
San Francisco,183,0,36,1128,11,99,45,1319
San Francisco,184,0,134,499,24,103,82,842
San Francisco,185,0,233,1265,31,80,68,1677
San Francisco,186,0,158,892,36,53,115,1254
San Francisco,187,0,456,170,12,192,59,889
San Francisco,188,0,127,4767,3,788,34,5719
San Francisco,189,0,189,435,2,5,52,683
San Francisco,190,0,32,717,1,9,11,770
San Mateo,191,0,75,298,5,22,37,437
San Mateo,192,0,107,602,3,641,13,1366
San Mateo,193,0,223,1409,113,115,430,2290
San Mateo,194,0,50,1583,72,70,70,1845
San Mateo,195,0,17,178,2,0,29,226
San Mateo,196,0,39,176,1,0,27,243
San Mateo,197,0,67,252,0,141,4,464
San Mateo,198,0,17,878,28,10,3,936
San Mateo,199,0,88,741,3,1032,17,1881
San Mateo,200,41,224,1233,97,2281,70,3946
San Mateo,201,2,74,463,137,205,91,972
San Mateo,202,0,9,323,19,1,28,380
San Mateo,203,4,330,1184,47,219,374,2158
San Mateo,204,0,57,371,22,130,99,679
San Mateo,205,0,48,196,6,5,16,271
San Mateo,206,0,40,67,6,1,19,133
San Mateo,207,0,46,245,396,36,8,731
San Mateo,208,44,2431,860,2566,405,636,6942
San Mateo,209,0,46,278,36,1,45,406
San Mateo,210,0,26,171,127,71,129,524
San Mateo,211,0,347,686,182,222,135,1572
San Mateo,212,271,11020,4341,19164,1021,2688,38505
San Mateo,213,0,78,810,21,107,106,1122
San Mateo,214,0,83,375,17,96,265,836
San Mateo,215,0,148,238,2,80,4,472
San Mateo,216,0,13,3055,9,95,51,3223
San Mateo,217,0,37,235,4,56,35,367
San Mateo,218,0,331,1136,17,263,78,1825
San Mateo,219,0,10,189,0,72,29,300
San Mateo,220,0,22,229,0,9,25,285
San Mateo,221,0,29,136,8,79,24,276
San Mateo,222,0,55,393,51,163,32,694
San Mateo,223,0,131,452,41,119,311,1054
San Mateo,224,0,14,193,1,6,89,303
San Mateo,225,0,87,536,37,129,99,888
San Mateo,226,1,87,367,3,212,76,746
San Mateo,227,7,55,170,73,5,45,355
San Mateo,228,0,0,6,0,0,0,6
San Mateo,229,0,21,669,4,10,12,716
San Mateo,230,0,48,796,86,467,14,1411
San Mateo,231,0,30,161,20,0,16,227
San Mateo,232,0,74,216,10,8,17,325
San Mateo,233,0,44,214,11,80,68,417
San Mateo,234,0,1926,1119,255,1143,2531,6974
San Mateo,235,0,12,388,39,3,303,745
San Mateo,236,0,151,451,18,96,72,788
San Mateo,237,0,119,1070,7,177,23,1396
San Mateo,238,0,54,316,237,27,80,714
San Mateo,239,0,748,1157,7320,261,55,9541
San Mateo,240,0,327,1706,157,285,121,2596
San Mateo,241,0,37,288,9,0,75,409
San Mateo,242,0,25,176,0,1,17,219
San Mateo,243,0,26,74,5,1,18,124
San Mateo,244,0,118,378,32,171,152,851
San Mateo,245,0,22,257,4,0,34,317
San Mateo,246,0,739,2790,83,163,44,3819
San Mateo,247,0,55,179,5,8,153,400
San Mateo,248,0,6463,2651,2920,299,992,13325
San Mateo,249,0,1140,930,1222,236,625,4153
San Mateo,250,0,42,313,11,92,141,599
San Mateo,251,0,779,1313,107,962,1003,4164
San Mateo,252,18,319,712,98,4,232,1383
San Mateo,253,0,42,49,1,5,30,127
San Mateo,254,8,94,359,10,0,38,509
San Mateo,255,0,100,221,10,26,17,374
San Mateo,256,0,550,709,13,12,88,1372
San Mateo,257,0,1671,3102,226,526,686,6211
San Mateo,258,0,144,571,33,14,92,854
San Mateo,259,0,105,910,127,105,97,1344
San Mateo,260,0,390,446,183,142,162,1323
San Mateo,261,0,34,319,37,12,68,470
San Mateo,262,0,117,284,10,65,162,638
San Mateo,263,0,5,155,60,2,35,257
San Mateo,264,0,346,256,64,83,47,796
San Mateo,265,0,3244,579,337,635,2160,6955
San Mateo,266,0,7968,1781,2157,592,2138,14636
San Mateo,267,0,57,336,14,1,81,489
San Mateo,268,0,19,327,39,1,18,404
San Mateo,269,0,131,277,23,71,14,516
San Mateo,270,0,14,48,5,8,11,86
San Mateo,271,0,103,175,440,57,2,777
San Mateo,272,0,35,86,9,6,7,143
San Mateo,273,0,17,42,4,0,14,77
San Mateo,274,0,1036,173,10,49,28,1296
San Mateo,275,0,571,371,94,210,303,1549
San Mateo,276,0,40,159,56,18,17,290
San Mateo,277,0,70,384,28,12,57,551
San Mateo,278,0,1723,807,73,615,2523,5741
San Mateo,279,0,1959,988,279,879,2276,6381
San Mateo,280,0,905,784,118,278,186,2271
San Mateo,281,0,448,1057,97,150,378,2130
San Mateo,282,6,2548,417,126,22,108,3227
San Mateo,283,0,5,220,9,33,17,284
San Mateo,284,0,389,1723,34,1116,70,3332
San Mateo,285,0,15,463,4,12,71,565
San Mateo,286,0,253,712,106,198,88,1357
San Mateo,287,0,223,524,12,34,176,969
San Mateo,288,0,73,818,21,96,40,1048
San Mateo,289,0,72,216,28,49,9,374
San Mateo,290,0,18,38,17,0,38,111
San Mateo,291,0,158,783,331,101,43,1416
San Mateo,292,0,42,169,0,7,28,246
San Mateo,293,28,92,179,142,42,87,570
San Mateo,294,9,89,600,71,98,157,1024
San Mateo,295,68,83,419,152,256,129,1107
San Mateo,296,211,703,1880,153,309,250,3506
San Mateo,297,500,84,346,49,43,97,1119
San Mateo,298,112,326,947,80,72,36,1573
San Mateo,299,27,167,537,7,144,223,1105
San Mateo,300,0,211,673,56,2,43,985
San Mateo,301,0,122,305,6,66,181,680
San Mateo,302,1,122,69,15,4,50,261
San Mateo,303,0,69,371,2,2,55,499
San Mateo,304,11,46,789,16,0,38,900
San Mateo,305,0,23,75,0,0,7,105
San Mateo,306,0,72,80,4,0,32,188
San Mateo,307,0,120,293,51,10,29,503
San Mateo,308,5,49,160,92,0,75,381
San Mateo,309,0,1210,1775,123,393,220,3721
San Mateo,310,109,3383,1630,1872,1134,1956,10084
San Mateo,311,0,4285,2192,2198,102,4409,13186
San Mateo,312,0,123,126,148,3,187,587
San Mateo,313,11,2284,1695,752,421,2194,7357
San Mateo,314,0,761,3019,915,224,631,5550
San Mateo,315,4,3073,4543,410,937,6283,15250
San Mateo,316,0,81,81,13,36,60,271
San Mateo,317,0,169,1001,132,146,71,1519
San Mateo,318,0,84,247,1,5,77,414
San Mateo,319,0,59,145,0,8,59,271
San Mateo,320,0,94,335,11,0,67,507
San Mateo,321,0,173,351,24,103,73,724
San Mateo,322,8,184,292,16,36,23,559
San Mateo,323,0,83,390,282,417,59,1231
San Mateo,324,0,63,363,0,153,11,590
San Mateo,325,0,74,115,3,225,68,485
San Mateo,326,0,165,322,75,497,200,1259
San Mateo,327,0,110,331,63,141,18,663
San Mateo,328,0,214,147,24,34,36,455
San Mateo,329,4,816,701,364,135,595,2615
San Mateo,330,0,121,198,17,28,123,487
San Mateo,331,15,2621,716,2280,94,30297,36023
San Mateo,332,24,2462,1729,523,5,663,5406
San Mateo,333,0,74,686,12,452,62,1286
San Mateo,334,0,151,379,26,71,123,750
San Mateo,335,2,1189,211,29,297,4,1732
San Mateo,336,0,145,164,43,170,7,529
San Mateo,337,0,31,992,13,0,146,1182
San Mateo,338,0,51,42,0,0,22,115
San Mateo,339,0,31,572,0,0,63,666
San Mateo,340,1,1446,761,204,24,2198,4634
San Mateo,341,0,1190,2279,31,671,308,4479
San Mateo,342,7,137,1234,40,2,12,1432
San Mateo,343,0,96,419,0,1,8,524
San Mateo,344,0,60,127,24,3,22,236
San Mateo,345,0,375,335,13,27,11,761
San Mateo,346,7,4076,703,668,146,363,5963
Santa Clara,347,143,222,1332,163,20,73,1953
Santa Clara,348,0,2608,166,334,0,5142,8250
Santa Clara,349,0,4333,3669,2481,10,686,11179
Santa Clara,350,0,610,103,345,119,7,1184
Santa Clara,351,2,1794,2322,79,163,400,4760
Santa Clara,352,0,9,62,0,0,93,164
Santa Clara,353,0,29,97,9,43,10,188
Santa Clara,354,0,436,15046,2,42,1,15527
Santa Clara,355,4,380,20032,25,1642,49,22132
Santa Clara,356,0,5790,3830,440,703,9417,20180
Santa Clara,357,0,144,338,23,4,90,599
Santa Clara,358,0,380,240,54,8,140,822
Santa Clara,359,0,174,249,27,17,60,527
Santa Clara,360,0,204,202,8,14,18,446
Santa Clara,361,0,137,386,31,114,94,762
Santa Clara,362,0,431,693,1582,41,43,2790
Santa Clara,363,0,40,406,0,33,20,499
Santa Clara,364,0,11,227,1,54,0,293
Santa Clara,365,0,187,240,233,57,157,874
Santa Clara,366,0,943,898,1844,132,595,4412
Santa Clara,367,0,2130,733,81,108,130,3182
Santa Clara,368,1,147,304,17,3,17,489
Santa Clara,369,0,172,597,16,4,44,833
Santa Clara,370,0,1017,1038,83,280,347,2765
Santa Clara,371,0,402,1157,17,209,90,1875
Santa Clara,372,0,288,1071,91,719,260,2429
Santa Clara,373,0,1676,439,16,170,497,2798
Santa Clara,374,0,926,787,681,634,821,3849
Santa Clara,375,0,76,245,0,4,10,335
Santa Clara,376,30,1024,473,614,106,413,2660
Santa Clara,377,0,628,159,238,30,1731,2786
Santa Clara,378,0,3439,2000,61,99,1047,6646
Santa Clara,379,6,37,404,5,19,27,498
Santa Clara,380,0,28,144,6,35,61,274
Santa Clara,381,0,159,443,102,195,245,1144
Santa Clara,382,0,60,205,5,4,0,274
Santa Clara,383,0,162,3322,47,91,166,3788
Santa Clara,384,4,145,470,5,28,7,659
Santa Clara,385,0,137,39,0,3,9,188
Santa Clara,386,0,61,67,13,0,6,147
Santa Clara,387,0,61,301,43,156,73,634
Santa Clara,388,0,182,1299,47,17,154,1699
Santa Clara,389,0,128,909,56,288,55,1436
Santa Clara,390,0,135,170,178,26,25,534
Santa Clara,391,0,126,1599,15,438,113,2291
Santa Clara,392,0,54,265,1,35,14,369
Santa Clara,393,0,28,346,320,57,69,820
Santa Clara,394,1,108,564,19,22,210,924
Santa Clara,395,0,3926,683,808,16,4005,9438
Santa Clara,396,0,859,310,747,1,782,2699
Santa Clara,397,0,1141,121,457,51,603,2373
Santa Clara,398,0,473,205,201,248,313,1440
Santa Clara,399,0,3826,140,676,145,2356,7143
Santa Clara,400,0,98,251,11,6,21,387
Santa Clara,401,4,4144,3640,3854,230,22964,34836
Santa Clara,402,0,959,168,3949,0,1076,6152
Santa Clara,403,0,5563,462,6596,7,17377,30005
Santa Clara,404,0,691,375,1636,8,2149,4859
Santa Clara,405,0,944,683,1255,609,177,3668
Santa Clara,406,20,2582,749,6349,182,1240,11122
Santa Clara,407,0,1906,1405,4536,609,2386,10842
Santa Clara,408,0,8063,425,2557,141,969,12155
Santa Clara,409,0,5108,1439,6001,56,506,13110
Santa Clara,410,0,2831,266,7424,11,362,10894
Santa Clara,411,0,0,0,569,0,0,569
Santa Clara,412,3,2713,973,7699,157,182,11727
Santa Clara,413,0,84,432,1324,181,29,2050
Santa Clara,414,0,1283,971,3739,246,2078,8317
Santa Clara,415,0,6180,4092,3083,225,1183,14763
Santa Clara,416,0,2104,359,399,32,490,3384
Santa Clara,417,0,627,53,3117,19,330,4146
Santa Clara,418,0,591,220,1815,99,286,3011
Santa Clara,419,0,54,174,13,8,9,258
Santa Clara,420,0,7,172,2,15,7,203
Santa Clara,421,0,202,147,71,23,41,484
Santa Clara,422,0,457,181,174,15,769,1596
Santa Clara,423,0,33,172,21,51,4,281
Santa Clara,424,0,87,441,29,36,22,615
Santa Clara,425,0,78,181,4,50,274,587
Santa Clara,426,0,47,142,945,193,20,1347
Santa Clara,427,0,6641,996,2834,327,781,11579
Santa Clara,428,0,3848,1178,1746,514,743,8029
Santa Clara,429,0,2082,505,6074,10,3074,11745
Santa Clara,430,0,5993,845,8360,214,1035,16447
Santa Clara,431,0,748,301,1411,109,881,3450
Santa Clara,432,0,2738,680,3482,462,2057,9419
Santa Clara,433,0,341,524,369,47,879,2160
Santa Clara,434,0,314,1012,2009,602,696,4633
Santa Clara,435,0,7116,2202,2354,199,2291,14162
Santa Clara,436,0,350,891,70,281,28,1620
Santa Clara,437,0,24,176,11,117,12,340
Santa Clara,438,0,34,374,7,59,13,487
Santa Clara,439,40,61,549,14,211,28,903
Santa Clara,440,0,55,598,6,35,29,723
Santa Clara,441,0,178,545,0,107,29,859
Santa Clara,442,0,19,281,6,35,13,354
Santa Clara,443,0,25,145,3,15,49,237
Santa Clara,444,0,119,588,127,38,106,978
Santa Clara,445,0,54,368,23,80,16,541
Santa Clara,446,0,47,157,34,73,9,320
Santa Clara,447,0,80,252,5,71,5,413
Santa Clara,448,0,366,679,9,372,14,1440
Santa Clara,449,0,73,894,9,283,19,1278
Santa Clara,450,0,1832,1072,314,399,238,3855
Santa Clara,451,3,72,864,2,249,39,1229
Santa Clara,452,0,21,968,17,135,9,1150
Santa Clara,453,0,150,671,6,258,26,1111
Santa Clara,454,0,54,845,46,12,50,1007
Santa Clara,455,0,39,468,12,105,20,644
Santa Clara,456,0,122,242,57,16,26,463
Santa Clara,457,0,65,106,1,0,14,186
Santa Clara,458,0,53,183,12,8,5,261
Santa Clara,459,0,101,569,12,130,53,865
Santa Clara,460,6,209,5144,34975,132,95,40561
Santa Clara,461,0,167,153,7,6,32,365
Santa Clara,462,0,93,696,6,311,38,1144
Santa Clara,463,0,111,94,13,23,38,279
Santa Clara,464,0,62,172,24,3,10,271
Santa Clara,465,0,181,978,77,653,39,1928
Santa Clara,466,0,132,1102,54,2971,28,4287
Santa Clara,467,0,2380,1995,85,632,1188,6280
Santa Clara,468,0,115,581,3,105,66,870
Santa Clara,469,2,236,528,23,68,38,895
Santa Clara,470,0,64,467,166,61,63,821
Santa Clara,471,4,84,846,70,430,22,1456
Santa Clara,472,0,383,633,104,15,100,1235
Santa Clara,473,0,56,435,47,49,12,599
Santa Clara,474,0,16,146,4,7,35,208
Santa Clara,475,0,99,677,79,648,46,1549
Santa Clara,476,0,243,1345,11,263,55,1917
Santa Clara,477,2,31,671,7,69,111,891
Santa Clara,478,0,650,495,66,953,32,2196
Santa Clara,479,0,665,745,158,10,32,1610
Santa Clara,480,0,32,230,18,13,4,297
Santa Clara,481,0,39,309,1,61,13,423
Santa Clara,482,0,33,78,5,10,20,146
Santa Clara,483,0,338,402,8,132,69,949
Santa Clara,484,0,999,1145,245,194,329,2912
Santa Clara,485,0,564,1048,178,285,55,2130
Santa Clara,486,0,334,471,61,473,12,1351
Santa Clara,487,0,100,506,10,74,27,717
Santa Clara,488,0,142,515,39,8,36,740
Santa Clara,489,0,63,301,5,12,12,393
Santa Clara,490,0,747,1602,422,274,207,3252
Santa Clara,491,0,30,215,4,239,4,492
Santa Clara,492,0,255,267,26,180,43,771
Santa Clara,493,0,184,388,3,3,25,603
Santa Clara,494,0,311,479,56,38,30,914
Santa Clara,495,19,96,234,70,4,41,464
Santa Clara,496,0,161,824,17,18,152,1172
Santa Clara,497,43,123,1479,52,22,110,1829
Santa Clara,498,0,143,604,16,152,48,963
Santa Clara,499,0,116,793,26,282,29,1246
Santa Clara,500,0,18,187,13,2,26,246
Santa Clara,501,0,6,102,0,31,31,170
Santa Clara,502,0,68,345,15,277,10,715
Santa Clara,503,6,97,1200,19,172,48,1542
Santa Clara,504,0,1239,2364,1552,555,2019,7729
Santa Clara,505,0,14,188,8,17,54,281
Santa Clara,506,0,173,1012,350,44,20,1599
Santa Clara,507,1,85,387,17,61,16,567
Santa Clara,508,0,2189,423,1142,2,477,4233
Santa Clara,509,0,444,587,158,146,286,1621
Santa Clara,510,1,33,175,33,0,19,261
Santa Clara,511,12,546,2873,281,306,728,4746
Santa Clara,512,3,81,164,33,0,58,339
Santa Clara,513,1,45,179,7,3,22,257
Santa Clara,514,1,149,764,18,193,124,1249
Santa Clara,515,0,35,306,19,18,59,437
Santa Clara,516,0,23,156,5,0,3,187
Santa Clara,517,0,39,702,30,128,87,986
Santa Clara,518,0,348,2002,58,546,98,3052
Santa Clara,519,0,270,4000,1782,53,114,6219
Santa Clara,520,0,155,491,47,69,57,819
Santa Clara,521,0,221,1489,186,249,388,2533
Santa Clara,522,0,132,490,12,50,248,932
Santa Clara,523,0,118,385,18,630,64,1215
Santa Clara,524,0,87,48,14,8,44,201
Santa Clara,525,0,68,479,48,13,27,635
Santa Clara,526,6,67,521,8,24,34,660
Santa Clara,527,0,322,631,18,133,79,1183
Santa Clara,528,25,309,681,33,110,95,1253
Santa Clara,529,2,132,413,39,194,94,874
Santa Clara,530,0,2858,2024,399,924,1077,7282
Santa Clara,531,0,630,908,37,2629,31,4235
Santa Clara,532,0,57,517,24,104,31,733
Santa Clara,533,0,342,6726,5,67,28,7168
Santa Clara,534,0,230,439,318,77,72,1136
Santa Clara,535,0,127,801,37,178,14,1157
Santa Clara,536,0,51,380,22,137,50,640
Santa Clara,537,4,534,982,752,313,382,2967
Santa Clara,538,71,293,194,7,31,36,632
Santa Clara,539,0,610,2038,463,604,885,4600
Santa Clara,540,42,814,2023,209,176,127,3391
Santa Clara,541,0,125,1378,44,192,45,1784
Santa Clara,542,8,425,951,66,1,572,2023
Santa Clara,543,26,426,2583,77,105,764,3981
Santa Clara,544,0,78,330,65,50,59,582
Santa Clara,545,0,271,835,11,42,21,1180
Santa Clara,546,0,1519,10404,354,25,13285,25587
Santa Clara,547,0,1842,706,460,154,2329,5491
Santa Clara,548,0,78,526,56,43,27,730
Santa Clara,549,3,1243,886,85,108,229,2554
Santa Clara,550,0,122,305,3,25,39,494
Santa Clara,551,0,95,531,233,91,163,1113
Santa Clara,552,0,30,129,0,3,111,273
Santa Clara,553,0,8,161,17,32,24,242
Santa Clara,554,0,79,330,3,54,36,502
Santa Clara,555,0,43,677,57,32,10,819
Santa Clara,556,0,0,359,0,3,0,362
Santa Clara,557,0,422,5156,124,122,3191,9015
Santa Clara,558,8,8508,2661,254,176,6976,18583
Santa Clara,559,0,65,398,31,17,68,579
Santa Clara,560,0,1107,1055,138,27,48,2375
Santa Clara,561,8,155,442,240,65,70,980
Santa Clara,562,0,15,234,7,54,93,403
Santa Clara,563,12,1591,2849,4761,1468,3474,14155
Santa Clara,564,0,107,734,20,637,80,1578
Santa Clara,565,0,383,279,169,9,132,972
Santa Clara,566,0,63,444,91,83,304,985
Santa Clara,567,0,125,592,457,287,318,1779
Santa Clara,568,0,15,400,86,95,96,692
Santa Clara,569,0,12,126,5,1,9,153
Santa Clara,570,0,50,226,0,92,14,382
Santa Clara,571,1,8,123,1,6,40,179
Santa Clara,572,0,23,496,13,0,4,536
Santa Clara,573,0,8,174,13,59,4,258
Santa Clara,574,0,18,335,5,17,41,416
Santa Clara,575,0,25,504,37,78,29,673
Santa Clara,576,0,49,201,53,32,79,414
Santa Clara,577,0,6,381,3,7,8,405
Santa Clara,578,0,49,427,12,71,46,605
Santa Clara,579,0,26,909,209,603,478,2225
Santa Clara,580,0,27,242,121,57,103,550
Santa Clara,581,0,19,271,2,68,8,368
Santa Clara,582,0,76,1327,28,391,20,1842
Santa Clara,583,0,235,1670,36,1068,60,3069
Santa Clara,584,0,21,404,11,35,23,494
Santa Clara,585,0,45,319,7,82,5,458
Santa Clara,586,0,8,399,7,219,44,677
Santa Clara,587,0,5,370,0,0,0,375
Santa Clara,588,0,30,325,2,22,15,394
Santa Clara,589,0,45,332,76,49,45,547
Santa Clara,590,0,31,228,37,167,4,467
Santa Clara,591,0,73,516,11,49,74,723
Santa Clara,592,20,13,232,74,45,48,432
Santa Clara,593,0,126,161,1174,124,1267,2852
Santa Clara,594,0,52,313,15,6,101,487
Santa Clara,595,0,81,2707,1,84,11,2884
Santa Clara,596,0,19,482,13,100,10,624
Santa Clara,597,0,72,485,219,0,63,839
Santa Clara,598,1,140,354,17,89,45,646
Santa Clara,599,0,10,111,6,0,11,138
Santa Clara,600,0,14,203,1,7,5,230
Santa Clara,601,0,614,481,37,51,61,1244
Santa Clara,602,0,735,339,794,240,1432,3540
Santa Clara,603,13,701,805,1097,498,948,4062
Santa Clara,604,0,470,1709,2475,82,1026,5762
Santa Clara,605,0,1440,1379,6284,756,905,10764
Santa Clara,606,7,396,753,387,42,144,1729
Santa Clara,607,0,227,1612,85,2057,768,4749
Santa Clara,608,0,1365,980,3433,202,1543,7523
Santa Clara,609,1,223,627,53,136,600,1640
Santa Clara,610,0,49,182,103,31,51,416
Santa Clara,611,0,105,876,49,84,59,1173
Santa Clara,612,0,305,616,611,64,30,1626
Santa Clara,613,0,68,365,43,101,5,582
Santa Clara,614,2,15,431,2,24,0,474
Santa Clara,615,0,22,323,9,10,22,386
Santa Clara,616,0,9,553,10,12,2,586
Santa Clara,617,0,19,323,5,62,3,412
Santa Clara,618,0,16,70,10,1,5,102
Santa Clara,619,0,21,301,7,0,3,332
Santa Clara,620,0,100,661,29,61,7,858
Santa Clara,621,1,20,367,16,152,18,574
Santa Clara,622,0,2,267,2,8,9,288
Santa Clara,623,0,15,236,14,2,23,290
Santa Clara,624,0,10,67,0,0,0,77
Santa Clara,625,0,30,602,5,84,9,730
Santa Clara,626,0,28,306,4,6,6,350
Santa Clara,627,0,66,383,3,147,75,674
Santa Clara,628,51,49,351,29,9,30,519
Santa Clara,629,0,16,284,1,8,68,377
Santa Clara,630,0,70,668,19,123,17,897
Santa Clara,631,0,5,813,9,4,11,842
Santa Clara,632,0,50,634,24,616,37,1361
Santa Clara,633,0,106,929,35,36,57,1163
Santa Clara,634,0,63,411,35,308,651,1468
Santa Clara,635,0,83,263,51,6,45,448
Santa Clara,636,0,56,425,11,212,59,763
Santa Clara,637,3,96,94,27,5,109,334
Santa Clara,638,0,51,230,7,31,33,352
Santa Clara,639,2,10,182,0,137,76,407
Santa Clara,640,0,4,294,0,6,47,351
Santa Clara,641,0,3,234,10,11,25,283
Santa Clara,642,0,26,172,4,0,44,246
Santa Clara,643,0,8,210,2,4,41,265
Santa Clara,644,0,26,465,20,170,6,687
Santa Clara,645,0,72,672,6,13,18,781
Santa Clara,646,0,6,213,0,2,0,221
Santa Clara,647,7,41,70,0,0,16,134
Santa Clara,648,0,58,226,6,12,4,306
Santa Clara,649,0,12,389,26,171,52,650
Santa Clara,650,0,68,504,17,59,13,661
Santa Clara,651,0,8,800,25,51,25,909
Santa Clara,652,0,37,362,28,55,88,570
Santa Clara,653,1,112,1286,33,134,30,1596
Santa Clara,654,0,58,299,1,3,63,424
Santa Clara,655,0,291,473,41,1,82,888
Santa Clara,656,0,1176,1004,2375,67,758,5380
Santa Clara,657,0,138,363,35,66,19,621
Santa Clara,658,0,29,98,6,0,13,146
Santa Clara,659,0,188,294,33,37,14,566
Santa Clara,660,16,1186,1318,1611,374,515,5020
Santa Clara,661,0,491,4835,1628,540,51,7545
Santa Clara,662,0,23,126,0,2,34,185
Santa Clara,663,0,13,178,3,5,15,214
Santa Clara,664,0,40,229,13,3,36,321
Santa Clara,665,0,206,464,18,36,24,748
Santa Clara,666,0,60,166,19,0,41,286
Santa Clara,667,0,45,328,6,64,7,450
Santa Clara,668,0,21,204,145,5,13,388
Santa Clara,669,0,22,435,48,47,71,623
Santa Clara,670,0,17,508,16,23,58,622
Santa Clara,671,0,267,341,1,141,16,766
Santa Clara,672,0,65,173,26,29,9,302
Santa Clara,673,0,105,406,5,46,18,580
Santa Clara,674,0,84,648,13,129,34,908
Santa Clara,675,0,184,341,78,136,26,765
Santa Clara,676,0,231,1110,1204,270,233,3048
Santa Clara,677,0,161,1274,29,976,100,2540
Santa Clara,678,0,17,217,74,5,2,315
Santa Clara,679,2,31,562,60,398,31,1084
Santa Clara,680,0,117,416,8,764,88,1393
Santa Clara,681,0,117,551,25,137,47,877
Santa Clara,682,0,141,617,6,72,27,863
Santa Clara,683,0,29,133,6,106,14,288
Santa Clara,684,0,36,494,20,187,27,764
Santa Clara,685,0,65,288,22,23,46,444
Santa Clara,686,0,257,334,3,129,13,736
Santa Clara,687,0,113,753,39,1816,21,2742
Santa Clara,688,0,51,1911,29,110,25,2126
Santa Clara,689,0,62,154,1,56,35,308
Santa Clara,690,0,97,462,14,150,92,815
Santa Clara,691,0,8,184,5,95,12,304
Santa Clara,692,0,230,429,16,227,84,986
Santa Clara,693,0,18,335,2,18,3,376
Santa Clara,694,0,59,139,2,1,5,206
Santa Clara,695,0,115,192,4,0,63,374
Santa Clara,696,38,93,326,611,4,65,1137
Santa Clara,697,255,1181,148,143,48,100,1875
Santa Clara,698,46,69,785,47,421,92,1460
Santa Clara,699,257,125,104,46,51,38,621
Santa Clara,700,113,1088,2015,5404,915,1085,10620
Santa Clara,701,0,111,527,174,133,301,1246
Santa Clara,702,5,451,1674,140,237,453,2960
Santa Clara,703,15,88,140,13,11,71,338
Santa Clara,704,25,60,221,94,16,84,500
Santa Clara,705,101,81,1083,150,58,162,1635
Santa Clara,706,800,258,1591,1794,2093,646,7182
Santa Clara,707,43,387,1947,653,630,509,4169
Santa Clara,708,0,44,538,0,60,161,803
Santa Clara,709,2,173,830,42,285,170,1502
Santa Clara,710,11,413,502,7,112,47,1092
Santa Clara,711,21,105,206,32,13,155,532
Santa Clara,712,163,54,466,167,57,266,1173
Santa Clara,713,52,201,257,173,67,285,1035
Santa Clara,714,17,2,96,7,123,5,250
Alameda,715,30,7033,1009,5505,816,2447,16840
Alameda,716,0,336,328,436,6,705,1811
Alameda,717,0,40,920,129,18,90,1197
Alameda,718,89,495,518,826,371,1353,3652
Alameda,719,10,37,226,46,23,27,369
Alameda,720,1,271,247,644,99,68,1330
Alameda,721,0,248,1191,64,1071,266,2840
Alameda,722,0,58,291,21,36,54,460
Alameda,723,0,177,1079,118,142,159,1675
Alameda,724,7,150,1727,30,410,78,2402
Alameda,725,0,58,261,155,45,71,590
Alameda,726,0,68,162,25,202,138,595
Alameda,727,1,14,160,0,0,19,194
Alameda,728,0,1080,1555,1876,1632,1104,7247
Alameda,729,6,615,2333,451,876,573,4854
Alameda,730,1,1564,2077,1084,1178,685,6589
Alameda,731,0,62,66,6,11,10,155
Alameda,732,0,465,1976,769,756,619,4585
Alameda,733,0,286,2461,170,1059,67,4043
Alameda,734,1,357,562,370,110,859,2259
Alameda,735,1,16,331,85,3,91,527
Alameda,736,0,2348,1342,233,1073,4654,9650
Alameda,737,0,727,681,1816,379,484,4087
Alameda,738,0,27,410,10,4,14,465
Alameda,739,2,1594,2335,821,452,1261,6465
Alameda,740,0,33,575,18,32,40,698
Alameda,741,0,88,537,11,201,16,853
Alameda,742,3,5796,5914,1720,1601,2037,17071
Alameda,743,118,787,752,692,157,898,3404
Alameda,744,0,45,1149,55,65,306,1620
Alameda,745,0,57,127,9,45,37,275
Alameda,746,29,263,753,177,101,128,1451
Alameda,747,4,36,191,5,6,17,259
Alameda,748,0,20,72,6,2,8,108
Alameda,749,0,184,244,869,41,13,1351
Alameda,750,0,998,558,8990,857,407,11810
Alameda,751,0,2899,2299,15547,2680,3217,26642
Alameda,752,0,2156,2334,23731,802,1131,30154
Alameda,753,1,26,107,5,2,6,147
Alameda,754,15,58,955,73,26,14,1141
Alameda,755,0,253,563,143,31,372,1362
Alameda,756,8,355,350,289,64,498,1564
Alameda,757,0,7,120,5,16,13,161
Alameda,758,0,53,523,11,105,102,794
Alameda,759,0,42,103,57,41,19,262
Alameda,760,0,25,180,11,32,40,288
Alameda,761,0,870,1262,213,289,33,2667
Alameda,762,0,29,96,3,3,36,167
Alameda,763,0,1352,2087,8,30,75,3552
Alameda,764,0,55,930,44,632,44,1705
Alameda,765,0,33,470,11,127,15,656
Alameda,766,0,31,490,17,43,30,611
Alameda,767,0,798,1932,7211,959,225,11125
Alameda,768,28,2629,538,2410,293,259,6157
Alameda,769,0,903,405,381,9,153,1851
Alameda,770,0,129,785,119,192,55,1280
Alameda,771,0,213,775,5,360,56,1409
Alameda,772,0,22,79,15,68,55,239
Alameda,773,0,137,370,333,173,376,1389
Alameda,774,0,216,911,397,156,51,1731
Alameda,775,0,47,316,25,44,40,472
Alameda,776,0,200,682,33,5,38,958
Alameda,777,0,1232,2989,107,863,734,5925
Alameda,778,0,671,5043,15,18,119,5866
Alameda,779,0,28,106,28,6,10,178
Alameda,780,2,152,412,58,32,10,666
Alameda,781,0,38,170,37,3,27,275
Alameda,782,0,49,332,40,8,20,449
Alameda,783,0,6,42,86,0,0,134
Alameda,784,0,50,375,74,175,17,691
Alameda,785,0,21,347,50,18,11,447
Alameda,786,0,14,87,5,29,18,153
Alameda,787,0,40,449,36,124,39,688
Alameda,788,0,44,262,6,11,0,323
Alameda,789,0,27,171,19,7,40,264
Alameda,790,0,21,233,27,0,9,290
Alameda,791,2,174,604,74,136,6,996
Alameda,792,0,5,84,2,0,5,96
Alameda,793,0,32,266,40,55,23,416
Alameda,794,0,34,77,26,30,0,167
Alameda,795,0,126,424,744,13,138,1445
Alameda,796,23,308,1884,2286,1207,284,5992
Alameda,797,0,2165,552,2671,226,620,6234
Alameda,798,0,128,421,1397,9,28,1983
Alameda,799,0,10,114,39,0,11,174
Alameda,800,0,38,1064,44,85,272,1503
Alameda,801,0,282,813,255,320,123,1793
Alameda,802,0,14,166,10,0,25,215
Alameda,803,1,14,459,2,16,0,492
Alameda,804,0,21,323,7,31,64,446
Alameda,805,0,38,264,6,46,57,411
Alameda,806,26,425,983,5271,536,954,8195
Alameda,807,0,13,105,43,85,19,265
Alameda,808,0,3,106,2,0,1,112
Alameda,809,0,217,227,1376,5,566,2391
Alameda,810,11,3711,2240,10516,2556,2525,21559
Alameda,811,0,120,1634,406,376,273,2809
Alameda,812,0,461,784,12,398,35,1690
Alameda,813,0,5,1086,18,0,3,1112
Alameda,814,0,4,195,15,55,9,278
Alameda,815,0,13,145,1,15,0,174
Alameda,816,0,3,412,2,129,3,549
Alameda,817,0,35,267,30,14,11,357
Alameda,818,0,2,458,7,1,29,497
Alameda,819,0,31,90,19,40,17,197
Alameda,820,0,55,570,149,72,8,854
Alameda,821,0,21,1829,9,42,22,1923
Alameda,822,0,9,191,5,1,40,246
Alameda,823,0,26,337,3,4,176,546
Alameda,824,0,187,448,36,400,101,1172
Alameda,825,0,18,98,4,13,25,158
Alameda,826,0,32,256,79,139,167,673
Alameda,827,0,72,1161,6,153,362,1754
Alameda,828,0,216,741,48,444,392,1841
Alameda,829,0,29,378,24,1,295,727
Alameda,830,0,2,288,13,174,27,504
Alameda,831,0,8,361,38,44,8,459
Alameda,832,0,38,444,12,42,11,547
Alameda,833,0,11,129,1,0,12,153
Alameda,834,0,48,241,711,27,59,1086
Alameda,835,0,46,303,10,68,65,492
Alameda,836,0,15,103,62,384,95,659
Alameda,837,0,32,449,5,30,365,881
Alameda,838,0,96,521,4,177,16,814
Alameda,839,0,287,1504,46,243,463,2543
Alameda,840,0,111,550,35,216,89,1001
Alameda,841,0,19,416,10,29,23,497
Alameda,842,0,57,242,25,141,22,487
Alameda,843,0,31,255,7,17,7,317
Alameda,844,15,233,572,27,61,85,993
Alameda,845,0,24,542,9,2,21,598
Alameda,846,0,88,488,57,108,28,769
Alameda,847,0,278,475,40,33,59,885
Alameda,848,0,191,2559,44,561,79,3434
Alameda,849,0,32,258,3,99,34,426
Alameda,850,0,30,62,1,8,35,136
Alameda,851,0,14,142,0,0,18,174
Alameda,852,2,18,264,23,43,33,383
Alameda,853,0,23,1282,11,15,28,1359
Alameda,854,0,3,334,13,55,11,416
Alameda,855,0,10,511,15,10,26,572
Alameda,856,0,55,734,16,546,119,1470
Alameda,857,0,32,707,11,140,37,927
Alameda,858,0,43,514,30,463,25,1075
Alameda,859,0,39,226,12,37,10,324
Alameda,860,0,226,960,2335,99,920,4540
Alameda,861,0,253,4624,249,33,50,5209
Alameda,862,0,789,1013,1241,1254,1136,5433
Alameda,863,0,80,374,53,329,48,884
Alameda,864,0,130,1863,816,348,61,3218
Alameda,865,1,3,399,3,0,16,422
Alameda,866,0,10,461,1,3,31,506
Alameda,867,0,11,162,9,69,22,273
Alameda,868,0,43,292,5,4,19,363
Alameda,869,0,57,680,30,133,143,1043
Alameda,870,0,41,183,90,65,333,712
Alameda,871,3,724,2291,141,370,122,3651
Alameda,872,0,451,509,121,553,486,2120
Alameda,873,0,928,1144,4969,1701,1678,10420
Alameda,874,0,350,226,3079,0,11,3666
Alameda,875,138,2548,4056,6976,781,1541,16040
Alameda,876,0,0,61,36,0,53,150
Alameda,877,0,23,242,25,168,0,458
Alameda,878,0,92,397,161,41,35,726
Alameda,879,0,15,107,126,29,76,353
Alameda,880,0,0,244,12,6,47,309
Alameda,881,0,0,109,0,10,21,140
Alameda,882,0,10,363,2,117,5,497
Alameda,883,0,15,1020,0,5,12,1052
Alameda,884,0,31,264,7,5,23,330
Alameda,885,0,497,748,52,13,5,1315
Alameda,886,0,87,174,3,18,21,303
Alameda,887,0,305,450,1,20,0,776
Alameda,888,0,1,205,11,10,18,245
Alameda,889,0,6,197,0,1,0,204
Alameda,890,0,29,238,0,14,56,337
Alameda,891,0,14,175,0,18,17,224
Alameda,892,0,35,123,437,4,63,662
Alameda,893,5,70,158,89,24,130,476
Alameda,894,0,103,307,344,0,49,803
Alameda,895,0,369,1453,482,14,167,2485
Alameda,896,178,171,132,1679,327,200,2687
Alameda,897,0,75,163,6,172,8,424
Alameda,898,0,17,246,80,15,1,359
Alameda,899,0,7,569,7,23,9,615
Alameda,900,0,42,529,3,174,7,755
Alameda,901,0,18,122,2,1,1,144
Alameda,902,0,8,626,2,47,7,690
Alameda,903,0,21,119,6,13,9,168
Alameda,904,0,6,325,13,9,34,387
Alameda,905,0,23,285,3,10,18,339
Alameda,906,0,24,1835,24,145,35,2063
Alameda,907,0,46,152,54,14,50,316
Alameda,908,0,31,197,0,41,5,274
Alameda,909,0,23,316,4,23,27,393
Alameda,910,0,53,555,35,7,11,661
Alameda,911,0,33,587,0,123,29,772
Alameda,912,0,47,223,3,14,25,312
Alameda,913,0,292,567,63,296,71,1289
Alameda,914,0,84,165,128,12,12,401
Alameda,915,0,125,300,2,19,25,471
Alameda,916,0,78,816,17,321,13,1245
Alameda,917,0,83,285,1,70,172,611
Alameda,918,4,69,631,14,7,35,760
Alameda,919,0,13,23,20,0,2,58
Alameda,920,0,6,302,98,12,8,426
Alameda,921,0,57,265,9,3,9,343
Alameda,922,0,86,275,100,16,30,507
Alameda,923,2,46,371,27,216,34,696
Alameda,924,0,15,306,1,124,29,475
Alameda,925,0,187,534,3,73,31,828
Alameda,926,3,431,1852,580,526,219,3611
Alameda,927,0,44,678,3,27,2,754
Alameda,928,0,45,296,0,2,11,354
Alameda,929,0,3,380,14,7,17,421
Alameda,930,0,6,545,0,2,13,566
Alameda,931,0,17,3010,12,3,6,3048
Alameda,932,0,0,151,14,4,2,171
Alameda,933,0,9,506,58,22,29,624
Alameda,934,0,63,644,13,88,16,824
Alameda,935,0,0,181,0,1,0,182
Alameda,936,0,5,159,0,1,7,172
Alameda,937,0,34,301,12,154,54,555
Alameda,938,8,101,79,13,2,8,211
Alameda,939,9,205,654,55,147,70,1140
Alameda,940,0,73,362,22,56,12,525
Alameda,941,0,34,362,12,15,81,504
Alameda,942,0,197,804,22,97,32,1152
Alameda,943,0,29,356,48,30,16,479
Alameda,944,0,69,383,0,101,2,555
Alameda,945,0,1449,1472,3044,9,6864,12838
Alameda,946,0,248,1614,381,145,541,2929
Alameda,947,21,433,1815,592,362,404,3627
Alameda,948,0,121,475,78,72,597,1343
Alameda,949,25,24,620,152,204,46,1071
Alameda,950,0,127,798,14,169,44,1152
Alameda,951,0,35,367,35,34,12,483
Alameda,952,0,600,779,3485,22,1503,6389
Alameda,953,0,91,345,31,124,16,607
Alameda,954,0,65,903,9,762,2,1741
Alameda,955,0,18,1763,22,81,431,2315
Alameda,956,0,32,350,1,58,25,466
Alameda,957,0,23,717,5,0,2,747
Alameda,958,0,14,212,5,23,0,254
Alameda,959,0,54,313,6,210,19,602
Alameda,960,1,651,842,389,128,554,2565
Alameda,961,0,788,615,333,242,19,1997
Alameda,962,12,13,531,6,19,14,595
Alameda,963,0,36,395,18,13,212,674
Alameda,964,0,114,208,505,114,122,1063
Alameda,965,5,42,74,2436,21,70,2648
Alameda,966,0,88,480,481,1,52,1102
Alameda,967,5,597,1532,508,370,424,3436
Alameda,968,0,1079,3384,6439,288,1603,12793
Alameda,969,0,3562,2478,1213,291,1179,8723
Alameda,970,0,807,1625,90,78,3408,6008
Alameda,971,0,7849,4220,640,106,3454,16269
Alameda,972,0,444,1085,99,688,144,2460
Alameda,973,0,57,7515,36,18,29,7655
Alameda,974,0,116,1217,51,364,45,1793
Alameda,975,0,45,501,0,41,8,595
Alameda,976,0,179,817,87,229,141,1453
Alameda,977,0,123,2164,49,35,197,2568
Alameda,978,0,22,342,61,33,81,539
Alameda,979,0,266,4176,85,390,83,5000
Alameda,980,0,15,60,0,17,11,103
Alameda,981,0,0,242,0,5,0,247
Alameda,982,0,87,274,6,3,26,396
Alameda,983,0,3,180,0,10,16,209
Alameda,984,0,44,281,197,1,84,607
Alameda,985,0,4,211,69,27,6,317
Alameda,986,0,15,121,22,16,8,182
Alameda,987,0,29,118,11,3,3,164
Alameda,988,0,245,168,1667,970,415,3465
Alameda,989,0,37,184,316,18,249,804
Alameda,990,0,40,156,238,23,60,517
Alameda,991,33,5222,4109,2595,1211,2554,15724
Alameda,992,0,22,119,65,9,107,322
Alameda,993,0,88,440,480,40,176,1224
Alameda,994,0,3,155,0,4,16,178
Alameda,995,0,27,430,31,27,21,536
Alameda,996,0,332,279,34,33,34,712
Alameda,997,0,37,45,35,11,133,261
Alameda,998,0,109,1146,67,230,77,1629
Alameda,999,0,122,548,0,343,17,1030
Alameda,1000,0,84,536,85,53,68,826
Alameda,1001,0,23,188,0,30,16,257
Alameda,1002,0,134,519,2,34,97,786
Alameda,1003,0,57,2573,9,226,13,2878
Alameda,1004,5,73,227,15,56,80,456
Alameda,1005,0,49,120,6,14,23,212
Alameda,1006,0,50,662,59,58,14,843
Alameda,1007,0,5,244,0,0,20,269
Alameda,1008,0,80,1208,21,315,42,1666
Alameda,1009,0,45,329,17,183,2,576
Alameda,1010,0,179,682,54,66,270,1251
Alameda,1011,0,197,647,11,394,50,1299
Alameda,1012,0,47,366,48,4,30,495
Alameda,1013,0,24,163,18,10,33,248
Alameda,1014,124,2343,3321,3354,1623,1276,12041
Alameda,1015,0,80,633,5,111,15,844
Alameda,1016,0,87,481,56,87,26,737
Alameda,1017,0,70,567,2,22,21,682
Alameda,1018,17,1442,3210,162,327,971,6129
Alameda,1019,0,73,211,4,30,35,353
Alameda,1020,0,51,236,2,1,4,294
Alameda,1021,0,248,14120,13,76,146,14603
Alameda,1022,0,2453,158,96,83,4,2794
Alameda,1023,0,10,670,33,128,46,887
Alameda,1024,0,11,161,9,55,6,242
Alameda,1025,0,27,414,23,59,42,565
Alameda,1026,0,18,185,5,77,19,304
Alameda,1027,0,182,730,23,238,25,1198
Alameda,1028,0,45,69,6,0,21,141
Alameda,1029,0,576,80,6,5,72,739
Alameda,1030,0,2,125,3,9,2,141
Alameda,1031,0,38,147,3,27,26,241
Alameda,1032,0,4,127,0,3,12,146
Alameda,1033,0,159,560,57,136,26,938
Alameda,1034,0,45,220,2,131,17,415
Alameda,1035,0,40,408,0,21,12,481
Alameda,1036,0,44,516,5,38,41,644
Alameda,1037,0,44,213,45,101,4,407
Alameda,1038,16,48,470,0,272,114,920
Alameda,1039,0,43,462,33,137,126,801
Contra Costa,1040,0,3,196,1,39,2,241
Contra Costa,1041,0,177,457,21,428,3,1086
Contra Costa,1042,0,4,203,0,3,7,217
Contra Costa,1043,0,39,375,33,9,23,479
Contra Costa,1044,0,57,143,4,14,1,219
Contra Costa,1045,0,25,95,30,0,36,186
Contra Costa,1046,0,10,132,4,0,9,155
Contra Costa,1047,0,26,316,2,73,18,435
Contra Costa,1048,0,41,218,7,29,4,299
Contra Costa,1049,0,173,324,10,251,80,838
Contra Costa,1050,0,188,533,66,171,73,1031
Contra Costa,1051,0,129,1000,10,556,254,1949
Contra Costa,1052,0,6,69,0,0,1,76
Contra Costa,1053,0,18,255,13,1,25,312
Contra Costa,1054,0,15,194,3,84,3,299
Contra Costa,1055,0,56,487,14,64,45,666
Contra Costa,1056,0,40,376,14,28,380,838
Contra Costa,1057,0,6,145,5,37,6,199
Contra Costa,1058,0,116,639,120,227,125,1227
Contra Costa,1059,42,1035,748,1487,1213,737,5262
Contra Costa,1060,8,71,438,378,34,78,1007
Contra Costa,1061,0,22,511,44,118,92,787
Contra Costa,1062,48,1017,555,2426,743,710,5499
Contra Costa,1063,0,30,1699,28,18,53,1828
Contra Costa,1064,0,7,172,8,37,58,282
Contra Costa,1065,0,16,414,45,71,33,579
Contra Costa,1066,0,120,1655,3,492,207,2477
Contra Costa,1067,0,19,277,23,52,78,449
Contra Costa,1068,0,178,271,384,59,338,1230
Contra Costa,1069,13,687,1201,2528,735,1575,6739
Contra Costa,1070,0,10,172,12,25,45,264
Contra Costa,1071,0,44,197,73,54,26,394
Contra Costa,1072,0,8,958,73,166,11,1216
Contra Costa,1073,0,13,311,7,3,13,347
Contra Costa,1074,0,115,1039,15,843,99,2111
Contra Costa,1075,0,76,319,0,123,32,550
Contra Costa,1076,0,10,193,3,0,4,210
Contra Costa,1077,0,51,263,3,16,70,403
Contra Costa,1078,0,36,340,21,34,10,441
Contra Costa,1079,0,60,514,14,179,57,824
Contra Costa,1080,0,36,396,3,122,21,578
Contra Costa,1081,0,3,113,17,0,17,150
Contra Costa,1082,0,108,448,128,37,12,733
Contra Costa,1083,0,902,1409,695,258,278,3542
Contra Costa,1084,1,52,352,0,70,32,507
Contra Costa,1085,0,28,375,0,106,29,538
Contra Costa,1086,0,46,355,2,194,101,698
Contra Costa,1087,5,28,105,23,2,22,185
Contra Costa,1088,0,24,68,159,0,2,253
Contra Costa,1089,0,36,382,414,49,31,912
Contra Costa,1090,0,90,171,425,42,102,830
Contra Costa,1091,0,24,4030,48,143,23,4268
Contra Costa,1092,309,170,635,47,47,487,1695
Contra Costa,1093,0,55,284,7,6,3046,3398
Contra Costa,1094,0,65,198,87,30,2419,2799
Contra Costa,1095,0,430,161,840,123,1512,3066
Contra Costa,1096,0,409,532,536,593,950,3020
Contra Costa,1097,0,1828,1105,1971,528,3963,9395
Contra Costa,1098,0,116,281,32,246,35,710
Contra Costa,1099,0,421,283,55,39,101,899
Contra Costa,1100,5,56,609,17,257,52,996
Contra Costa,1101,0,81,131,9,26,49,296
Contra Costa,1102,33,6,2,1,0,38,80
Contra Costa,1103,0,84,479,9,203,140,915
Contra Costa,1104,0,24,89,1,0,1,115
Contra Costa,1105,0,9,33,0,0,7,49
Contra Costa,1106,17,149,902,11,158,78,1315
Contra Costa,1107,0,47,226,0,12,16,301
Contra Costa,1108,0,45,337,21,497,38,938
Contra Costa,1109,0,30,1443,71,0,65,1609
Contra Costa,1110,19,209,589,23,274,20,1134
Contra Costa,1111,0,27,367,2,0,272,668
Contra Costa,1112,0,309,1014,33,38,80,1474
Contra Costa,1113,0,3998,2866,183,844,430,8321
Contra Costa,1114,0,34,159,16,129,25,363
Contra Costa,1115,0,26,170,30,158,51,435
Contra Costa,1116,0,1083,518,42,27,115,1785
Contra Costa,1117,0,104,123,2,2,32,263
Contra Costa,1118,0,488,987,187,753,695,3110
Contra Costa,1119,0,44,493,33,169,110,849
Contra Costa,1120,0,59,325,8,222,40,654
Contra Costa,1121,0,3389,2968,263,1169,691,8480
Contra Costa,1122,6,2962,4991,1365,3470,1519,14313
Contra Costa,1123,0,373,762,54,703,183,2075
Contra Costa,1124,0,250,2633,5,111,282,3281
Contra Costa,1125,0,31,215,21,149,38,454
Contra Costa,1126,0,83,231,3,9,15,341
Contra Costa,1127,0,330,2456,3,80,72,2941
Contra Costa,1128,0,64,443,81,53,111,752
Contra Costa,1129,0,103,1024,2,113,453,1695
Contra Costa,1130,0,67,167,12,2,22,270
Contra Costa,1131,6,104,69,12,9,62,262
Contra Costa,1132,6,75,526,15,13,35,670
Contra Costa,1133,0,294,334,78,114,187,1007
Contra Costa,1134,10,455,952,226,453,251,2347
Contra Costa,1135,0,205,451,4,12,34,706
Contra Costa,1136,0,927,1013,10,4,415,2369
Contra Costa,1137,8,1397,4596,636,1523,288,8448
Contra Costa,1138,0,172,544,16,14,79,825
Contra Costa,1139,13,23,102,12,0,0,150
Contra Costa,1140,0,214,947,6,256,11,1434
Contra Costa,1141,5,94,4638,80,100,23,4940
Contra Costa,1142,0,34,92,51,2,27,206
Contra Costa,1143,0,98,919,4,1,48,1070
Contra Costa,1144,5,290,442,53,45,76,911
Contra Costa,1145,2,6167,3754,539,1696,1125,13283
Contra Costa,1146,1,1148,7568,69,2197,134,11117
Contra Costa,1147,0,231,993,21,182,171,1598
Contra Costa,1148,0,178,343,5,0,0,526
Contra Costa,1149,0,135,300,7,40,76,558
Contra Costa,1150,0,499,1324,47,506,181,2557
Contra Costa,1151,0,90,349,32,4,22,497
Contra Costa,1152,0,633,2401,123,621,218,3996
Contra Costa,1153,0,204,421,17,27,22,691
Contra Costa,1154,7,240,1023,71,163,159,1663
Contra Costa,1155,0,63,116,2,15,27,223
Contra Costa,1156,1,122,228,12,67,32,462
Contra Costa,1157,0,167,451,1,45,27,691
Contra Costa,1158,0,161,628,21,360,139,1309
Contra Costa,1159,0,24,714,12,26,13,789
Contra Costa,1160,12,175,433,7,0,60,687
Contra Costa,1161,1,1715,2978,213,952,836,6695
Contra Costa,1162,0,43,38,20,4,27,132
Contra Costa,1163,10,24,106,5,11,13,169
Contra Costa,1164,6,237,408,13,3,112,779
Contra Costa,1165,7,75,400,39,19,209,749
Contra Costa,1166,0,149,1337,48,50,87,1671
Contra Costa,1167,0,284,477,24,16,145,946
Contra Costa,1168,15,7095,3281,1219,946,2832,15388
Contra Costa,1169,0,1099,752,111,800,565,3327
Contra Costa,1170,18,824,2451,208,675,653,4829
Contra Costa,1171,0,118,475,7,112,38,750
Contra Costa,1172,0,39,308,23,126,18,514
Contra Costa,1173,0,5,310,2,0,24,341
Contra Costa,1174,0,49,335,109,5,21,519
Contra Costa,1175,816,1381,968,395,100,63,3723
Contra Costa,1176,38,704,3096,169,494,245,4746
Contra Costa,1177,70,376,820,163,41,267,1737
Contra Costa,1178,35,591,5539,256,1938,670,9029
Contra Costa,1179,257,671,3020,438,839,1486,6711
Contra Costa,1180,14,109,628,69,75,271,1166
Contra Costa,1181,7,23,155,16,17,24,242
Contra Costa,1182,23,125,798,164,271,276,1657
Contra Costa,1183,0,169,198,855,127,304,1653
Contra Costa,1184,0,31,271,39,37,56,434
Contra Costa,1185,2,243,1378,106,932,265,2926
Contra Costa,1186,0,167,2139,26,473,130,2935
Contra Costa,1187,0,102,1226,4,314,31,1677
Contra Costa,1188,1,79,640,104,95,360,1279
Contra Costa,1189,0,458,1980,330,1441,341,4550
Contra Costa,1190,0,25,307,0,198,1,531
Contra Costa,1191,0,147,494,3,34,377,1055
Contra Costa,1192,0,14,183,0,0,18,215
Contra Costa,1193,0,68,389,16,176,14,663
Contra Costa,1194,0,30,254,4,12,24,324
Contra Costa,1195,0,117,728,20,110,104,1079
Contra Costa,1196,0,36,227,18,0,56,337
Contra Costa,1197,0,458,646,7,189,11,1311
Contra Costa,1198,0,10,1039,0,314,62,1425
Contra Costa,1199,0,153,1376,537,378,551,2995
Contra Costa,1200,0,50,292,5,12,48,407
Contra Costa,1201,0,63,160,57,5,12,297
Contra Costa,1202,0,37,163,46,129,15,390
Contra Costa,1203,0,14,726,2,5,342,1089
Contra Costa,1204,0,6,420,103,316,344,1189
Contra Costa,1205,4,71,262,595,4,194,1130
Contra Costa,1206,0,14,135,212,105,285,751
Contra Costa,1207,0,134,108,38,0,20,300
Contra Costa,1208,0,30,231,7,79,21,368
Contra Costa,1209,0,12,94,237,48,4,395
Contra Costa,1210,0,18,195,34,17,71,335
Solano,1211,78,0,519,3335,341,2096,6369
Solano,1212,0,0,809,36,36,373,1254
Solano,1213,0,0,321,0,146,42,509
Solano,1214,0,0,165,3,19,49,236
Solano,1215,0,0,315,6,194,21,536
Solano,1216,0,0,54,12,18,16,100
Solano,1217,52,0,792,45,12,222,1123
Solano,1218,0,0,90,9,7,6,112
Solano,1219,0,0,211,4,34,236,485
Solano,1220,0,0,260,80,117,31,488
Solano,1221,0,0,146,3,7,11,167
Solano,1222,0,0,403,48,0,12,463
Solano,1223,0,0,151,427,23,506,1107
Solano,1224,0,0,542,142,45,237,966
Solano,1225,7,0,57,7,32,110,213
Solano,1226,0,0,80,232,108,4,424
Solano,1227,0,0,139,14,40,8,201
Solano,1228,0,0,105,0,0,27,132
Solano,1229,0,0,440,11,126,23,600
Solano,1230,0,0,393,24,15,0,432
Solano,1231,0,0,282,26,51,10,369
Solano,1232,0,0,474,5,130,42,651
Solano,1233,0,0,228,1,10,5,244
Solano,1234,0,0,634,88,177,250,1149
Solano,1235,0,0,204,3,24,0,231
Solano,1236,0,0,974,1,38,2,1015
Solano,1237,0,0,74,0,0,15,89
Solano,1238,0,0,908,314,0,288,1510
Solano,1239,0,0,34,0,0,9,43
Solano,1240,0,0,274,15,39,21,349
Solano,1241,0,0,2204,239,489,90,3022
Solano,1242,0,0,4009,5,51,7,4072
Solano,1243,0,0,1076,0,13,7,1096
Solano,1244,1,0,365,1,0,31,398
Solano,1245,0,0,104,38,8,11,161
Solano,1246,53,0,1331,68,1718,89,3259
Solano,1247,0,0,774,964,210,381,2329
Solano,1248,24,0,1450,144,566,524,2708
Solano,1249,28,0,997,608,420,324,2377
Solano,1250,0,0,678,1697,666,546,3587
Solano,1251,0,0,594,102,318,356,1370
Solano,1252,0,0,657,103,39,209,1008
Solano,1253,0,0,70,3,3,20,96
Solano,1254,0,0,190,10,4,14,218
Solano,1255,36,0,365,0,38,5,444
Solano,1256,0,0,176,62,50,71,359
Solano,1257,0,0,221,0,1,2,224
Solano,1258,0,0,118,1,16,38,173
Solano,1259,0,0,494,438,124,31,1087
Solano,1260,0,0,119,4,9,12,144
Solano,1261,0,0,178,9,113,56,356
Solano,1262,0,0,702,62,45,2934,3743
Solano,1263,0,0,519,6,22,583,1130
Solano,1264,0,0,413,8,95,7,523
Solano,1265,0,0,2864,13,1030,24,3931
Solano,1266,0,0,539,15,166,43,763
Solano,1267,0,0,413,0,132,81,626
Solano,1268,9,0,1193,36,87,66,1391
Solano,1269,0,0,1286,2,676,92,2056
Solano,1270,2,0,922,1078,51,286,2339
Solano,1271,3,0,341,69,45,53,511
Solano,1272,0,0,1951,0,0,1113,3064
Solano,1273,0,0,363,17,142,52,574
Solano,1274,0,0,754,54,458,93,1359
Solano,1275,0,0,145,9,79,7,240
Solano,1276,0,0,264,8,102,16,390
Solano,1277,0,0,127,3,16,18,164
Solano,1278,0,0,201,2,114,20,337
Solano,1279,108,0,2508,2752,451,1588,7407
Solano,1280,11,0,2478,145,2147,95,4876
Solano,1281,0,0,612,150,564,45,1371
Solano,1282,3,0,1320,113,564,946,2946
Solano,1283,0,0,718,10,22,22,772
Solano,1284,0,0,1378,133,344,882,2737
Solano,1285,0,0,225,3,3,35,266
Solano,1286,514,0,36,13,3,265,831
Solano,1287,251,0,11,152,106,54,574
Solano,1288,172,0,717,48,378,220,1535
Solano,1289,101,0,1020,1212,549,350,3232
Solano,1290,321,0,695,183,274,235,1708
Napa,1291,78,61,870,312,612,36,1969
Napa,1292,120,806,1670,4373,226,1527,8722
Napa,1293,352,28,352,62,92,96,982
Napa,1294,21,59,2760,216,27,71,3154
Napa,1295,12,56,929,53,744,256,2050
Napa,1296,260,15,211,50,22,85,643
Napa,1297,184,118,1479,42,212,125,2160
Napa,1298,49,447,1586,734,549,122,3487
Napa,1299,44,202,1451,239,171,1924,4031
Napa,1300,5,73,401,219,30,80,808
Napa,1301,0,142,383,117,41,314,997
Napa,1302,12,21,366,20,394,56,869
Napa,1303,3,11,75,19,1,18,127
Napa,1304,44,22,409,10,33,125,643
Napa,1305,113,183,1758,352,418,116,2940
Napa,1306,355,121,2840,242,663,167,4388
Napa,1307,38,25,518,100,21,45,747
Napa,1308,287,59,498,413,15,93,1365
Napa,1309,227,0,9,79,6,19,340
Napa,1310,13,31,1938,376,208,61,2627
Napa,1311,768,99,682,1443,11,161,3164
Napa,1312,204,21,62,46,0,47,380
Napa,1313,640,59,1324,2005,32,130,4190
Napa,1314,582,212,1522,1619,407,237,4579
Napa,1315,518,46,314,2186,56,674,3794
Napa,1316,236,11,21,239,14,27,548
Napa,1317,231,77,1386,398,153,159,2404
Sonoma,1318,151,130,733,358,91,62,1525
Sonoma,1319,40,148,399,100,92,219,998
Sonoma,1320,107,826,1350,214,279,215,2991
Sonoma,1321,49,127,192,103,22,138,631
Sonoma,1322,0,0,1,0,0,0,1
Sonoma,1323,126,444,1935,250,515,430,3700
Sonoma,1324,421,672,271,1751,112,526,3753
Sonoma,1325,81,1372,1297,4156,455,432,7793
Sonoma,1326,16,108,280,7,16,67,494
Sonoma,1327,24,21,1171,37,16,301,1570
Sonoma,1328,279,48,268,80,7,198,880
Sonoma,1329,276,79,459,419,388,194,1815
Sonoma,1330,0,44,238,18,71,147,518
Sonoma,1331,1,182,639,360,477,194,1853
Sonoma,1332,15,638,2234,895,895,463,5140
Sonoma,1333,0,11,94,4,7,52,168
Sonoma,1334,0,14,154,28,8,58,262
Sonoma,1335,0,63,665,21,353,79,1181
Sonoma,1336,21,670,2357,1562,387,577,5574
Sonoma,1337,112,950,3610,1527,1021,1306,8526
Sonoma,1338,2,26,352,9,83,77,549
Sonoma,1339,0,33,245,62,304,43,687
Sonoma,1340,0,75,319,265,1,140,800
Sonoma,1341,19,16,214,18,1,33,301
Sonoma,1342,0,14,1350,30,22,10,1426
Sonoma,1343,0,13,414,0,15,35,477
Sonoma,1344,0,124,620,31,324,253,1352
Sonoma,1345,0,33,64,13,2,18,130
Sonoma,1346,0,354,1185,317,78,217,2151
Sonoma,1347,3,115,312,18,91,166,705
Sonoma,1348,65,328,1145,508,1905,437,4388
Sonoma,1349,4,147,666,58,302,84,1261
Sonoma,1350,4,166,483,33,258,137,1081
Sonoma,1351,0,20,288,2,0,74,384
Sonoma,1352,0,9,31,48,0,38,126
Sonoma,1353,49,32,249,262,59,13,664
Sonoma,1354,65,172,299,91,167,216,1010
Sonoma,1355,0,20,237,11,41,40,349
Sonoma,1356,0,52,589,38,340,54,1073
Sonoma,1357,0,32,299,22,63,31,447
Sonoma,1358,1,51,1469,5,231,81,1838
Sonoma,1359,0,73,3331,35,412,41,3892
Sonoma,1360,10,194,225,5,26,37,497
Sonoma,1361,10,1014,1235,161,697,1132,4249
Sonoma,1362,0,355,670,39,144,160,1368
Sonoma,1363,0,293,6590,0,211,1971,9065
Sonoma,1364,0,26,529,23,137,38,753
Sonoma,1365,0,87,693,28,54,1239,2101
Sonoma,1366,2,509,1939,2270,187,145,5052
Sonoma,1367,9,83,350,51,16,175,684
Sonoma,1368,147,1415,2800,4188,219,1067,9836
Sonoma,1369,13,179,1408,756,442,466,3264
Sonoma,1370,159,44,344,191,119,220,1077
Sonoma,1371,6,20,408,4,43,69,550
Sonoma,1372,6,13,189,9,13,44,274
Sonoma,1373,5,542,1051,269,202,284,2353
Sonoma,1374,6,711,1304,495,776,522,3814
Sonoma,1375,2,208,746,333,140,63,1492
Sonoma,1376,2,477,1004,155,224,254,2116
Sonoma,1377,18,277,572,21,353,101,1342
Sonoma,1378,0,99,845,292,238,146,1620
Sonoma,1379,0,15,140,0,67,48,270
Sonoma,1380,45,529,965,1222,1562,1404,5727
Sonoma,1381,100,649,1145,832,236,1071,4033
Sonoma,1382,234,73,795,180,25,143,1450
Sonoma,1383,297,65,211,426,70,162,1231
Sonoma,1384,20,402,1318,667,513,399,3319
Sonoma,1385,17,27,314,16,27,98,499
Sonoma,1386,130,217,686,169,306,121,1629
Sonoma,1387,87,97,139,29,7,167,526
Sonoma,1388,7,11,66,5,0,46,135
Sonoma,1389,49,83,849,70,64,100,1215
Sonoma,1390,60,18,248,15,17,46,404
Sonoma,1391,27,40,604,26,120,46,863
Sonoma,1392,93,32,144,340,21,78,708
Sonoma,1393,9,22,289,403,40,32,795
Sonoma,1394,149,344,502,338,1,150,1484
Sonoma,1395,92,460,1103,654,621,654,3584
Sonoma,1396,83,89,775,96,162,102,1307
Sonoma,1397,106,90,428,434,249,236,1543
Sonoma,1398,374,23,234,14,12,50,707
Sonoma,1399,25,322,2053,852,624,478,4354
Sonoma,1400,210,45,112,548,28,47,990
Sonoma,1401,1347,59,525,1139,36,129,3235
Sonoma,1402,62,104,699,744,226,207,2042
Sonoma,1403,62,51,309,47,46,59,574
Marin,1404,0,77,66,50,0,18,211
Marin,1405,0,187,865,56,878,249,2235
Marin,1406,2,343,338,202,6,1286,2177
Marin,1407,4,2059,1317,2049,187,480,6096
Marin,1408,0,93,456,30,244,78,901
Marin,1409,83,290,691,155,172,118,1509
Marin,1410,0,160,398,4,279,363,1204
Marin,1411,6,96,823,12,11,179,1127
Marin,1412,0,742,2011,204,540,675,4172
Marin,1413,0,340,385,123,37,18,903
Marin,1414,0,95,292,29,31,95,542
Marin,1415,252,140,694,225,119,225,1655
Marin,1416,24,11,241,27,6,54,363
Marin,1417,0,18,91,0,9,8,126
Marin,1418,9,40,243,29,10,43,374
Marin,1419,0,44,245,5,66,56,416
Marin,1420,3,74,468,14,93,202,854
Marin,1421,0,501,3877,63,420,200,5061
Marin,1422,2,238,1118,115,85,232,1790
Marin,1423,3,107,363,34,50,53,610
Marin,1424,0,937,1537,285,136,454,3349
Marin,1425,0,550,1013,13,57,2037,3670
Marin,1426,0,73,225,56,85,54,493
Marin,1427,0,517,1383,31,440,187,2558
Marin,1428,0,1514,1393,1000,1974,1531,7412
Marin,1429,0,280,474,328,564,590,2236
Marin,1430,0,949,2642,140,469,904,5104
Marin,1431,0,192,484,50,78,111,915
Marin,1432,0,325,1216,62,236,236,2075
Marin,1433,0,88,204,16,6,39,353
Marin,1434,0,102,439,15,292,140,988
Marin,1435,1,45,367,7,8,30,458
Marin,1436,0,162,1359,24,279,76,1900
Marin,1437,0,263,2953,51,175,47,3489
Marin,1438,0,1200,1241,292,917,346,3996
Marin,1439,0,3,24,0,0,1649,1676
Marin,1440,0,156,1197,63,102,142,1660
Marin,1441,0,296,1539,301,979,274,3389
Marin,1442,6,195,680,49,319,68,1317
Marin,1443,2,212,1097,55,301,79,1746
Marin,1444,4,299,547,86,366,130,1432
Marin,1445,3,227,499,27,46,69,871
Marin,1446,0,207,670,48,56,157,1138
Marin,1447,0,139,148,2,70,91,450
Marin,1448,0,1049,1542,314,699,452,4056
Marin,1449,0,10,258,3,94,15,380
Marin,1450,0,120,397,12,201,39,769
Marin,1451,0,376,469,23,49,89,1006
Marin,1452,0,633,860,83,187,267,2030
Marin,1453,16,57,538,0,0,27,638
Marin,1454,54,65,235,8,37,40,439
