"TAZ","TOTHH","TOTPOP","hh_own","hh_rent","hh_size_1","hh_size_2","hh_size_3","hh_size_4_plus","hh_wrks_0","hh_wrks_1","hh_wrks_2","hh_wrks_3_plus","hh_kids_no","hh_kids_yes","HHINCQ1","HHINCQ2","HHINCQ3","HHINCQ4","AGE0004","AGE0519","AGE2044","AGE4564","AGE65P","gq_tot_pop","gq_type_univ","gq_type_mil","gq_type_othnon"
1,48,108,6,42,26,14,3,5,14,23,8,3,42,6,24,11,5,8,4,8,48,24,24,11,2,0,9
2,150,338,19,131,80,45,10,15,43,74,25,8,132,18,78,34,14,24,13,25,150,76,74,33,5,0,28
3,265,401,8,257,153,81,19,12,76,131,44,14,232,33,118,33,55,59,11,14,191,120,65,39,6,0,33
4,157,261,14,143,99,39,12,7,45,78,26,8,138,19,56,25,42,34,1,12,125,80,43,24,3,0,21
5,479,802,56,423,304,119,30,26,138,236,80,25,420,59,186,77,103,113,5,42,362,254,139,81,12,0,69
6,2128,3465,102,2026,1391,578,93,66,210,1504,394,20,2035,93,654,554,299,621,45,236,2298,597,289,376,376,0,0
7,3346,5981,24,3322,2287,720,180,159,1272,1560,475,39,3215,131,2019,706,436,185,103,290,2963,1723,902,991,39,0,952
8,5008,11031,66,4942,3533,837,283,355,2218,1785,667,338,4251,757,3383,933,620,72,239,772,3773,3557,2690,2943,0,0,2943
9,6071,12106,142,5929,3368,1627,546,530,1632,3171,1031,237,5496,575,3100,1408,852,711,410,1026,6357,3010,1303,1284,173,0,1111
10,4034,8265,463,3571,2131,1227,331,345,1058,1746,968,262,3440,594,1190,856,806,1182,226,709,4880,1757,693,1126,328,0,798
11,2548,4950,183,2365,1638,504,190,216,493,1359,598,98,2248,300,1344,393,446,365,124,325,2092,1777,632,728,0,0,728
12,811,1317,211,600,423,284,66,38,209,357,245,0,767,44,103,25,97,586,30,65,707,287,228,21,0,0,21
13,51,96,23,28,22,20,5,4,13,22,16,0,48,3,19,1,2,29,4,6,46,28,12,2,0,0,2
14,393,736,165,228,173,152,36,32,97,173,122,1,371,22,143,12,15,223,33,46,359,211,87,13,0,0,13
15,274,544,14,260,130,93,26,25,7,104,142,21,250,24,34,80,76,84,23,55,309,110,47,28,0,0,28
16,5429,9794,1320,4109,2403,2084,572,370,457,2098,2719,155,5203,226,554,384,880,3611,395,479,6651,1757,512,151,0,0,151
17,4560,8169,1562,2998,2079,1783,442,256,720,2477,1262,101,4292,268,798,553,877,2332,287,334,5073,1801,674,282,92,0,190
18,1027,1916,359,668,500,364,100,63,100,540,317,70,924,103,93,248,240,446,58,63,1276,432,87,189,0,0,189
19,883,2029,167,716,361,372,82,68,86,464,273,60,794,89,232,76,85,490,55,116,1378,422,58,274,0,0,274
20,2235,4794,506,1729,1030,743,252,210,351,1155,616,113,1981,254,695,283,424,833,151,285,2822,1109,427,442,11,0,431
21,3623,5811,596,3027,2098,1136,228,161,1374,1577,587,85,3465,158,2034,256,553,780,94,156,2619,995,1947,220,10,0,210
22,1213,1963,93,1120,685,390,73,65,278,732,181,22,1096,117,106,165,254,688,48,74,1010,378,453,35,0,0,35
23,644,1281,320,324,274,239,66,65,147,389,96,12,582,62,183,93,85,283,63,130,387,332,369,23,0,0,23
24,490,868,50,440,259,131,57,43,235,156,94,5,383,107,399,41,0,50,21,69,153,244,381,11,0,0,11
25,1603,3597,38,1565,522,547,274,260,569,711,235,88,1215,388,1158,244,147,54,111,440,925,1017,1104,14,0,0,14
26,750,1594,21,729,316,216,100,118,181,373,158,38,658,92,456,138,118,38,36,153,559,433,413,9,0,0,9
27,1525,3077,165,1360,707,444,187,187,508,694,205,118,1360,165,882,268,165,210,75,254,1036,690,1022,39,0,0,39
28,1968,3451,453,1515,938,698,188,144,450,846,628,44,1801,167,378,348,417,825,94,128,1665,744,820,13,0,0,13
29,3245,5028,424,2821,1950,1003,187,105,597,1740,894,14,3031,214,965,869,680,731,79,152,3057,1059,681,97,79,0,18
30,3945,7012,209,3736,2340,1047,250,308,1263,2035,571,76,3560,385,2138,939,414,454,159,499,3591,1813,950,340,0,0,340
31,2725,4282,137,2588,1693,760,146,126,559,1431,681,54,2663,62,1002,839,446,438,78,200,2538,952,514,134,14,0,120
32,3281,5511,311,2970,1809,1037,259,176,569,1625,908,179,3130,151,799,875,842,765,116,177,3072,1138,1008,47,0,0,47
33,2816,5458,459,2357,1263,970,330,253,659,975,1078,104,2579,237,942,465,520,889,170,241,3193,1016,838,23,0,0,23
34,2650,4684,515,2135,1242,989,258,161,461,1032,763,394,2526,124,567,307,609,1167,144,195,2717,820,808,0,0,0,0
35,2372,4587,547,1825,1025,857,275,215,465,793,877,237,2273,99,760,353,275,984,132,243,2364,891,957,0,0,0,0
36,2631,5581,168,2463,1012,928,415,276,940,1155,394,142,2301,330,1743,491,163,234,147,485,1870,1522,1557,93,0,0,93
37,1818,3565,161,1657,876,581,204,157,370,978,338,132,1645,173,857,360,273,328,69,217,1718,864,697,48,0,0,48
38,2373,4468,702,1671,990,890,296,197,498,1126,678,71,1964,409,514,350,286,1223,116,277,2281,1001,793,14,0,0,14
39,2072,4096,528,1544,812,778,325,157,371,942,613,146,1838,234,412,328,436,896,118,232,2147,875,724,1,0,0,1
40,2602,4556,794,1808,1188,1014,237,163,392,1204,946,60,2408,194,360,272,683,1287,145,233,2421,896,861,25,0,0,25
41,2134,4016,387,1747,1001,745,216,172,672,986,413,63,1785,349,1005,323,341,465,114,274,1892,849,887,88,0,0,88
42,645,2741,3,642,114,189,141,201,86,169,132,258,509,136,214,134,95,202,93,350,1295,751,252,639,0,68,571
43,3192,5652,646,2546,1553,1056,296,287,446,1597,1081,68,2754,438,398,360,796,1638,293,383,3344,1012,620,14,0,0,14
44,3685,6519,609,3076,1791,1316,371,207,401,1557,1456,271,3234,451,391,531,657,2106,223,269,4314,1000,713,34,34,0,0
45,2470,4563,604,1866,1080,916,258,216,219,1362,640,249,2079,391,343,180,563,1384,195,277,2688,780,623,12,0,0,12
46,4052,7157,820,3232,1869,1559,380,244,660,2075,1069,248,3606,446,517,524,682,2329,313,308,4113,1361,1062,112,84,0,28
47,1723,2921,443,1280,919,558,115,131,244,1086,391,2,1599,124,263,288,360,812,106,209,1521,586,499,18,0,0,18
48,2004,3864,664,1340,824,737,223,220,292,1106,585,21,1748,256,285,150,550,1019,178,355,1974,793,564,12,0,0,12
49,2265,4478,862,1403,981,778,252,254,499,1171,541,54,2079,186,280,281,467,1237,196,498,1812,1103,869,18,9,0,9
50,2423,4657,701,1722,1084,832,256,251,292,1124,894,113,1924,499,220,259,291,1653,208,353,2523,893,680,40,0,0,40
51,2088,3780,523,1565,1006,735,188,159,258,932,855,43,1882,206,245,268,328,1247,170,273,2061,784,492,0,0,0,0
52,1358,3701,14,1344,335,324,299,400,136,431,579,212,863,495,68,220,188,882,200,625,1897,776,203,0,0,0,0
53,33,285,0,33,16,7,7,3,0,25,8,0,33,0,13,0,16,4,3,15,163,76,28,215,0,0,215
54,2800,6829,1376,1424,866,909,477,548,810,742,916,332,2142,658,727,585,489,999,256,753,2471,1848,1501,90,0,0,90
55,1539,3595,711,828,474,549,239,277,365,623,465,86,1273,266,364,374,275,526,132,396,1261,1008,798,0,0,0,0
56,50,110,27,23,16,19,8,7,12,20,15,3,41,9,5,11,7,27,2,8,22,22,56,0,0,0,0
57,946,2440,708,238,222,314,157,253,176,296,386,88,634,312,92,79,162,613,112,456,561,736,575,0,0,0,0
58,2455,5513,622,1833,823,838,410,384,603,937,734,181,1942,513,726,541,548,640,219,564,2278,1339,1113,54,0,0,54
59,3179,7938,1306,1873,881,1041,564,693,579,1108,1051,441,2408,771,641,589,644,1305,320,945,3037,2092,1544,21,0,0,21
60,1567,3835,636,931,469,499,241,358,351,561,545,110,1197,370,304,453,288,522,131,443,1454,988,819,6,0,0,6
61,1883,4448,579,1304,573,654,305,351,365,732,687,99,1419,464,506,384,372,621,187,454,1981,1027,799,0,0,0,0
62,3225,7408,983,2242,998,1109,566,552,633,1211,1260,121,2493,732,610,629,844,1142,352,908,3053,1783,1312,13,0,0,13
63,2169,5318,900,1269,595,727,422,425,330,680,1051,108,1560,609,286,304,598,981,251,614,2065,1304,1084,16,0,0,16
64,2863,6793,1019,1844,811,982,520,550,456,1105,1148,154,2169,694,610,545,428,1280,271,744,2990,1615,1173,14,0,0,14
65,2442,5556,700,1742,818,832,419,373,394,920,975,153,1937,505,286,563,350,1243,225,640,2440,1309,942,71,0,0,71
66,2004,4386,553,1451,663,718,285,338,357,575,711,361,1524,480,396,403,438,767,162,443,1993,993,795,0,0,0,0
67,2142,5063,620,1522,677,731,346,388,359,711,821,251,1591,551,297,392,423,1030,209,491,2497,1070,796,100,89,0,11
68,1466,3284,452,1014,468,524,263,211,418,572,318,158,1291,175,484,292,214,476,118,309,1580,669,608,31,0,0,31
69,2690,8209,818,1872,890,933,433,434,315,849,1094,432,2144,546,303,431,632,1324,270,1794,4251,1138,756,2264,2141,0,123
70,2893,6093,840,2053,998,1105,409,381,447,1107,1042,297,2377,516,478,407,597,1411,311,607,2970,1326,879,6,0,0,6
71,1942,4351,879,1063,695,614,248,385,445,934,463,100,1448,494,487,206,305,944,263,690,1515,1005,878,19,0,0,19
72,1105,2286,420,685,423,395,162,125,187,453,322,143,932,173,145,226,182,552,93,163,1254,434,342,27,0,0,27
73,2434,4101,520,1914,1276,772,196,190,723,905,521,285,2160,274,742,423,463,806,153,186,2034,787,941,0,0,0,0
74,2163,3708,170,1993,1218,626,158,161,1060,667,341,95,2096,67,929,211,402,621,85,195,1546,588,1294,54,0,0,54
75,1966,3076,564,1402,1142,620,116,88,537,928,445,56,1885,81,391,384,318,873,81,63,1647,483,802,16,0,0,16
76,1699,2978,403,1296,952,570,93,84,410,983,296,10,1699,0,515,271,515,398,55,85,1402,696,740,373,0,0,373
77,2134,4567,562,1572,816,764,341,213,447,890,594,203,1747,387,752,269,393,720,144,362,2304,772,985,237,0,0,237
78,2881,5677,207,2674,1358,884,289,350,1580,810,295,196,2626,255,1801,509,342,229,180,616,1996,1203,1682,40,0,0,40
79,2168,3569,295,1873,1234,644,163,127,198,1146,676,148,2101,67,339,462,270,1097,102,162,2186,768,351,67,1,0,66
80,1999,4309,354,1645,850,652,279,218,342,809,707,141,1755,244,529,335,381,754,152,343,2525,848,441,58,0,0,58
81,4203,8098,769,3434,1953,1437,458,355,416,1958,1470,359,3843,360,855,876,666,1806,296,479,4822,1799,702,225,0,0,225
82,1780,3429,486,1294,720,679,229,152,316,863,488,113,1577,203,453,328,185,814,94,201,1912,890,332,30,0,0,30
83,2112,3977,1015,1097,817,900,214,181,298,818,935,61,1845,267,261,158,276,1417,173,223,1713,1234,634,20,0,0,20
84,2324,4850,657,1667,861,912,289,262,176,591,1244,313,2038,286,238,243,357,1486,155,331,2872,1086,406,64,0,0,64
85,1860,3775,336,1524,714,722,257,167,147,760,709,244,1567,293,216,216,380,1048,118,176,2431,656,394,28,0,0,28
86,3300,6920,731,2569,1320,1141,414,425,535,1356,1205,204,2889,411,680,640,680,1300,274,646,3628,1451,921,105,0,0,105
87,2377,5141,584,1793,862,862,347,306,333,948,903,193,2040,337,400,326,500,1151,242,437,2879,944,639,144,24,0,120
88,2578,5500,491,2087,898,1006,354,320,229,1094,955,300,2355,223,415,369,531,1263,186,290,3586,952,486,91,19,0,72
89,3491,7710,1306,2185,1173,1312,489,517,441,1280,1543,227,2788,703,371,622,685,1813,405,804,3742,1781,978,138,0,0,138
90,2094,4606,608,1486,728,702,356,308,237,932,752,173,1832,262,254,471,778,591,209,305,2629,902,561,167,110,0,57
91,2314,5517,977,1337,733,868,326,387,478,1035,711,90,1871,443,438,262,310,1304,263,588,2680,1215,771,488,474,0,14
92,1024,2494,735,289,287,309,144,284,239,265,414,106,754,270,204,133,160,527,100,314,593,770,717,19,0,0,19
93,4210,7896,1501,2709,1660,1754,439,357,690,1834,1366,320,3847,363,692,782,906,1830,272,478,3663,2429,1054,6,0,0,6
94,1329,2661,588,741,461,546,204,118,204,499,551,75,1060,269,207,164,186,772,92,210,1177,803,379,14,0,0,14
95,1420,3024,766,654,475,550,198,197,244,566,563,47,1169,251,190,195,294,741,178,330,1224,842,450,10,0,0,10
96,1148,2570,619,529,343,398,184,223,119,499,499,31,870,278,83,209,240,616,177,302,1031,712,348,16,0,0,16
97,1609,3414,699,910,500,629,233,247,267,646,611,85,1326,283,240,196,231,942,203,309,1607,825,470,0,0,0,0
98,1902,4123,838,1064,597,726,301,278,249,835,705,113,1557,345,216,277,299,1110,206,414,1886,1014,603,0,0,0,0
99,2035,4226,502,1533,815,756,250,214,446,863,553,173,1772,263,429,316,402,888,173,261,2369,945,478,116,0,0,116
100,1827,4309,313,1514,664,598,251,314,215,749,693,170,1460,367,443,458,208,718,145,369,2325,1023,447,83,27,0,56
101,2959,6781,486,2473,1174,910,380,495,592,920,1044,403,2528,431,749,682,604,924,244,625,3682,1496,734,49,0,0,49
102,2713,5524,676,2037,1080,983,362,288,279,1012,1262,160,2377,336,419,344,562,1388,221,391,2980,1315,617,129,0,0,129
103,2729,5194,948,1781,1074,1111,310,234,616,902,930,281,2545,184,566,453,383,1327,171,300,2547,1491,685,32,0,0,32
104,1901,3635,459,1442,796,752,209,144,256,1068,506,71,1759,142,324,248,357,972,132,171,2063,877,392,23,0,0,23
105,3229,6382,545,2684,1474,1052,376,327,537,1155,1261,276,2859,370,781,523,523,1402,195,455,3323,1499,910,120,0,0,120
106,3224,6943,559,2665,1647,913,296,368,591,1110,1117,406,3004,220,888,538,713,1085,179,539,3549,1859,817,730,0,0,730
107,893,2850,217,676,310,305,122,156,61,443,326,63,737,156,191,151,188,363,80,219,1596,708,247,735,0,0,735
108,1260,2743,268,992,482,478,142,158,290,332,591,47,1117,143,455,145,91,569,105,327,1626,494,191,221,169,0,52
109,3527,7272,1121,2406,1189,1532,474,332,308,1388,1330,501,2920,607,753,396,284,2094,266,410,4764,1196,636,357,142,0,215
110,2998,7470,632,2366,866,1312,426,394,236,940,1773,49,2403,595,572,258,532,1636,529,611,5200,849,281,872,851,0,21
111,2383,5016,589,1794,890,1043,270,180,51,1063,1231,38,2069,314,117,203,525,1538,190,190,3788,695,153,577,553,0,24
112,1035,2201,407,628,333,407,144,151,113,442,352,128,879,156,186,126,129,594,90,179,1188,488,256,8,0,0,8
113,2484,5837,1089,1395,711,924,437,412,535,1052,779,118,2010,474,540,272,469,1203,284,768,2906,1310,569,22,0,0,22
114,1753,3807,881,872,543,686,270,254,223,612,799,119,1379,374,217,239,223,1074,226,308,1890,943,440,62,0,0,62
115,675,1840,181,494,174,239,119,143,50,313,218,94,545,130,101,205,79,290,72,152,872,511,233,131,0,0,131
116,1875,4971,717,1158,525,627,324,399,229,696,683,267,1416,459,336,341,325,873,195,586,2473,1211,506,187,0,0,187
117,1588,4369,495,1093,375,509,304,400,113,644,561,270,1114,474,249,222,407,710,192,507,2283,941,446,28,0,0,28
118,1431,4288,287,1144,311,425,266,429,163,424,615,229,960,471,456,304,297,374,176,606,2175,911,420,22,0,0,22
119,786,2290,293,493,141,253,175,217,109,210,323,144,618,168,163,90,126,407,80,259,1099,559,293,17,0,0,17
120,1126,3016,402,724,280,367,228,251,152,310,511,153,936,190,255,234,51,586,127,305,1489,735,360,35,0,0,35
121,1306,3374,850,456,301,460,250,295,164,536,544,62,922,384,148,363,283,512,211,370,1389,869,535,60,0,0,60
122,2098,5180,1281,817,495,785,423,395,456,663,807,172,1579,519,519,381,262,936,272,648,2011,1472,777,26,0,0,26
123,1748,4227,752,996,452,627,345,324,161,685,691,211,1380,368,212,316,444,776,224,458,1990,1075,480,23,0,0,23
124,1269,3341,566,703,351,378,239,301,107,437,660,65,803,466,215,303,178,573,176,490,1382,827,466,34,0,0,34
125,1039,2878,739,300,221,359,199,260,131,350,432,126,795,244,210,144,229,456,163,386,1041,831,457,6,0,0,6
126,1520,4502,784,736,294,485,301,440,203,483,584,250,854,666,334,233,239,714,245,690,1760,1129,678,0,0,0,0
127,1766,4103,1077,689,511,612,295,348,274,515,753,224,1428,338,146,226,313,1081,268,530,1498,1114,693,7,0,0,7
128,2474,5451,1003,1471,790,870,417,397,207,1016,1094,157,1918,556,227,367,544,1336,331,587,2576,1278,679,24,0,0,24
129,2105,4416,1255,850,751,732,304,318,283,991,739,92,1689,416,171,211,467,1256,228,478,1630,1261,819,0,0,0,0
130,1840,4235,1257,583,595,604,291,350,391,742,650,57,1297,543,450,294,313,783,192,615,1209,1224,995,0,0,0,0
131,2638,6780,2184,454,541,953,492,652,685,742,1097,114,1859,779,388,535,487,1228,381,1075,1819,2061,1444,0,0,0,0
132,1551,4205,1036,515,319,509,311,412,361,418,500,272,1148,403,316,256,301,678,180,609,1362,1221,833,0,0,0,0
133,2455,6324,1566,889,563,866,465,561,382,650,1065,358,1921,534,358,305,531,1261,326,725,2356,1739,1178,13,0,0,13
134,2488,8046,1514,974,439,697,461,891,331,891,645,621,1639,849,351,460,657,1020,327,1157,2880,2222,1460,46,0,0,46
135,1567,5570,793,774,251,370,302,644,174,520,509,364,1089,478,339,362,411,455,196,861,2066,1498,949,0,0,0,0
136,966,3036,680,286,190,240,185,351,142,249,363,212,754,212,195,181,195,395,108,373,1065,853,637,11,0,0,11
137,1571,5440,1076,495,262,425,280,604,152,396,727,296,1077,494,357,381,346,487,213,723,1908,1509,1087,20,0,0,20
138,2627,9295,1455,1172,434,603,484,1106,356,795,939,537,1969,658,539,701,677,710,362,1305,3252,2603,1773,32,0,0,32
139,1323,5428,901,422,206,276,228,613,286,257,295,485,839,484,326,470,319,208,239,811,1789,1556,1033,37,0,0,37
140,1192,4156,782,410,224,327,189,452,249,270,366,307,882,310,324,287,225,356,196,640,1462,1167,691,0,0,0,0
141,765,2740,261,504,188,215,102,260,118,258,215,174,478,287,158,219,175,213,152,513,1060,690,325,57,0,0,57
142,273,1187,32,241,95,103,45,30,91,80,90,12,200,73,99,57,43,74,38,83,597,385,84,566,0,0,566
143,437,1438,212,225,126,123,72,116,68,148,122,99,274,163,164,117,101,55,88,193,520,381,256,29,0,0,29
144,1500,4156,447,1053,408,413,325,354,379,705,294,122,1006,494,882,268,174,176,258,824,1501,1005,568,23,0,0,23
145,1369,4148,110,1259,376,340,237,416,403,678,167,121,750,619,1012,313,41,3,276,1217,1459,833,363,20,0,0,20
146,552,1344,323,229,149,190,99,114,69,270,198,15,358,194,99,108,154,191,98,184,647,296,119,0,0,0,0
147,1311,5002,699,612,239,325,283,464,231,269,452,359,866,445,321,301,305,384,301,927,1954,1231,589,185,0,0,185
148,1132,4122,398,734,222,229,262,419,246,490,133,263,602,530,504,137,255,236,238,872,1542,1004,466,22,0,0,22
149,1606,5059,933,673,326,470,301,509,254,521,567,264,1113,493,422,402,260,522,276,821,1961,1317,684,110,0,0,110
150,1374,4382,608,766,353,349,197,475,340,400,386,248,940,434,530,303,347,194,239,674,1548,1100,821,106,0,0,106
151,620,2036,303,317,169,114,93,244,178,108,238,96,468,152,272,82,116,150,95,271,756,570,344,18,0,0,18
152,1395,4467,1004,391,282,358,231,524,249,425,452,269,1072,323,251,259,326,559,191,553,1511,1266,946,37,0,0,37
153,1087,4000,751,336,159,243,229,456,150,280,351,306,780,307,220,309,236,322,185,577,1351,1178,709,0,0,0,0
154,1064,4027,618,446,156,211,210,487,192,337,378,157,873,191,292,283,256,233,156,579,1293,1220,779,11,0,0,11
155,1019,3966,610,409,124,228,207,460,156,352,262,249,606,413,224,338,212,245,190,653,1282,1073,768,12,0,0,12
156,742,3109,353,389,89,149,160,344,85,231,202,224,491,251,219,226,164,133,139,554,1109,869,438,0,0,0,0
157,711,2564,194,517,105,188,152,266,202,287,105,117,406,305,426,130,79,76,138,641,883,603,299,0,0,0,0
158,386,1055,77,309,105,107,57,117,170,104,57,55,283,103,264,54,17,51,48,234,334,227,212,1,0,0,1
159,1438,4774,942,496,229,341,312,556,355,357,493,233,1085,353,369,455,347,267,178,683,1621,1349,943,26,0,0,26
160,1365,4905,902,463,202,330,269,564,113,526,495,231,890,475,151,583,310,321,181,769,1730,1357,868,0,0,0,0
161,1167,4175,693,474,173,298,208,488,130,270,477,290,842,325,194,379,227,367,159,626,1480,1170,740,6,0,0,6
162,1320,4775,765,555,211,296,236,577,269,397,478,176,929,391,345,451,317,207,181,655,1640,1318,981,17,0,0,17
163,1231,4462,788,443,199,311,240,481,197,315,359,360,786,445,200,441,213,377,177,651,1524,1240,870,4,0,0,4
164,1964,7543,1184,780,289,448,367,860,233,537,607,587,1366,598,367,446,516,635,335,1126,2628,2116,1338,32,0,0,32
165,1944,6818,1079,865,325,468,341,810,226,572,742,404,1318,626,449,501,433,561,310,900,2497,1862,1249,0,0,0,0
166,2712,9135,1571,1141,492,712,436,1072,313,933,904,562,2044,668,741,613,567,791,340,1177,3642,2353,1623,35,0,0,35
167,1925,7282,1247,678,309,454,367,795,195,485,680,565,1139,786,412,446,468,599,338,1052,2904,1814,1174,60,0,0,60
168,3059,9488,2026,1033,630,838,531,1060,475,1212,838,534,2465,594,610,776,848,825,375,1175,3745,2484,1709,36,0,0,36
169,2301,6684,1996,305,378,747,470,706,364,871,789,277,1527,774,331,528,305,1137,275,1032,1807,1919,1651,18,11,0,7
170,2177,5912,1631,546,469,712,405,591,477,675,779,246,1543,634,291,352,386,1148,257,958,1629,1700,1368,41,0,0,41
171,916,2449,761,155,188,301,171,256,123,351,371,71,693,223,59,93,186,578,117,407,661,748,516,12,0,0,12
172,1959,5322,1450,509,389,671,351,548,702,537,541,179,1556,403,284,394,474,807,245,788,1571,1510,1208,0,0,0,0
173,1379,3644,974,405,284,450,265,380,258,433,490,198,1057,322,185,227,243,724,139,494,1175,1009,827,0,0,0,0
174,2438,6037,1300,1138,601,833,460,544,469,1002,782,185,1892,546,524,341,386,1187,290,685,2511,1416,1135,14,0,0,14
175,2127,4521,455,1672,757,743,305,322,336,909,773,109,1771,356,255,482,495,895,184,351,2520,844,622,12,0,0,12
176,1874,4000,484,1390,647,686,273,268,375,835,536,128,1450,424,485,334,438,617,167,308,1980,901,644,55,43,0,12
177,3310,8727,1391,1919,879,974,654,803,510,1218,1190,392,2579,731,573,652,750,1335,356,934,3675,2073,1689,129,0,0,129
178,2389,6492,1437,952,504,757,466,662,434,942,656,357,1910,479,537,477,443,932,289,729,2378,1672,1424,16,0,0,16
179,2732,7827,1537,1195,519,811,544,858,516,865,910,441,1943,789,477,716,482,1057,337,952,2973,2083,1482,7,0,0,7
180,1770,4366,575,1195,512,572,303,383,220,712,554,284,1276,494,486,443,379,462,182,473,1960,1049,702,4,0,0,4
181,1913,5304,1113,800,414,572,387,540,328,594,714,277,1454,459,379,368,493,673,261,660,2034,1360,989,0,0,0,0
182,2404,6716,1474,930,542,759,479,624,507,863,662,372,1574,830,453,374,593,984,288,822,2408,1820,1378,17,0,0,17
183,2499,7382,1589,910,466,731,511,791,568,653,870,408,1804,695,634,312,625,928,328,970,2579,1943,1562,24,0,0,24
184,3047,8878,2058,989,553,890,624,980,655,986,870,536,2318,729,550,663,704,1130,355,1111,3049,2316,2047,8,0,0,8
185,2905,8249,1663,1242,629,858,543,875,686,905,706,608,2293,612,661,653,605,986,309,980,3060,2121,1779,7,0,0,7
186,2707,7915,1835,872,523,812,511,861,467,998,813,429,1964,743,335,630,543,1199,292,1103,2669,2098,1753,29,0,0,29
187,1436,4022,1150,286,281,424,278,453,362,412,474,188,953,483,304,244,225,663,130,666,1085,1202,939,0,0,0,0
188,544,1868,14,530,210,165,79,90,64,214,116,150,492,52,260,83,126,75,32,488,917,218,213,628,576,0,52
189,3183,7742,127,3056,948,1024,617,594,861,1516,425,381,2812,371,1336,637,584,626,354,1068,3561,1600,1159,0,0,0,0
190,1323,2365,240,1083,670,362,140,151,336,719,195,73,1055,268,349,407,331,236,83,208,1022,581,471,42,0,0,42
191,1440,4068,1075,365,273,458,303,406,348,385,546,161,1073,367,273,350,299,518,202,536,1366,1136,828,13,0,0,13
192,2654,7702,162,2492,518,749,592,795,231,984,878,561,1697,957,839,900,698,217,426,1237,3681,1636,722,10,0,0,10
193,2169,6849,1158,1011,364,562,426,817,229,649,913,378,1313,856,399,521,593,656,362,1068,2527,1815,1077,77,0,0,77
194,2004,7254,1201,803,328,514,375,787,369,514,635,486,1495,509,337,560,565,542,276,966,2507,1960,1545,195,0,0,195
195,1786,5638,1251,535,324,462,356,644,206,510,610,460,1323,463,229,350,496,711,249,796,1893,1607,1093,9,0,0,9
196,1921,6512,1463,458,295,500,365,761,211,479,866,365,1361,560,199,609,469,644,290,896,2391,1758,1177,7,0,0,7
197,1559,5939,1049,510,230,369,256,704,194,387,385,593,1157,402,345,267,318,629,222,823,2065,1617,1212,18,0,0,18
198,1691,5091,266,1425,372,418,338,563,157,514,701,319,1216,475,563,385,396,347,231,817,2105,1149,789,0,0,0,0
199,1155,2510,763,392,407,339,171,238,61,547,475,72,987,168,142,368,412,233,100,264,1001,749,396,1,0,0,1
200,968,2873,660,308,222,227,156,363,127,366,322,153,708,260,209,318,249,192,130,434,867,853,589,26,26,0,0
201,2796,8672,789,2007,570,707,482,1037,430,734,1238,394,1681,1115,1111,585,731,369,416,1508,3373,2068,1307,36,0,0,36
202,2242,7702,1385,857,343,577,445,877,392,545,669,636,1612,630,417,651,522,652,365,1152,2952,1948,1285,20,0,0,20
203,1565,5503,738,827,234,400,266,665,168,587,381,429,1162,403,334,470,456,305,266,895,2116,1444,782,0,0,0,0
204,2178,7898,1021,1157,362,492,395,929,333,501,1019,325,1685,493,715,398,576,489,347,1167,3151,1938,1295,59,0,0,59
205,2418,8334,1696,722,415,590,406,1007,363,665,567,823,1845,573,444,443,814,717,386,1178,3042,2331,1397,13,0,0,13
206,1221,3844,926,295,200,342,264,415,327,223,395,276,905,316,275,181,267,498,160,552,1333,1122,677,0,0,0,0
207,1177,4387,664,513,167,254,226,530,136,289,419,333,757,420,327,280,269,301,206,768,1561,1168,684,0,0,0,0
208,2210,5513,1416,794,541,708,381,580,496,735,853,126,1664,546,434,428,395,953,320,787,1897,1643,866,14,0,0,14
209,2565,7845,1870,695,478,693,507,887,277,914,1037,337,1849,716,284,659,655,967,378,1141,2705,2189,1432,19,0,0,19
210,1059,3911,310,749,155,199,211,494,150,324,319,266,632,427,341,307,253,158,243,855,1548,874,391,0,0,0,0
211,2902,8849,433,2469,670,830,439,963,407,1175,839,481,1926,976,765,1156,414,567,472,1572,3702,2028,1075,84,0,0,84
212,1245,4258,691,554,193,301,233,518,98,418,352,377,793,452,299,146,288,512,181,793,1465,1197,622,25,0,0,25
213,2689,6973,1499,1190,804,771,479,635,652,636,1061,340,2114,575,578,612,696,803,331,959,2154,1874,1655,31,0,0,31
214,2052,6411,1581,471,342,586,410,714,282,537,974,259,1565,487,343,522,587,600,353,978,2065,1817,1198,62,0,0,62
215,2176,6232,845,1331,446,615,422,693,270,812,911,183,1527,649,422,593,603,558,319,991,2419,1600,903,12,0,0,12
216,1511,3797,867,644,437,486,249,339,172,551,683,105,1091,420,342,295,421,453,194,464,1529,997,613,7,0,0,7
217,1337,4269,1105,232,187,417,281,452,160,288,684,205,836,501,131,216,374,616,224,626,1407,1177,835,64,0,0,64
218,1363,4148,783,580,280,404,204,475,289,380,413,281,1028,335,400,348,228,387,202,551,1476,1058,861,18,0,0,18
219,1929,6948,1428,501,228,487,362,852,328,573,579,449,1409,520,349,385,463,732,315,918,2410,1712,1593,11,0,0,11
220,1892,6037,1131,761,301,559,341,691,176,617,760,339,1247,645,370,351,532,639,330,1076,2238,1561,832,20,0,0,20
221,1526,4741,1061,465,284,434,316,492,230,330,680,286,1011,515,287,224,377,638,228,755,1670,1254,834,0,0,0,0
222,1787,4461,934,853,476,624,316,371,250,669,582,286,1303,484,299,417,404,667,214,558,1772,1256,661,12,0,0,12
223,1949,4630,928,1021,561,724,317,347,190,893,711,155,1592,357,336,448,485,680,225,605,1699,1327,774,31,0,0,31
224,1282,3376,1067,215,227,449,253,353,145,545,422,170,907,375,171,196,225,690,171,556,882,1091,676,0,0,0,0
225,1444,3967,1091,353,241,482,287,434,273,582,462,127,1044,400,234,314,332,564,242,682,1168,1208,667,0,0,0,0
226,2430,6555,1922,508,436,840,494,660,429,735,962,304,1794,636,250,588,672,920,328,1099,1841,1953,1334,14,0,0,14
227,2117,5601,1649,468,474,686,415,542,665,533,715,204,1405,712,301,565,450,801,259,909,1439,1545,1449,0,0,0,0
228,74,253,60,14,6,16,21,31,8,22,28,16,47,27,4,2,26,42,8,39,96,78,32,1,0,0,1
229,1864,5692,1202,662,255,580,398,631,197,547,721,399,1170,694,190,245,460,969,257,922,2077,1548,888,24,0,0,24
230,2894,8934,1988,906,506,776,584,1028,448,784,1170,492,2024,870,540,527,573,1254,483,1271,3227,2344,1609,10,0,0,10
231,1505,5185,1249,256,183,424,314,584,198,446,482,379,1106,399,255,226,333,691,225,762,1736,1310,1152,73,0,0,73
232,1817,5689,1421,396,284,545,377,611,381,551,642,243,1257,560,394,401,398,624,250,870,1835,1585,1149,128,0,0,128
233,3246,7612,2253,993,1004,1013,505,724,549,1391,1145,161,2396,850,511,833,852,1050,415,1005,2562,2160,1470,7,0,0,7
234,1936,3590,479,1457,823,706,223,184,254,949,604,129,1583,353,523,422,484,507,139,247,1933,699,572,0,0,0,0
235,1169,3338,909,260,226,363,178,402,209,274,528,158,788,381,173,225,284,487,199,541,1083,937,578,13,0,0,13
236,2213,5708,1212,1001,600,691,336,586,526,513,1019,155,1597,616,320,643,486,764,271,866,2072,1528,971,42,0,0,42
237,2633,8144,734,1899,513,700,532,888,223,890,799,721,1715,918,679,644,773,537,441,1474,3324,2023,882,31,0,0,31
238,1128,4227,651,477,184,235,216,493,124,183,480,341,612,516,123,306,317,382,221,777,1632,1086,511,0,0,0,0
239,0,0,0,0,0,0,0,0,0,0,0,0,0,0,0,0,0,0,0,0,0,0,0,0,0,0,0
240,1899,5190,692,1207,417,606,366,510,239,789,652,219,1317,582,475,320,518,586,296,808,1991,1325,770,42,0,0,42
241,1308,3653,979,329,298,366,223,421,305,429,408,166,803,505,272,205,300,531,167,649,919,1018,900,24,0,0,24
242,952,2828,837,115,152,274,191,335,252,157,381,162,662,290,148,155,209,440,135,528,714,810,641,0,0,0,0
243,984,2899,785,199,154,293,214,323,139,286,458,101,695,289,166,100,150,568,111,461,814,855,658,9,0,0,9
244,1903,5240,799,1104,416,544,365,578,378,449,839,237,1316,587,436,296,435,736,243,907,1694,1482,914,20,0,0,20
245,1281,3487,952,329,266,394,217,404,356,438,397,90,884,397,281,370,194,436,164,574,989,978,782,26,0,0,26
246,2939,8224,1781,1158,589,889,540,921,519,910,1269,241,1948,991,497,486,402,1554,394,1678,2183,2219,1750,130,0,0,130
247,1309,3870,994,315,197,353,247,512,294,443,510,62,875,434,183,164,294,668,208,948,916,1182,616,10,0,0,10
248,1404,3363,530,874,445,425,196,338,192,528,612,72,893,511,267,269,335,533,176,619,1221,927,420,77,0,0,77
249,2539,6278,1055,1484,710,857,389,583,243,1167,914,215,1821,718,351,370,698,1120,335,1163,2342,1609,829,14,0,0,14
250,1941,5014,1043,898,491,584,332,534,284,843,697,117,1146,795,297,298,413,933,290,1032,1550,1334,808,49,0,0,49
251,2757,5529,710,2047,1132,930,282,413,373,1372,916,96,2194,563,516,718,499,1024,294,727,2315,1345,848,5,0,0,5
252,1923,5924,1759,164,221,651,289,762,257,765,750,151,1012,911,203,151,172,1397,209,1434,1141,1767,1373,11,0,0,11
253,976,2588,736,240,169,384,155,268,230,283,379,84,678,298,126,87,270,493,79,508,643,795,563,0,0,0,0
254,1878,5785,1749,129,198,610,333,737,336,587,746,209,1184,694,81,255,224,1318,201,1319,1112,1830,1323,0,0,0,0
255,1286,3536,1073,213,224,443,206,413,284,445,473,84,812,474,155,119,252,760,166,806,764,1062,738,2,0,0,2
256,2488,4996,834,1654,1001,898,276,313,618,1038,828,4,1994,494,644,445,309,1090,245,566,1976,1067,1142,10,0,0,10
257,1766,3967,780,986,745,535,205,281,530,595,551,90,1416,350,367,447,322,630,237,470,1507,876,877,150,0,0,150
258,2892,6553,736,2156,1069,960,379,484,418,1131,1159,184,2302,590,752,581,749,810,346,839,2901,1508,959,119,0,0,119
259,2218,5410,919,1299,784,617,344,473,294,1118,578,228,1653,565,550,548,543,577,347,835,2255,1254,719,17,0,0,17
260,2470,8439,821,1649,476,710,431,853,281,789,991,409,1519,951,759,532,443,736,510,1595,3734,1724,876,51,0,0,51
261,1400,4411,834,566,243,376,307,474,175,342,650,233,825,575,283,235,490,392,291,837,1683,1044,556,8,0,0,8
262,1202,3997,709,493,211,381,214,396,98,573,267,264,941,261,283,187,295,437,206,658,1528,1063,542,90,0,0,90
263,803,2955,626,177,92,215,160,336,129,227,238,209,507,296,156,102,241,304,158,470,1035,828,464,122,0,0,122
264,1037,3251,846,191,159,299,203,376,169,283,467,118,730,307,153,151,210,523,156,565,992,948,590,76,0,0,76
265,1822,3543,924,898,743,616,253,210,270,1058,471,23,1480,342,360,411,450,601,207,300,1532,839,665,0,0,0,0
266,3032,7109,1135,1897,834,1086,520,592,452,1232,1125,223,2031,1001,579,340,514,1599,418,1039,2830,1430,1392,121,0,0,121
267,1314,3763,791,523,200,391,285,438,264,471,513,66,805,509,176,162,324,652,194,722,1193,979,675,48,0,0,48
268,1291,3656,773,518,224,360,279,428,182,404,579,126,795,496,47,228,252,764,191,751,1193,926,595,0,0,0,0
269,1605,4071,697,908,372,512,291,430,182,765,580,78,1109,496,193,234,378,800,225,705,1603,959,579,4,0,0,4
270,1281,3196,708,573,317,405,267,292,185,592,445,59,836,445,155,183,277,666,183,525,1200,714,574,0,0,0,0
271,2088,5618,1277,811,385,686,446,571,362,896,742,88,1286,802,286,286,463,1053,342,994,1998,1318,966,47,0,0,47
272,780,2330,621,159,105,253,154,268,142,207,369,62,500,280,43,132,142,463,108,481,568,671,502,3,0,0,3
273,1592,4275,855,737,274,557,322,439,190,604,741,57,984,608,217,244,406,725,266,731,1533,1127,618,0,0,0,0
274,2142,5696,744,1398,568,736,357,481,283,838,779,242,1745,397,370,384,551,837,330,814,2757,1155,640,0,0,0,0
275,1877,4799,730,1147,458,624,342,453,364,607,786,120,1387,490,492,285,381,719,303,711,2122,1112,551,12,0,0,12
276,1234,2839,596,638,357,447,165,265,231,322,594,87,973,261,225,213,385,411,148,348,1249,646,448,3,0,0,3
277,1750,4983,1091,659,320,537,381,512,187,509,752,302,1080,670,259,225,504,762,304,864,1843,1328,644,75,0,0,75
278,2540,6561,947,1593,540,956,513,531,148,1041,1293,58,1755,785,290,390,487,1373,545,960,3212,1351,493,177,0,0,177
279,1745,4553,870,875,387,602,321,435,209,885,607,44,1244,501,275,519,369,582,299,767,1820,1121,546,19,0,0,19
280,1349,3507,722,627,300,435,249,365,214,476,534,125,919,430,104,243,263,739,202,620,1151,1028,506,0,0,0,0
281,2052,4837,903,1149,668,630,309,445,390,711,846,105,1613,439,573,238,428,813,256,685,1725,1238,933,61,0,0,61
282,986,2594,746,240,247,284,148,307,190,330,376,90,643,343,147,171,182,486,151,523,636,753,531,0,0,0,0
283,1321,3592,1107,214,241,459,235,386,174,357,553,237,859,462,164,195,118,844,206,597,937,1051,801,47,0,0,47
284,1774,4948,364,1410,426,541,313,494,174,766,629,205,1282,492,355,425,437,557,344,788,2160,1057,599,21,0,0,21
285,1107,2995,951,156,203,362,235,307,174,372,436,125,739,368,119,113,131,744,197,483,836,896,583,1,0,0,1
286,2691,7388,1871,820,589,872,490,740,319,976,1280,116,1775,916,307,378,431,1575,390,1430,2465,1947,1156,373,325,0,48
287,992,2598,659,333,195,321,161,315,201,294,422,75,650,342,178,170,191,453,120,486,731,731,530,50,17,0,33
288,3049,7301,1155,1894,855,1071,438,685,566,1228,1213,42,1963,1086,596,543,607,1303,376,1236,2672,1801,1216,81,0,0,81
289,2146,6161,1924,222,303,663,428,752,270,583,1121,172,1139,1007,128,107,343,1568,306,1342,1479,1886,1148,0,0,0,0
290,1468,3685,879,589,337,522,263,346,306,584,468,110,1054,414,236,227,295,710,220,588,1100,1023,754,0,0,0,0
291,1227,3173,899,328,237,424,245,321,206,359,590,72,775,452,129,186,252,660,157,534,860,934,688,8,0,0,8
292,881,2447,738,143,142,295,140,304,133,315,344,89,588,293,86,134,136,525,127,485,560,739,536,0,0,0,0
293,2149,5970,1780,369,387,826,380,556,401,783,618,347,1670,479,211,556,455,927,266,995,1598,1816,1295,31,0,0,31
294,2413,6097,1827,586,499,930,433,551,281,1295,555,282,1890,523,312,259,504,1338,265,923,1540,2104,1265,11,0,0,11
295,1374,4178,937,437,254,453,245,422,214,408,639,113,997,377,129,303,389,553,233,755,1302,1170,718,13,0,0,13
296,3636,9278,2375,1261,1091,1245,447,853,713,1454,933,536,2690,946,771,573,843,1449,396,1529,2346,2713,2294,102,0,0,102
297,1679,4307,1007,672,481,612,248,338,200,581,670,228,1242,437,199,279,237,964,195,568,1282,1330,932,107,0,0,107
298,2639,6879,2109,530,536,973,415,715,725,1017,722,175,2128,511,244,270,482,1643,248,1298,1262,2072,1999,4,0,0,4
299,1159,3156,931,228,225,402,183,349,225,410,461,63,703,456,190,86,128,755,132,583,674,1011,756,0,0,0,0
300,965,2651,848,117,152,343,169,301,142,359,397,67,642,323,85,119,62,699,91,508,531,887,634,0,0,0,0
301,2212,6116,1807,405,374,761,406,671,339,679,1007,187,1317,895,56,332,505,1319,392,1106,1649,1822,1147,42,0,0,42
302,1630,4442,1450,180,253,627,300,450,223,453,896,58,1022,608,101,194,131,1204,221,736,1060,1437,988,24,0,0,24
303,1690,4723,1357,333,281,587,303,519,326,566,665,133,1145,545,185,264,291,950,306,759,1401,1399,858,26,0,0,26
304,2121,5553,1842,279,413,788,390,530,324,870,777,150,1524,597,165,301,299,1356,259,947,1248,1809,1290,90,0,0,90
305,726,2007,629,97,115,253,149,209,112,246,317,51,449,277,79,56,83,508,127,394,511,587,388,2,0,0,2
306,1348,3617,1020,328,229,444,267,408,204,504,492,148,804,544,169,156,274,749,207,694,970,1091,655,10,0,0,10
307,1800,5242,1557,243,260,535,363,642,226,681,721,172,1054,746,172,253,253,1122,291,1140,1354,1559,898,2,0,0,2
308,1630,4572,1275,355,317,462,288,563,184,397,881,168,859,771,164,200,326,940,273,1051,1194,1395,659,8,0,0,8
309,3670,8455,1663,2007,1158,1184,544,784,475,1484,1453,258,2569,1101,493,634,870,1673,494,1371,3209,2130,1251,42,0,0,42
310,677,1830,455,222,149,178,156,194,74,229,323,51,461,216,105,115,77,380,130,322,623,555,200,19,0,0,19
311,1748,4133,1270,478,503,571,303,371,260,722,709,57,1119,629,231,228,388,901,220,693,1256,1211,753,17,0,0,17
312,3310,8739,2099,1211,645,1065,673,927,502,1447,1262,99,2227,1083,544,293,597,1876,433,1796,2849,2655,1006,2,0,0,2
313,1647,4083,806,841,476,656,198,317,102,758,603,184,1130,517,324,367,298,658,168,475,1956,1098,386,153,0,0,153
314,1912,6250,416,1496,436,436,335,705,220,686,708,298,1286,626,627,661,349,275,356,1280,2601,1386,627,79,0,0,79
315,2387,4901,57,2330,818,1136,216,217,214,950,1150,73,2161,226,410,415,493,1069,183,350,3337,725,306,203,0,0,203
316,1000,2654,389,611,235,349,173,243,100,331,454,115,719,281,229,210,244,317,144,425,1228,616,241,17,0,0,17
317,2252,5418,901,1351,646,802,348,456,234,1014,878,126,1616,636,267,441,616,928,291,792,2198,1428,709,27,0,0,27
318,1072,2955,794,278,216,312,202,342,140,377,489,66,607,465,129,145,121,677,158,665,797,888,447,1,0,0,1
319,1194,3383,998,196,180,412,244,358,234,355,513,92,877,317,180,109,226,679,186,592,881,1047,677,11,0,0,11
320,2235,5844,997,1238,545,729,430,531,256,799,940,240,1421,814,332,544,396,963,373,879,2269,1523,800,41,0,0,41
321,1062,3034,871,191,176,317,192,377,218,275,487,82,682,380,169,94,210,589,209,518,941,824,542,16,0,0,16
322,1966,4925,1399,567,470,668,338,490,349,730,733,154,1495,471,269,318,292,1087,297,771,1445,1425,987,2,0,0,2
323,1802,5309,661,1141,468,528,301,505,230,816,576,180,1169,633,428,491,344,539,301,812,2093,1143,960,290,0,0,290
324,1423,4090,196,1227,340,421,238,424,112,485,633,193,793,630,390,476,316,241,262,770,1839,858,361,6,0,0,6
325,2178,6247,676,1502,469,648,408,653,147,1017,755,259,1629,549,486,609,481,602,387,1132,2701,1440,587,22,0,0,22
326,861,2767,91,770,164,198,182,317,64,349,278,170,529,332,266,351,143,101,154,592,1310,559,152,38,0,0,38
327,1518,5579,391,1127,257,274,302,685,145,635,439,299,751,767,443,360,395,320,342,1273,2229,1277,458,135,0,0,135
328,1162,3394,780,382,257,354,206,345,199,375,399,189,842,320,203,156,257,546,174,583,1209,935,493,0,0,0,0
329,1286,4622,648,638,221,288,229,548,129,523,383,251,864,422,331,376,346,233,260,980,1772,1114,496,72,0,0,72
330,1639,5535,675,964,300,389,295,655,147,488,575,429,843,796,507,411,368,353,360,1134,2195,1275,571,23,0,0,23
331,2012,6483,683,1329,513,521,321,657,186,726,577,523,1376,636,426,471,430,685,402,1182,3020,1303,576,13,0,0,13
332,963,4495,581,382,80,170,151,562,79,295,293,296,546,417,169,265,290,239,240,971,1850,983,451,25,0,0,25
333,2682,10877,1330,1352,372,479,443,1388,113,742,1011,816,1725,957,371,625,600,1086,681,2333,4364,2499,1000,77,0,0,77
334,1665,7421,763,902,230,304,259,872,209,359,622,475,969,696,381,594,335,355,434,1569,3069,1625,724,28,0,0,28
335,2784,8421,437,2347,712,535,402,1135,231,1655,522,376,1832,952,1047,669,479,589,539,2151,3562,1657,512,9,0,0,9
336,1639,4383,1028,611,357,496,294,492,189,749,579,122,1007,632,193,192,297,957,249,913,1368,1233,620,0,0,0,0
337,571,1488,333,238,147,173,81,170,65,263,201,42,350,221,77,62,119,313,68,287,416,451,266,0,0,0,0
338,821,2484,657,164,143,206,130,342,76,281,378,86,478,343,68,114,125,514,163,640,649,709,323,65,0,0,65
339,901,2668,805,96,125,297,180,299,182,332,310,77,554,347,67,53,75,706,84,579,498,853,654,0,0,0,0
340,2032,4792,798,1234,565,699,306,462,262,974,658,138,1397,635,353,187,583,909,316,795,1995,1089,597,23,0,0,23
341,2137,4561,557,1580,787,690,300,360,369,842,887,39,1467,670,379,397,412,949,303,599,1950,954,755,8,0,0,8
342,1337,4485,1176,161,205,505,222,405,296,570,390,81,937,400,141,111,221,864,107,1023,1033,1136,1186,596,539,0,57
343,811,2351,681,130,120,283,132,276,140,366,299,6,472,339,81,64,123,543,102,528,469,758,494,13,0,0,13
344,1152,3384,1013,139,183,330,204,435,122,449,530,51,573,579,145,93,92,822,147,952,587,1103,595,0,0,0,0
345,1752,4659,1318,434,399,528,309,516,297,652,731,72,1019,733,154,227,214,1157,236,1059,1121,1343,900,10,0,0,10
346,1358,3383,920,438,330,489,210,329,320,491,448,99,965,393,175,153,200,830,120,675,939,816,833,0,0,0,0
347,2848,7822,2546,302,498,1087,471,792,772,809,1097,170,2205,643,305,402,307,1834,199,1285,1472,2416,2450,83,0,0,83
348,0,0,0,0,0,0,0,0,0,0,0,0,0,0,0,0,0,0,0,0,0,0,0,0,0,0,0
349,369,1014,271,98,67,100,64,138,55,84,152,78,243,126,52,23,38,256,50,194,290,273,207,4,0,0,4
350,1007,3662,900,107,177,379,148,303,199,419,303,86,743,264,58,110,80,759,93,565,1470,751,783,979,977,0,2
351,2115,4870,819,1296,713,690,317,395,379,661,945,130,1538,577,374,270,330,1141,202,841,1722,1170,935,23,0,0,23
352,427,2806,6,421,92,227,66,42,107,214,99,7,377,50,161,230,30,6,47,71,2529,155,4,1857,1854,0,3
353,1965,6352,30,1935,873,797,139,156,491,986,457,31,1738,227,1066,513,166,220,234,324,5510,269,15,2901,2896,0,5
354,972,5399,6,966,603,262,39,68,243,489,225,15,860,112,612,214,108,38,29,173,4931,252,14,3797,3791,0,6
355,2143,7168,158,1985,1039,623,228,253,449,1100,570,24,1683,460,400,472,455,816,249,561,4982,539,837,3207,3191,0,16
356,3944,7859,1235,2709,1770,1221,433,520,963,1676,1170,135,3251,693,1118,545,624,1657,308,1012,2861,1756,1922,23,0,0,23
357,1734,4800,1327,407,300,595,327,512,194,746,620,174,1054,680,89,81,361,1203,192,1058,1073,1461,1016,20,0,0,20
358,1919,5623,1593,326,251,608,359,701,427,700,718,74,1157,762,260,193,248,1218,177,1341,1128,1832,1145,0,0,0,0
359,1326,3722,941,385,212,454,260,400,193,437,637,59,738,588,98,64,148,1016,126,764,941,1106,785,15,0,0,15
360,2033,5512,1165,868,408,628,374,623,396,752,731,154,1468,565,225,278,478,1052,228,1138,1675,1527,944,0,0,0,0
361,2473,7077,1391,1082,483,679,481,830,227,961,928,357,1211,1262,198,287,491,1497,336,1648,2191,1975,927,6,0,0,6
362,2181,6118,1564,617,448,614,397,722,386,729,986,80,1196,985,248,173,356,1404,256,1370,1481,1684,1327,6,0,0,6
363,1126,2836,570,556,309,327,186,304,183,357,365,221,633,493,235,89,161,641,82,587,789,772,606,0,0,0,0
364,706,2010,532,174,119,215,136,236,166,264,235,41,461,245,67,71,82,486,91,468,442,578,431,4,0,0,4
365,1837,3829,314,1523,763,510,263,301,190,955,559,133,1502,335,356,295,487,699,154,591,1839,886,359,0,0,0,0
366,2229,5596,826,1403,635,649,379,566,247,981,920,81,1661,568,294,403,326,1206,252,1117,2089,1421,717,20,0,0,20
367,2379,6411,1383,996,526,758,448,647,432,859,967,121,1648,731,378,338,507,1156,259,1326,1751,1844,1231,0,0,0,0
368,1450,4370,1259,191,150,485,273,542,367,567,398,118,1091,359,146,227,203,874,117,924,868,1359,1102,4,0,0,4
369,1996,5272,1465,531,490,592,289,625,597,462,878,59,1275,721,213,253,313,1217,168,1141,958,1521,1484,12,0,0,12
370,1792,4713,1284,508,400,574,277,541,395,669,678,50,1123,669,226,159,255,1152,201,1051,993,1416,1052,0,0,0,0
371,1348,3725,994,354,240,410,247,451,171,519,555,103,803,545,101,123,164,960,155,831,996,1132,611,7,0,0,7
372,2871,6783,833,2038,909,931,485,546,329,1553,871,118,2116,755,505,363,736,1267,407,1076,3468,1218,614,19,0,0,19
373,1259,3205,787,472,292,374,237,356,193,480,516,70,861,398,216,233,178,632,206,548,967,868,616,1,0,0,1
374,1316,3347,540,776,337,476,252,251,121,494,591,110,934,382,213,203,300,600,253,400,1729,725,240,41,0,0,41
375,1851,3621,501,1350,802,605,221,223,347,659,714,131,1481,370,479,195,313,864,208,323,1712,624,754,0,0,0,0
376,1843,4748,842,1001,531,591,314,407,188,744,744,167,1358,485,304,275,320,944,286,680,1970,1111,701,65,0,0,65
377,2594,5430,1010,1584,957,932,382,323,332,1218,868,176,2082,512,263,593,603,1135,292,512,2959,1088,579,29,0,0,29
378,1699,3673,433,1266,504,698,285,212,171,778,700,50,1346,353,235,247,308,909,228,370,1952,829,294,41,0,0,41
379,2420,5664,470,1950,793,811,367,449,222,1181,806,211,1916,504,455,543,429,993,321,752,3081,1113,397,19,0,0,19
380,2177,5196,212,1965,758,687,287,445,50,1219,787,121,1640,537,549,392,367,869,344,734,3023,809,286,68,0,0,68
381,2520,6110,1274,1246,768,718,407,627,287,1364,692,177,1745,775,504,249,531,1236,297,1189,2153,1660,811,0,0,0,0
382,1090,2966,642,448,237,312,181,360,103,445,529,13,650,440,85,210,189,606,199,618,938,809,402,6,0,0,6
383,726,2087,588,138,105,213,158,250,67,234,288,137,352,374,21,59,110,536,98,467,413,631,478,0,0,0,0
384,1591,4849,1415,176,187,466,311,627,342,599,520,130,972,619,116,163,201,1111,180,1170,991,1554,954,6,0,0,6
385,988,2964,883,105,115,324,193,356,189,476,260,63,607,381,89,117,113,669,92,703,572,924,673,0,0,0,0
386,1060,2972,959,101,161,383,176,340,209,424,391,36,658,402,200,91,117,652,94,649,526,980,723,0,0,0,0
387,1320,3896,1118,202,168,426,246,480,167,467,567,119,734,586,112,58,171,979,139,888,841,1291,737,17,0,0,17
388,2124,6394,1882,242,257,686,382,799,363,748,785,228,1297,827,144,186,354,1440,213,1556,1239,2051,1335,0,0,0,0
389,1948,5391,1382,566,391,597,334,626,417,668,706,157,1185,763,368,207,248,1125,238,1150,1362,1496,1145,13,0,0,13
390,1446,3294,592,854,449,513,219,265,254,500,642,50,1080,366,244,217,224,761,199,490,1485,751,369,0,0,0,0
391,3063,7248,938,2125,860,1093,524,586,430,1590,868,175,2144,919,397,497,734,1435,381,1001,3527,1362,977,157,0,0,157
392,2373,5907,161,2212,528,899,505,441,136,1035,1058,144,1725,648,248,628,490,1007,471,692,3644,838,262,1,0,0,1
393,1923,4765,515,1408,462,731,365,365,205,1066,515,137,1595,328,320,386,485,732,339,598,2345,973,510,1,0,0,1
394,1492,4252,834,658,301,472,288,431,182,452,654,204,1000,492,259,155,266,812,270,724,1623,1063,572,182,0,0,182
395,2387,5185,746,1641,655,995,448,289,150,1218,851,168,1810,577,207,275,612,1293,392,395,3149,899,350,0,0,0,0
396,4,10,2,2,1,1,1,1,0,2,2,0,3,1,0,1,1,2,1,1,5,2,1,0,0,0,0
397,981,2619,656,325,162,337,236,246,50,443,391,97,663,318,53,73,169,686,241,394,1271,563,150,0,0,0,0
398,1363,3157,554,809,393,463,281,226,68,617,543,135,921,442,150,325,219,669,242,329,1749,610,227,0,0,0,0
399,16,41,9,7,4,5,4,3,1,7,6,2,11,5,4,4,3,5,3,6,20,7,5,0,0,0,0
400,1899,4681,689,1210,541,587,363,408,161,899,659,180,1340,559,275,328,302,994,322,682,2325,931,421,0,0,0,0
401,347,1052,227,120,76,107,96,68,52,179,82,34,268,79,143,94,54,56,24,131,455,287,155,102,0,0,102
402,194,699,4,190,20,35,45,94,4,90,99,1,56,138,14,72,40,68,70,207,292,106,24,0,0,0,0
403,2,8,1,1,0,1,0,1,0,1,1,0,1,1,0,1,0,1,0,1,4,2,1,0,0,0,0
404,598,2080,379,219,94,137,118,249,81,202,251,64,401,197,161,137,120,180,106,361,743,609,261,18,0,0,18
405,3,9,2,1,0,1,1,1,0,2,1,0,2,1,0,1,1,1,0,2,3,3,1,0,0,0,0
406,726,1678,180,546,174,270,151,131,10,419,266,31,537,189,45,57,140,484,163,148,1060,247,60,12,0,0,12
407,43,93,4,39,10,22,7,4,1,25,15,2,32,11,3,3,9,28,7,4,68,11,3,1,0,0,1
408,15,34,1,14,4,6,3,2,0,8,6,1,11,4,1,1,3,10,3,1,25,4,1,0,0,0,0
409,0,0,0,0,0,0,0,0,0,0,0,0,0,0,0,0,0,0,0,0,0,0,0,0,0,0,0
410,4925,10346,546,4379,1391,2188,861,485,67,2847,1803,208,3646,1279,453,479,1207,2786,925,498,7299,1346,278,78,0,0,78
411,0,0,0,0,0,0,0,0,0,0,0,0,0,0,0,0,0,0,0,0,0,0,0,0,0,0,0
412,8542,19982,1294,7248,2072,3710,1515,1245,341,3809,3419,973,6707,1835,880,1257,2420,3985,1391,1877,13047,2821,846,0,0,0,0
413,4008,10130,1168,2840,829,1399,862,918,254,1653,1930,171,2666,1342,656,416,749,2187,864,1596,5495,1663,512,15,0,0,15
414,996,3648,611,385,139,217,239,401,134,310,324,228,613,383,169,258,192,377,181,648,1286,883,650,57,22,0,35
415,744,2213,424,320,136,204,164,240,87,249,250,158,409,335,139,108,235,262,121,326,952,542,272,14,0,0,14
416,2877,7806,1078,1799,676,891,592,718,253,1098,1160,366,1932,945,359,316,668,1534,471,1093,3914,1651,677,15,0,0,15
417,0,0,0,0,0,0,0,0,0,0,0,0,0,0,0,0,0,0,0,0,0,0,0,0,0,0,0
418,605,1609,582,23,158,181,108,158,65,239,190,111,423,182,125,161,160,159,61,228,483,526,311,6,0,0,6
419,1197,3858,595,602,207,335,254,401,130,470,376,221,838,359,226,245,324,402,240,553,1701,870,494,15,0,0,15
420,758,2765,530,228,104,184,155,315,89,216,297,156,521,237,129,196,165,268,161,395,1096,716,397,9,0,0,9
421,3129,7602,2062,1067,822,1208,532,567,288,1512,1020,309,2688,441,535,754,817,1023,266,887,3094,2111,1244,0,0,0,0
422,3362,7776,1237,2125,946,1328,547,541,209,1547,1180,426,2634,728,297,535,671,1859,495,759,4317,1342,863,84,0,0,84
423,1708,4997,712,996,359,520,336,493,185,568,709,246,1167,541,409,345,387,567,275,768,2301,1134,519,0,0,0,0
424,2569,7345,1209,1360,572,735,540,722,191,925,1142,311,1682,887,491,670,536,872,416,1160,3190,1827,752,13,0,0,13
425,1440,3681,372,1068,379,513,248,300,92,492,661,195,1079,361,226,323,394,497,227,476,2007,683,288,0,0,0,0
426,1871,4537,674,1197,526,640,386,319,117,853,690,211,1393,478,208,341,328,994,281,523,2598,829,306,90,0,0,90
427,1256,2967,495,761,266,552,270,168,31,540,611,74,1040,216,91,68,305,792,219,212,2152,297,87,2,0,0,2
428,603,1419,235,368,127,267,130,79,14,258,296,35,501,102,43,32,148,380,105,98,1040,137,39,0,0,0,0
429,0,0,0,0,0,0,0,0,0,0,0,0,0,0,0,0,0,0,0,0,0,0,0,0,0,0,0
430,719,1636,44,675,242,291,84,102,76,303,250,90,538,181,95,149,130,345,84,206,1003,264,79,0,0,0,0
431,14,32,1,13,5,5,2,2,1,6,5,2,11,3,2,3,2,7,2,4,20,5,1,0,0,0,0
432,222,505,13,209,74,91,25,32,23,93,78,28,167,55,30,46,40,106,25,63,311,82,24,0,0,0,0
433,2324,5853,614,1710,650,736,453,485,248,979,809,288,1746,578,598,469,422,835,327,858,2849,1195,624,36,34,0,2
434,37,117,17,20,14,16,3,4,6,18,11,2,30,7,24,13,0,0,11,20,45,36,5,2,0,0,2
435,2178,4591,560,1618,867,679,311,321,361,1009,660,148,1728,450,603,498,467,610,244,524,2324,1012,487,84,0,0,84
436,1627,4333,841,786,388,464,313,462,145,686,596,200,896,731,300,337,434,556,293,689,1582,1164,605,7,0,0,7
437,2234,6249,871,1363,489,631,437,677,149,912,809,364,1503,731,385,557,427,865,385,1061,2703,1485,615,0,0,0,0
438,1764,4837,1031,733,385,596,343,440,211,613,705,235,1072,692,273,312,351,828,270,708,1839,1209,811,11,0,0,11
439,1142,3170,658,484,225,378,207,332,182,356,340,264,855,287,285,151,196,510,198,511,1150,826,485,0,0,0,0
440,3473,8860,982,2491,776,1158,784,755,315,1793,1111,254,2369,1104,559,429,826,1659,690,1201,4648,1632,689,0,0,0,0
441,2702,6621,647,2055,687,1019,470,526,315,976,1133,278,2193,509,510,369,565,1258,440,735,3616,1208,622,13,0,0,13
442,1089,3317,838,251,156,327,220,386,107,267,419,296,832,257,91,126,184,688,160,511,1145,938,563,13,0,0,13
443,2094,5791,650,1444,396,731,438,529,94,939,903,158,1593,501,216,380,586,912,334,818,2841,1224,574,0,0,0,0
444,2261,6174,1172,1089,492,705,460,604,263,912,761,325,1559,702,207,532,397,1125,367,909,2425,1555,918,1,0,0,1
445,3377,9304,1083,2294,649,1072,738,918,295,1493,1333,256,2196,1181,423,717,796,1441,672,1466,4441,1823,902,18,0,0,18
446,3557,9069,1392,2165,714,1269,822,752,215,1567,1404,371,2550,1007,221,554,962,1820,666,997,5101,1491,814,0,0,0,0
447,1861,4629,912,949,444,641,391,385,234,962,555,110,1309,552,251,298,287,1025,319,572,1917,1076,745,0,0,0,0
448,3298,7803,494,2804,968,1155,607,568,347,1694,862,395,2274,1024,643,566,864,1225,529,921,4294,1192,867,29,0,0,29
449,2714,6972,712,2002,686,679,639,710,322,1120,1071,201,1754,960,355,512,563,1284,566,1222,3238,1227,719,0,0,0,0
450,2491,5570,610,1881,731,951,408,401,299,819,1169,204,1979,512,300,409,709,1073,389,610,2913,1084,574,11,0,0,11
451,2475,7021,1447,1028,471,700,459,845,415,1008,833,219,1596,879,443,250,481,1301,491,1432,2416,1745,937,15,0,0,15
452,1079,3017,899,180,218,304,213,344,171,357,424,127,581,498,80,191,129,679,140,618,719,898,642,0,0,0,0
453,2615,7494,1630,985,477,653,528,957,270,1065,1027,253,1440,1175,265,288,623,1439,464,1655,2397,1963,1015,25,0,0,25
454,1552,4505,1224,328,226,453,328,545,245,509,702,96,913,639,104,144,256,1048,141,957,1042,1435,930,0,0,0,0
455,923,2683,792,131,120,304,154,345,255,248,324,96,653,270,161,106,119,537,106,578,568,907,524,2,0,0,2
456,3031,8460,911,2120,565,819,636,1011,436,1350,911,334,1773,1258,584,694,618,1135,441,1759,3102,2206,952,6,0,0,6
457,1769,5384,1120,649,227,463,385,694,245,524,933,67,848,921,153,242,246,1128,381,1251,1719,1281,752,0,0,0,0
458,1577,4725,957,620,211,418,371,577,250,591,567,169,708,869,218,198,164,997,302,1057,1598,1141,627,0,0,0,0
459,2894,8366,1664,1230,474,817,624,979,355,1136,1178,225,1959,935,357,397,579,1561,519,1623,3091,1983,1150,21,0,0,21
460,1527,4226,553,974,272,404,379,472,173,720,552,82,959,568,112,185,364,866,310,829,1795,905,387,28,0,0,28
461,1714,4925,1136,578,335,494,363,522,109,563,941,101,1100,614,187,305,442,780,265,857,1633,1366,804,17,0,0,17
462,1693,5153,1034,659,238,436,359,660,204,751,571,167,906,787,260,191,370,872,265,1169,1632,1458,629,30,0,0,30
463,1820,4647,1016,804,371,599,414,436,262,759,577,222,1297,523,140,414,427,839,287,673,1892,1078,717,0,0,0,0
464,1918,5005,1006,912,387,689,371,471,190,723,845,160,1346,572,278,274,522,844,351,710,2094,1170,680,20,0,0,20
465,3261,7667,1284,1977,979,1058,574,650,518,1350,1062,331,2473,788,775,736,509,1241,434,996,3178,1838,1221,41,0,0,41
466,1626,4120,1063,563,378,553,294,401,201,555,662,208,1209,417,241,354,294,737,225,622,1423,1231,619,9,0,0,9
467,2234,5198,690,1544,735,725,345,429,252,1165,671,146,1729,505,344,599,375,916,272,675,2234,1399,618,120,0,0,120
468,2260,5737,716,1544,575,728,403,554,469,866,832,93,1573,687,577,489,410,784,346,914,2243,1498,736,43,0,0,43
469,2590,7622,671,1919,552,666,477,895,329,1131,712,418,1388,1202,564,851,677,498,560,1624,3165,1620,653,0,0,0,0
470,2315,6334,1356,959,454,736,480,645,258,1060,772,225,1736,579,334,313,541,1127,374,1000,2389,1714,857,18,0,0,18
471,2398,5682,642,1756,682,876,378,462,298,848,1030,222,1884,514,457,676,675,590,356,721,2535,1265,805,40,0,0,40
472,2191,5520,422,1769,592,676,401,522,166,1191,770,64,1414,777,413,630,530,618,354,935,2676,1140,415,0,0,0,0
473,2601,7539,513,2088,552,755,484,810,342,1215,858,186,1681,920,798,786,388,629,458,1465,3003,1848,765,16,0,0,16
474,1625,4406,698,927,358,491,248,528,139,673,537,276,1197,428,255,413,421,536,257,727,1727,1158,537,14,0,0,14
475,1714,4682,789,925,369,507,324,514,153,841,574,146,1168,546,270,514,267,663,278,886,1680,1231,607,0,0,0,0
476,2595,7447,1554,1041,445,758,523,869,340,1012,1005,238,1568,1027,220,537,631,1207,371,1477,2214,2126,1259,18,0,0,18
477,2167,6551,1281,886,331,527,489,820,295,865,746,261,1311,856,355,377,336,1099,329,1437,2058,1878,849,0,0,0,0
478,2693,7280,603,2090,561,693,663,776,305,1341,622,425,1616,1077,561,552,743,837,512,1470,3260,1466,572,10,0,0,10
479,2907,9003,1455,1452,403,674,702,1128,355,1130,1235,187,1636,1271,406,363,525,1613,418,2186,3074,2392,933,63,0,0,63
480,1117,3472,953,164,75,336,240,466,115,396,504,102,711,406,80,103,146,788,95,777,714,1249,637,0,0,0,0
481,1632,4985,1343,289,181,443,344,664,272,586,633,141,871,761,93,239,348,952,116,1091,1173,1720,885,0,0,0,0
482,1445,4598,1198,247,127,336,377,605,148,464,707,126,737,708,146,117,157,1025,130,1012,1077,1657,722,0,0,0,0
483,2183,6311,1025,1158,401,484,497,801,277,1118,653,135,1382,801,528,286,451,918,278,1524,1992,1779,738,0,0,0,0
484,2932,8171,1571,1361,618,665,665,984,516,1311,932,173,1786,1146,451,454,536,1491,306,1888,2389,2312,1276,0,0,0,0
485,2294,6859,1314,980,334,535,495,930,276,1002,811,205,1180,1114,242,177,299,1576,312,1705,2156,1777,909,15,0,0,15
486,1931,5940,664,1267,251,388,531,761,166,1129,455,181,842,1089,340,201,447,943,336,1532,2281,1247,544,0,0,0,0
487,2012,5353,779,1233,403,606,425,578,221,903,768,120,1245,767,272,178,453,1109,263,1090,2027,1375,598,17,0,0,17
488,2832,7934,1757,1075,544,774,513,1001,573,933,1110,216,1628,1204,497,383,301,1651,265,1710,1994,2383,1582,17,0,0,17
489,2085,6229,1781,304,176,704,468,737,284,786,750,265,1214,871,232,175,330,1348,159,1227,1330,2132,1381,0,0,0,0
490,1424,4237,1086,338,191,371,310,552,247,524,496,157,922,502,186,202,233,803,143,881,1080,1368,765,0,0,0,0
491,1041,3255,684,357,98,280,234,429,61,425,498,57,524,517,60,129,153,699,100,784,914,1058,399,0,0,0,0
492,1855,5787,1356,499,169,430,503,753,153,739,790,173,865,990,154,219,258,1224,210,1351,1542,1902,782,0,0,0,0
493,1979,5832,1791,188,256,622,387,714,445,613,676,245,1255,724,255,296,288,1140,141,1182,1186,2000,1323,15,0,0,15
494,2064,6094,1851,213,229,627,465,743,476,781,582,225,1382,682,233,296,483,1052,136,1313,1190,2182,1273,0,0,0,0
495,2062,5954,1825,237,232,759,392,679,357,773,825,107,1287,775,161,321,275,1305,119,1181,1151,2103,1400,0,0,0,0
496,1008,2821,835,173,167,329,197,315,206,315,360,127,788,220,151,59,146,652,89,543,518,897,774,0,0,0,0
497,2489,6842,1938,551,453,853,433,750,656,675,935,223,1562,927,365,209,203,1712,165,1280,1233,2186,1978,0,0,0,0
498,1506,4146,1251,255,278,447,310,471,221,543,627,115,1031,475,171,185,235,915,152,774,1015,1402,803,0,0,0,0
499,2674,7868,1872,802,411,722,599,942,325,1101,1057,191,1353,1321,260,421,506,1487,410,1722,2338,2308,1090,13,0,0,13
500,1396,4163,1061,335,186,407,283,520,178,417,477,324,808,588,90,247,258,801,205,920,1202,1222,614,0,0,0,0
501,1407,4130,1113,294,209,409,278,511,158,580,601,68,814,593,150,194,214,849,212,805,1248,1207,658,0,0,0,0
502,1716,4627,749,967,370,494,377,475,342,512,622,240,1132,584,443,378,336,559,271,792,1707,1197,660,10,0,0,10
503,2937,6669,810,2127,1071,920,400,546,708,1067,979,183,2223,714,993,568,557,819,336,966,2445,1522,1400,0,0,0,0
504,2268,4844,1024,1244,778,844,311,335,262,1066,660,280,1551,717,392,550,528,798,288,573,2184,1284,515,8,0,0,8
505,2135,6080,1168,967,415,667,424,629,299,846,818,172,1180,955,341,533,388,873,318,1182,2052,1762,766,24,0,0,24
506,1488,3983,803,685,344,396,286,462,324,537,544,83,1055,433,306,229,311,642,194,803,1166,1169,651,24,0,0,24
507,1973,5103,1631,342,393,713,346,521,330,954,574,115,1206,767,236,259,425,1053,172,1020,1154,1549,1208,0,0,0,0
508,1181,2949,598,583,320,340,195,326,106,453,571,51,697,484,167,132,234,648,130,670,868,889,392,0,0,0,0
509,1377,3068,495,882,459,449,197,272,130,917,318,12,1037,340,222,271,288,596,126,572,1018,973,379,21,0,0,21
510,981,2821,856,125,117,341,170,353,239,390,322,30,643,338,68,76,135,702,76,574,535,952,684,0,0,0,0
511,3006,7085,1901,1105,877,1015,448,666,645,1435,819,107,2242,764,500,356,509,1641,250,1347,1534,2441,1513,14,0,0,14
512,1619,4268,1299,320,316,600,285,418,155,697,679,88,1111,508,151,256,343,869,191,762,1082,1420,813,22,0,0,22
513,1053,3072,907,146,151,392,188,322,200,486,267,100,728,325,158,79,98,718,74,661,582,1055,700,96,0,0,96
514,2809,7890,2155,654,540,805,488,976,611,967,1038,193,1675,1134,306,362,556,1585,241,1803,1608,2398,1840,0,0,0,0
515,2429,7492,1626,803,302,684,460,983,253,999,892,285,1304,1125,374,593,314,1148,344,1851,2292,2113,892,19,0,0,19
516,1375,4014,1131,244,220,363,265,527,147,412,713,103,751,624,96,220,250,809,193,1024,955,1245,597,0,0,0,0
517,1932,5534,1389,543,325,528,391,688,246,443,1008,235,1033,899,309,214,357,1052,287,1294,1494,1641,818,8,0,0,8
518,2349,6539,1517,832,457,621,442,829,364,946,862,177,1482,867,276,335,386,1352,297,1563,1603,2014,1062,0,0,0,0
519,3250,8757,2127,1123,773,899,582,996,306,1637,1208,99,2188,1062,363,546,760,1581,488,1763,2795,2402,1309,37,0,0,37
520,1423,4495,1096,327,162,365,311,585,117,571,513,222,748,675,222,210,257,734,240,1005,1314,1313,623,27,0,0,27
521,2017,5149,1034,983,565,635,337,480,318,670,816,213,1158,859,508,366,409,734,297,878,1802,1364,808,28,0,0,28
522,2259,6374,1383,876,421,672,433,733,210,639,1110,300,1372,887,441,413,469,936,341,1277,2005,1784,967,63,0,0,63
523,2756,7963,2241,515,468,860,570,858,411,748,1267,330,1479,1277,252,515,593,1396,459,1615,2299,2283,1307,51,0,0,51
524,1947,5439,1681,266,330,632,375,610,308,727,734,178,1222,725,254,251,349,1093,335,1070,1443,1584,1007,16,0,0,16
525,1618,4425,1309,309,299,529,290,500,317,707,500,94,982,636,161,406,380,671,253,850,1153,1314,855,17,0,0,17
526,2443,6670,1927,516,467,792,466,718,240,875,1237,91,1437,1006,281,237,433,1492,430,1290,1908,2005,1037,21,0,0,21
527,2918,7398,2108,810,710,1025,523,660,395,1221,1018,284,2146,772,556,504,327,1531,443,1167,2253,2294,1241,93,0,0,93
528,2645,6459,1260,1385,695,907,432,611,267,1220,878,280,1844,801,360,594,699,992,339,1092,2232,1816,980,27,0,0,27
529,1251,2927,925,326,373,417,168,293,376,514,332,29,893,358,169,202,347,533,156,438,621,850,862,0,0,0,0
530,3352,7291,1229,2123,1128,1238,412,574,394,1732,1005,221,2551,801,573,869,738,1172,369,964,3165,1881,912,2,0,0,2
531,1433,2955,790,643,544,472,201,216,267,727,327,112,1170,263,423,304,276,430,149,303,1097,856,550,45,0,0,45
532,3156,7385,575,2581,1048,1055,507,546,446,1177,1283,250,2474,682,951,885,565,755,392,992,3559,1556,886,95,0,0,95
533,2613,7103,619,1994,618,849,439,707,271,1137,831,374,1936,677,816,780,488,529,396,1229,3145,1582,751,42,0,0,42
534,2032,5106,1202,830,566,669,346,451,367,737,654,274,1660,372,584,291,426,731,257,677,1908,1314,950,37,23,0,14
535,2068,5110,769,1299,668,618,304,478,347,748,722,251,1586,482,494,512,539,523,266,768,2137,1330,609,0,0,0,0
536,1838,5269,397,1441,417,517,303,601,121,677,651,389,1195,643,363,581,372,522,326,1105,2420,1088,330,0,0,0,0
537,3330,7235,695,2635,1115,1251,453,511,233,1980,914,203,2816,514,672,649,856,1153,386,799,4145,1382,523,82,0,0,82
538,1239,3557,413,826,401,390,202,246,113,588,446,92,1020,219,225,396,233,385,180,367,1730,962,318,634,0,0,634
539,399,1302,161,238,120,135,64,80,37,189,143,30,329,70,80,75,89,155,58,137,578,406,123,275,0,0,275
540,2575,5659,781,1794,848,941,397,389,350,1131,835,259,1901,674,552,694,601,728,240,705,2649,1352,713,15,0,0,15
541,2155,5380,1440,715,519,775,389,472,305,1106,562,182,1792,363,256,303,551,1045,260,764,1614,1663,1079,11,0,0,11
542,1010,2515,400,610,278,340,155,237,65,489,394,62,738,272,95,255,267,393,119,371,991,700,334,20,0,0,20
543,1487,5873,563,924,409,486,270,322,199,630,605,53,1254,233,401,321,234,531,248,1455,3214,686,270,2288,2259,0,29
544,2272,5839,686,1586,612,770,369,521,264,991,722,295,1992,280,573,583,565,551,336,822,2855,1253,573,51,51,0,0
545,1383,4138,361,1022,529,418,220,216,201,555,544,83,1140,243,390,262,318,413,166,1039,1895,577,461,1018,954,0,64
546,2100,4814,572,1528,690,748,288,374,111,964,921,104,1629,471,242,605,406,847,214,450,2776,982,392,15,0,0,15
547,2942,8128,980,1962,717,983,481,761,316,973,1339,314,2197,745,690,345,709,1198,434,1211,4187,1645,651,89,0,0,89
548,3383,8916,1278,2105,1044,1049,498,792,505,1574,889,415,2609,774,911,706,859,907,480,1209,3866,2137,1224,68,0,0,68
549,2470,5577,344,2126,1075,653,320,422,585,1208,419,258,2085,385,1173,755,274,268,239,749,2610,1281,698,98,0,0,98
550,1364,4169,532,832,331,388,252,393,98,483,582,201,995,369,352,296,373,343,218,646,1770,1004,531,52,0,0,52
551,1925,6587,554,1371,360,495,362,708,294,751,597,283,1301,624,644,626,389,266,390,1371,2643,1554,629,278,0,0,278
552,1270,4479,470,800,203,298,251,518,148,559,443,120,792,478,441,460,170,199,253,1006,1805,1033,382,0,0,0,0
553,1249,4804,575,674,194,260,255,540,164,513,353,219,811,438,374,300,190,385,276,1006,2032,1071,419,118,0,0,118
554,1179,3808,520,659,310,388,231,250,156,415,505,103,908,271,413,131,227,408,137,427,1767,1014,463,581,254,0,327
555,2776,7312,494,2282,864,791,456,665,198,1330,833,415,2326,450,999,795,502,480,398,1022,4176,1294,422,160,0,0,160
556,639,5056,22,617,232,181,86,140,92,238,203,106,531,108,400,182,46,11,64,3275,1426,211,80,3526,3514,0,12
557,2028,4082,390,1638,952,600,232,244,344,1185,354,145,1940,88,792,366,413,457,155,296,2483,740,408,145,0,0,145
558,2431,4762,523,1908,1135,824,210,262,359,1161,779,132,2254,177,669,295,451,1016,180,380,2690,1024,488,188,0,0,188
559,1703,4949,1027,676,328,501,296,578,153,759,606,185,1175,528,264,424,331,684,277,885,1831,1348,608,7,0,0,7
560,1585,5258,302,1283,361,415,225,584,190,667,408,320,916,669,539,324,314,408,302,1045,2465,1106,340,236,0,0,236
561,1630,4466,409,1221,471,413,269,477,285,722,439,184,1095,535,626,522,302,180,253,797,1891,1102,423,11,0,0,11
562,1350,4676,510,840,256,283,208,603,195,318,540,297,848,502,449,369,247,285,253,1013,1872,1110,428,37,0,0,37
563,4592,13018,1351,3241,1353,1160,662,1417,832,2088,1109,563,3123,1469,2139,1180,849,424,692,2550,4733,3449,1594,616,0,0,616
564,3039,8582,1052,1987,627,842,602,968,220,1480,1037,302,1901,1138,713,674,805,847,480,1706,3469,2056,871,33,0,0,33
565,2224,5900,1109,1115,540,722,393,569,372,932,708,212,1639,585,635,456,573,560,326,840,2413,1494,827,0,0,0,0
566,3553,9187,2626,927,793,1197,730,833,269,1804,1060,420,2483,1070,733,613,668,1539,693,1209,4009,2224,1052,19,0,0,19
567,2295,7824,1098,1197,383,467,442,1003,241,810,723,521,1378,917,731,730,569,265,385,1611,2557,2127,1144,30,0,0,30
568,2312,8642,1214,1098,371,472,408,1061,466,852,677,317,1231,1081,827,604,412,469,480,1745,3269,2221,927,20,0,0,20
569,1067,4494,566,501,83,201,202,581,96,317,346,308,498,569,317,323,244,183,253,985,1688,1155,413,0,0,0,0
570,1129,4471,357,772,177,219,181,552,164,442,244,279,559,570,473,366,186,104,256,999,1708,1098,410,18,0,0,18
571,864,3906,594,270,66,176,129,493,41,255,260,308,509,355,172,154,250,288,189,789,1422,1018,488,0,0,0,0
572,944,4186,573,371,67,147,185,545,91,198,321,334,489,455,151,284,244,265,211,821,1485,1106,563,0,0,0,0
573,1040,4196,792,248,82,245,187,526,171,287,375,207,606,434,196,250,232,362,180,696,1355,1257,708,47,0,0,47
574,1367,4864,806,561,212,297,257,601,118,536,330,383,721,646,411,534,306,116,245,842,1611,1502,664,81,0,0,81
575,1002,4199,770,232,92,219,210,481,129,310,226,337,654,348,204,249,235,314,187,719,1388,1195,710,45,0,0,45
576,1170,4824,872,298,112,248,222,588,165,354,444,207,792,378,192,429,302,247,217,867,1571,1411,758,51,0,0,51
577,1100,4821,772,328,76,195,214,615,46,280,453,321,657,443,127,357,384,232,207,908,1696,1309,701,36,0,0,36
578,2351,8296,678,1673,362,504,459,1026,198,990,762,401,1574,777,598,764,632,357,468,1708,3448,1884,788,6,0,0,6
579,778,2465,211,567,195,228,129,226,247,192,197,142,595,183,372,225,89,92,99,370,813,661,522,166,0,0,166
580,1124,4495,264,860,124,238,193,569,136,279,398,311,505,619,354,377,308,85,242,1204,1656,1022,371,100,0,0,100
581,1195,5055,423,772,119,224,171,681,121,578,243,253,508,687,513,329,143,210,288,1184,1821,1216,546,16,0,0,16
582,1832,6522,946,886,255,429,367,781,196,596,610,430,1148,684,606,425,452,349,290,1214,2110,1782,1126,38,0,0,38
583,1556,6459,945,611,194,322,244,796,193,331,674,358,950,606,525,419,257,355,296,1135,2191,1705,1132,15,0,0,15
584,922,4315,673,249,68,144,184,526,111,157,266,388,474,448,232,219,210,261,203,811,1520,1189,592,8,0,0,8
585,981,4893,624,357,76,144,155,606,130,251,304,296,584,397,249,313,265,154,267,1021,1846,1228,531,3,0,0,3
586,1138,6005,770,368,76,127,175,760,33,283,233,589,597,541,168,253,348,369,316,1287,2249,1458,695,0,0,0,0
587,386,2103,238,148,40,52,54,240,21,64,94,207,154,232,58,102,110,116,108,473,778,504,240,5,0,0,5
588,1256,6283,696,560,65,193,217,781,131,186,441,498,558,698,178,456,304,318,312,1416,2257,1593,705,40,0,0,40
589,1405,6026,635,770,172,266,236,731,115,418,392,480,795,610,404,414,295,292,332,1190,2184,1538,782,22,0,0,22
590,881,4005,383,498,48,137,153,543,79,221,242,339,427,454,272,310,162,137,235,961,1433,987,389,0,0,0,0
591,2183,8637,692,1491,319,372,397,1095,324,542,678,639,1038,1145,777,593,436,377,502,2089,3093,1924,1029,151,0,0,151
592,1317,4829,574,743,212,300,205,600,138,421,367,391,643,674,407,374,287,249,274,1018,1782,1139,616,20,0,0,20
593,892,3053,290,602,132,220,158,382,70,268,312,242,453,439,213,267,180,232,194,600,1176,744,339,8,0,0,8
594,1420,5514,742,678,185,268,252,715,146,352,574,348,840,580,349,436,358,277,288,1158,2010,1462,596,68,0,0,68
595,2490,7182,588,1902,571,617,396,906,515,863,676,436,1675,815,1030,745,502,213,396,1382,2446,1623,1335,0,0,0,0
596,754,2740,411,343,101,180,135,338,87,233,207,227,541,213,219,162,202,171,103,433,940,777,487,24,0,0,24
597,2358,7015,653,1705,480,677,478,723,524,839,788,207,1653,705,1150,420,185,603,365,1221,2793,1572,1064,71,0,0,71
598,2409,8075,1589,820,322,628,481,978,374,687,985,363,1492,917,340,406,471,1192,516,1248,3264,1970,1077,59,0,0,59
599,1413,5000,1011,402,161,322,308,622,139,373,527,374,838,575,150,275,327,661,247,774,1799,1405,775,17,0,0,17
600,1248,4398,909,339,133,355,248,512,135,251,548,314,802,446,101,266,378,503,209,592,1535,1220,842,27,0,0,27
601,2861,8473,1778,1083,430,854,720,857,297,1128,1195,241,2142,719,332,441,773,1315,526,1040,3659,2246,1002,136,0,0,136
602,690,2389,561,129,91,187,158,254,63,241,216,170,376,314,126,277,158,129,93,391,771,808,326,148,0,0,148
603,314,915,217,97,61,96,76,81,29,108,99,78,171,143,49,39,40,186,43,101,366,302,103,67,0,0,67
604,1167,4271,904,263,170,289,242,466,107,405,366,289,637,530,298,211,333,325,209,740,1694,1210,418,258,0,0,258
605,3923,11413,1561,2362,616,1234,924,1149,294,1927,1130,572,2371,1552,476,632,1111,1704,724,1721,5365,2538,1065,47,0,0,47
606,3976,11481,1950,2026,576,1321,981,1098,259,1422,1770,525,2770,1206,321,467,889,2299,997,1404,6520,1794,766,15,0,0,15
607,2237,6569,1085,1152,324,573,603,737,145,928,876,288,1283,954,130,379,781,947,428,975,3357,1332,477,18,0,0,18
608,2147,5712,829,1318,337,745,547,518,168,898,989,92,1434,713,133,256,680,1078,559,745,3421,775,212,45,0,0,45
609,1561,5249,1268,293,157,392,347,665,275,417,595,274,959,602,300,237,328,696,207,909,1623,1532,978,0,0,0,0
610,670,1855,382,288,166,155,124,225,198,153,263,56,450,220,236,63,92,279,105,329,610,448,363,0,0,0,0
611,1711,6092,1087,624,206,397,360,748,174,539,595,403,940,771,258,332,397,724,322,1143,2064,1607,956,34,0,0,34
612,2377,7186,1228,1149,376,562,564,875,181,750,968,478,1395,982,440,326,624,987,465,1335,2834,1699,853,1,0,0,1
613,1027,3753,648,379,140,210,207,470,119,303,412,193,557,470,255,232,222,318,166,683,1234,1028,642,0,0,0,0
614,1354,4900,1067,287,119,321,265,649,142,383,568,261,741,613,229,206,215,704,239,942,1524,1425,770,4,0,0,4
615,1380,4616,983,397,104,380,337,559,202,374,476,328,925,455,270,283,237,590,158,778,1410,1420,850,20,0,0,20
616,1277,4795,689,588,122,248,279,628,67,421,363,426,707,570,156,362,376,383,280,922,1755,1271,567,0,0,0,0
617,1322,4949,650,672,142,276,284,620,148,408,455,311,803,519,286,284,400,352,261,987,1794,1326,581,3,0,0,3
618,758,2703,600,158,68,206,169,315,101,251,233,173,487,271,94,135,160,369,153,443,856,755,496,7,0,0,7
619,1543,5322,1270,273,162,331,366,684,267,415,539,322,946,597,295,234,253,761,291,997,1628,1541,865,16,0,0,16
620,1092,3833,762,330,129,181,251,531,94,369,464,165,563,529,154,149,216,573,228,775,1271,1033,526,11,0,0,11
621,1230,4367,729,501,176,304,270,480,151,350,412,317,953,277,283,137,395,415,226,733,1472,1249,687,29,0,0,29
622,1537,5457,1139,398,173,380,329,655,204,357,393,583,1011,526,262,211,397,667,278,929,1867,1542,841,22,0,0,22
623,2092,7214,1543,549,220,449,466,957,243,450,844,555,1323,769,206,315,624,947,365,1351,2368,2103,1027,12,0,0,12
624,857,2923,703,154,93,217,172,375,129,271,282,175,579,278,126,105,228,398,166,421,940,820,576,39,0,0,39
625,1629,5527,1019,610,219,428,363,619,155,564,562,348,1060,569,240,327,343,719,295,898,2119,1419,796,32,0,0,32
626,1226,4455,918,308,90,262,273,601,207,229,468,322,775,451,154,213,261,598,162,879,1403,1350,661,8,0,0,8
627,1774,5836,1233,541,236,458,376,704,187,777,604,206,1113,661,217,314,532,711,260,1067,1902,1707,900,57,0,0,57
628,1501,4695,1194,307,220,437,291,553,363,407,424,307,967,534,287,172,289,753,174,802,1324,1428,967,16,0,0,16
629,1691,5291,1302,389,281,552,298,560,212,306,750,423,1023,668,152,277,419,843,273,888,1651,1535,944,71,0,0,71
630,2310,8250,1401,909,308,544,399,1059,263,697,856,494,1546,764,413,587,664,646,438,1503,2841,2193,1275,40,0,0,40
631,1368,4709,898,470,139,377,281,571,166,360,504,338,716,652,180,248,363,577,256,828,1607,1273,745,5,0,0,5
632,1778,5814,1171,607,292,454,342,690,339,549,457,433,1271,507,496,382,437,463,298,890,2220,1470,936,50,0,0,50
633,2533,9497,1304,1229,327,521,431,1254,279,708,745,801,1367,1166,555,746,651,581,531,2023,3352,2372,1219,48,0,0,48
634,1567,6142,775,792,223,308,263,773,227,559,328,453,1116,451,556,451,295,265,344,1350,2275,1531,642,37,0,0,37
635,1073,4265,695,378,134,261,188,490,133,249,311,380,729,344,257,255,300,261,257,843,1563,1070,532,9,0,0,9
636,1374,5970,942,432,142,268,245,719,233,345,281,515,757,617,355,340,332,347,316,1234,2146,1601,673,25,0,0,25
637,1590,5186,1368,222,208,546,276,560,191,406,627,366,1060,530,80,306,421,783,228,774,1566,1561,1057,21,0,0,21
638,1316,6258,861,455,78,206,224,808,142,277,393,504,695,621,300,261,454,301,373,1344,2323,1523,695,24,0,0,24
639,1371,6039,808,563,106,221,237,807,114,373,502,382,699,672,288,449,348,286,368,1315,2244,1480,632,22,0,0,22
640,832,3694,615,217,51,141,145,495,96,240,235,261,495,337,124,272,191,245,158,655,1314,1010,557,0,0,0,0
641,880,3975,637,243,66,139,169,506,88,225,180,387,442,438,152,212,243,273,219,783,1462,1041,470,0,0,0,0
642,1037,3533,815,222,151,280,198,408,114,491,319,113,743,294,92,185,266,494,161,571,1176,991,634,0,0,0,0
643,1068,4396,827,241,94,232,208,534,95,355,321,297,668,400,188,306,298,276,211,804,1404,1295,682,54,0,0,54
644,1080,4662,914,166,66,193,205,616,127,344,301,308,750,330,97,207,315,461,211,683,1561,1308,899,40,0,0,40
645,1232,4806,997,235,116,216,254,646,112,421,389,310,769,463,183,264,292,493,216,960,1511,1394,725,43,0,0,43
646,912,3648,745,167,55,200,161,496,98,276,339,199,561,351,115,192,209,396,152,745,1108,1038,605,12,0,0,12
647,1299,4692,1129,170,97,311,284,607,154,253,632,260,629,670,181,133,260,725,135,950,1336,1368,903,0,0,0,0
648,1738,6757,1511,227,71,288,332,1047,256,483,631,368,898,840,186,223,427,902,245,1647,1781,2283,801,0,0,0,0
649,1160,4538,886,274,92,189,257,622,113,341,388,318,664,496,133,186,315,526,172,952,1412,1351,651,35,11,0,24
650,2023,7876,1220,803,176,361,396,1090,154,494,795,580,1167,856,275,357,654,737,343,1516,2845,2183,989,19,0,0,19
651,1808,7291,1391,417,172,306,341,989,160,466,662,520,1067,741,358,369,546,535,313,1316,2472,2127,1063,72,0,0,72
652,1457,5050,1069,388,248,266,249,694,284,449,524,200,839,618,250,298,267,642,231,912,1574,1286,1047,24,0,0,24
653,3126,11497,2751,375,135,489,682,1820,138,1066,1654,268,1423,1703,83,255,356,2432,379,3040,3053,3842,1183,20,0,0,20
654,3983,8881,3486,497,1259,1535,400,789,1612,1048,894,429,3342,641,982,759,832,1410,180,1083,1313,2431,3874,8,0,0,8
655,4017,13741,3542,475,303,970,840,1904,360,1289,1787,581,2272,1745,253,379,728,2657,535,3073,3742,4649,1742,32,0,0,32
656,2070,7052,1738,332,190,519,454,907,112,565,1074,319,1269,801,192,271,524,1083,344,1522,2190,2134,862,33,0,0,33
657,2540,8362,1815,725,355,621,552,1012,231,791,905,613,1408,1132,585,529,746,680,450,1503,3103,2388,918,62,0,0,62
658,1376,4269,1085,291,200,374,289,513,244,239,659,234,817,559,237,142,305,692,251,841,1290,1180,707,0,0,0,0
659,1059,3242,831,228,151,324,192,392,81,434,482,62,621,438,170,168,220,501,172,585,1136,924,425,16,0,0,16
660,1108,3556,897,211,152,335,196,425,222,294,480,112,684,424,235,121,318,434,190,665,1181,991,529,17,0,0,17
661,4585,12607,2023,2562,935,1389,1003,1258,470,2089,1556,470,2794,1791,780,1091,1216,1498,1008,2138,5545,2756,1160,60,0,0,60
662,1403,4536,1118,285,153,395,297,558,190,464,559,190,771,632,74,310,299,720,248,942,1423,1272,651,24,0,0,24
663,982,3158,843,139,101,299,201,381,165,291,405,121,569,413,99,162,226,495,196,614,946,918,484,0,0,0,0
664,2699,7778,1309,1390,508,726,592,873,149,1093,1239,218,1775,924,294,520,836,1049,442,1509,2855,2132,840,39,0,0,39
665,2480,7522,1911,569,458,723,495,804,286,806,935,453,1610,870,310,380,675,1115,485,1251,2629,2110,1047,59,0,0,59
666,1906,5990,1145,761,347,521,356,682,253,663,732,258,1244,662,535,581,520,270,309,1073,2157,1570,881,47,0,0,47
667,1959,5768,966,993,379,482,424,674,166,821,766,206,1162,797,304,738,581,336,359,1200,2395,1339,475,6,0,0,6
668,2083,6408,1680,403,364,610,398,711,182,749,793,359,1237,846,224,382,659,818,307,1047,2230,1885,939,30,0,0,30
669,2511,9178,1079,1432,359,482,491,1179,318,811,919,463,1381,1130,903,761,416,431,586,2114,3216,2297,965,44,0,0,44
670,2201,8005,1381,820,272,554,368,1007,263,659,581,698,1426,775,549,393,581,678,420,1681,2689,2130,1085,29,0,0,29
671,2720,7613,509,2211,592,866,505,757,167,1086,1038,429,1826,894,376,960,689,695,499,1161,3707,1598,648,52,0,0,52
672,1495,4635,894,601,229,452,322,492,249,519,600,127,1087,408,249,350,432,464,253,769,1841,1122,650,47,0,0,47
673,1448,4296,1014,434,247,408,293,500,145,455,624,224,1018,430,254,330,363,501,236,761,1567,1159,573,3,0,0,3
674,1821,5659,1479,342,239,531,359,692,279,562,644,336,1061,760,221,356,401,843,291,1038,1817,1599,914,38,0,0,38
675,1707,5349,1319,388,248,511,367,581,221,434,636,416,1124,583,178,281,433,815,277,933,1742,1512,885,47,0,0,47
676,3105,8477,1667,1438,660,1017,599,829,308,1233,1062,502,2041,1064,404,790,883,1028,447,1425,3050,2281,1274,65,0,0,65
677,1654,4443,646,1008,447,465,266,476,277,518,624,235,1180,474,343,427,357,527,246,752,1724,1020,701,16,0,0,16
678,987,3008,777,210,189,284,158,356,200,244,377,166,665,322,131,142,150,564,151,504,875,831,647,33,0,0,33
679,1671,4792,908,763,309,501,364,497,214,642,688,127,1174,497,319,338,415,599,248,904,1653,1305,682,45,0,0,45
680,2224,6721,1723,501,308,689,484,743,310,653,1033,228,1388,836,299,340,480,1105,370,1207,2090,1903,1151,27,0,0,27
681,1271,3558,873,398,226,429,217,399,244,366,471,190,832,439,126,362,304,479,209,609,1041,986,713,44,0,0,44
682,1808,5322,1489,319,292,550,367,599,246,777,610,175,1209,599,222,242,490,854,318,992,1612,1556,844,20,0,0,20
683,1334,3926,1114,220,195,420,290,429,202,577,447,108,858,476,210,251,247,626,212,782,1149,1137,646,53,0,0,53
684,2412,7089,1700,712,398,653,485,876,326,813,1012,261,1399,1013,576,410,474,952,431,1554,2237,1981,886,13,0,0,13
685,1688,4945,1009,679,301,419,395,573,165,629,704,190,954,734,296,409,369,614,295,1097,1690,1295,568,9,0,0,9
686,2057,5430,1068,989,516,584,392,565,323,786,794,154,1392,665,464,485,577,531,336,1009,1939,1360,786,0,0,0,0
687,1512,3986,679,833,377,453,290,392,216,491,621,184,1059,453,254,371,311,576,227,760,1357,1085,557,2,0,0,2
688,2882,8398,1604,1278,550,717,521,1094,428,1216,984,254,1569,1313,632,526,559,1165,477,1896,2567,2263,1195,49,0,0,49
689,1441,4370,1326,115,172,440,280,549,184,402,601,254,807,634,104,178,153,1006,182,1012,982,1342,852,0,0,0,0
690,2046,5943,1772,274,281,653,422,690,420,498,828,300,1231,815,226,181,324,1315,266,1252,1342,1786,1297,23,0,0,23
691,1091,3250,1009,82,139,358,213,381,206,314,457,114,784,307,111,91,145,744,87,767,615,1121,660,0,0,0,0
692,1141,3490,947,194,148,313,238,442,165,425,450,101,673,468,107,156,130,748,125,870,771,1112,612,0,0,0,0
693,1426,4352,1217,209,184,358,301,583,157,470,660,139,752,674,113,167,182,964,163,1032,980,1423,754,2,0,0,2
694,1767,5455,1557,210,160,532,371,704,182,705,688,192,941,826,192,121,253,1201,139,1308,1125,1904,979,13,0,0,13
695,2746,8545,2476,270,227,834,593,1092,449,1119,996,182,1727,1019,279,232,493,1742,268,1912,1841,2908,1616,0,0,0,0
696,2115,5484,1525,590,470,711,366,568,323,913,699,180,1556,559,328,378,515,894,198,932,1468,1816,1070,35,0,0,35
697,514,1831,312,202,94,121,90,209,51,293,132,38,318,196,107,181,72,154,92,366,553,490,330,31,0,0,31
698,2870,9129,2515,355,336,874,532,1128,343,1204,905,418,1659,1211,175,472,516,1707,491,2025,2391,2816,1406,13,0,0,13
699,1743,5082,1463,280,240,593,375,535,250,475,698,320,1189,554,143,239,466,895,231,978,1339,1573,961,0,0,0,0
700,4577,13233,2974,1603,985,1227,825,1540,571,1842,1668,496,2625,1952,851,1056,1020,1650,768,2794,4224,3634,1813,25,0,0,25
701,2521,6977,1975,546,474,853,431,763,516,1091,749,165,1559,962,387,620,556,958,364,1312,1881,1997,1423,18,0,0,18
702,3495,11180,1808,1687,605,949,624,1317,341,1505,1221,428,2048,1447,652,1077,731,1035,773,2488,3883,2709,1327,354,0,0,354
703,1577,4878,1317,260,177,545,285,570,199,571,495,312,968,609,115,182,365,915,224,902,1289,1553,910,20,0,0,20
704,1681,4885,1411,270,238,651,228,564,253,683,467,278,1125,556,84,287,316,994,204,822,1212,1567,1080,0,0,0,0
705,4581,14544,3236,1345,771,1212,852,1746,670,1515,1760,636,2508,2073,888,987,1081,1625,941,3103,4654,3673,2173,63,0,0,63
706,1108,3601,604,504,226,321,160,401,171,486,262,189,814,294,225,251,259,373,168,726,1117,1043,547,56,0,0,56
707,2674,10343,768,1906,388,496,448,1342,184,1035,791,664,1318,1356,745,899,618,412,781,2676,3859,2134,893,236,0,0,236
708,2649,8337,1439,1210,554,666,456,973,504,959,720,466,1613,1036,746,641,671,591,483,1874,2630,2030,1320,3,0,0,3
709,2143,7687,1075,1068,255,446,413,1029,221,886,708,328,1095,1048,633,468,595,447,537,1988,2762,1771,629,28,0,0,28
710,2273,7795,1246,1027,304,530,422,1017,221,748,936,368,1143,1130,361,692,663,557,432,1870,2667,2026,800,23,0,0,23
711,3004,9958,2627,377,294,874,566,1270,345,1404,814,441,1714,1290,246,418,1189,1151,513,2360,2761,3019,1305,2,0,0,2
712,1435,4900,1032,403,231,473,252,479,268,523,453,191,1018,417,233,275,308,619,220,855,1446,1406,973,184,0,0,184
713,1558,5238,1148,410,222,529,233,574,245,548,614,151,1012,546,269,354,393,542,224,945,1460,1580,1029,47,0,0,47
714,335,940,197,138,61,126,51,97,35,123,119,58,224,111,32,120,72,111,47,150,252,291,200,38,0,0,38
715,2852,8588,2119,733,422,811,589,1030,269,1010,1262,311,1360,1492,291,427,619,1515,492,1831,2755,2560,950,7,0,0,7
716,1876,5021,1270,606,416,647,295,518,293,623,798,162,1311,565,414,273,375,814,237,906,1436,1500,942,40,0,0,40
717,2372,6727,1615,757,496,756,442,678,304,727,1072,269,1479,893,455,330,584,1003,423,1264,2245,1838,957,148,0,0,148
718,2810,8004,2002,808,505,929,540,836,227,998,1110,475,1711,1099,216,545,792,1257,410,1581,2512,2359,1142,127,0,0,127
719,2751,7399,1954,797,612,817,524,798,351,1181,970,249,1814,937,610,719,790,632,488,1317,2627,2149,818,14,0,0,14
720,2129,5917,1784,345,358,708,470,593,197,833,925,174,1545,584,249,269,648,963,454,921,2304,1642,596,6,0,0,6
721,2346,6159,1473,873,518,809,432,587,329,857,874,286,1598,748,503,644,490,709,344,976,2102,1811,926,90,0,0,90
722,2874,8570,1476,1398,605,825,537,907,354,744,1218,558,1834,1040,584,815,737,738,567,1688,3361,2041,913,42,0,0,42
723,1941,5091,1369,572,385,737,307,512,133,790,888,130,1195,746,141,373,390,1037,217,948,1353,1715,858,66,0,0,66
724,2774,6593,1610,1164,920,892,395,567,440,1068,843,423,1943,831,396,597,659,1122,315,1019,1955,1634,1670,159,0,0,159
725,1375,4024,1319,56,120,549,246,460,163,480,484,248,887,488,89,104,264,918,117,846,761,1445,855,30,0,0,30
726,3019,8674,2358,661,443,969,562,1045,349,1099,1173,398,2042,977,452,522,743,1302,488,1799,2493,2455,1439,10,0,0,10
727,1120,3327,878,242,202,283,229,406,134,337,526,123,730,390,114,155,318,533,192,752,1087,857,439,17,0,0,17
728,2452,6887,1969,483,408,856,480,708,324,661,1177,290,1657,795,330,691,562,869,358,1232,2190,2084,1023,37,0,0,37
729,9008,29557,7033,1975,951,1637,2037,4383,422,3260,4395,931,3726,5282,617,673,1552,6166,2250,7871,10650,6691,2095,0,0,0,0
730,4522,12403,1733,2789,938,1317,943,1324,242,1869,2027,384,2315,2207,562,701,1122,2137,757,1990,6429,2736,491,246,0,213,33
731,2790,6569,834,1956,802,941,500,547,292,1555,847,96,1954,836,512,866,747,665,420,1146,3011,1442,550,0,0,0,0
732,1954,5720,1225,729,324,566,391,673,185,732,925,112,1246,708,170,559,585,640,357,1158,2148,1435,622,37,0,0,37
733,2793,7757,1549,1244,560,882,544,807,281,1182,1103,227,1791,1002,399,635,568,1191,505,1431,3112,1822,887,47,0,0,47
734,3163,9165,2649,514,495,940,628,1100,387,1023,1315,438,1980,1183,216,506,674,1767,544,1800,2707,2758,1356,15,0,0,15
735,1308,3559,1095,213,226,410,251,421,175,583,486,64,846,462,121,167,214,806,130,626,871,1229,703,0,0,0,0
736,3229,9168,2328,901,515,1008,662,1044,347,1172,1386,324,2022,1207,279,563,809,1578,366,1966,2612,2795,1429,115,0,0,115
737,1570,4991,1338,232,176,395,312,687,121,415,907,127,812,758,191,236,253,890,271,1256,1395,1366,703,21,0,0,21
738,2103,6132,1798,305,271,687,433,712,250,640,1077,136,1188,915,191,269,375,1268,190,1403,1466,2022,1051,13,0,0,13
739,2538,6415,799,1739,828,744,385,581,376,947,1006,209,1825,713,763,541,366,868,295,1242,2262,1789,827,362,0,0,362
740,1407,3983,1110,297,253,401,260,493,189,628,478,112,706,701,103,207,367,730,181,927,1032,1166,677,7,0,0,7
741,1707,5007,1297,410,217,552,343,595,255,562,677,213,1037,670,168,229,497,813,172,1179,1248,1586,822,23,0,0,23
742,5650,15098,2240,3410,1284,1569,1150,1647,662,2498,1989,501,3333,2317,772,978,1382,2518,958,3176,5824,3045,2095,74,0,0,74
743,3465,9781,2474,991,654,906,668,1237,540,1146,1544,235,2052,1413,571,433,634,1827,373,2328,2493,3091,1496,32,0,0,32
744,1943,5216,1041,902,420,612,355,556,248,717,825,153,1271,672,450,265,358,870,263,1104,1506,1411,932,10,0,0,10
745,2196,5546,1539,657,513,723,398,562,334,930,798,134,1489,707,360,369,466,1001,227,1136,1452,1701,1030,0,0,0,0
746,2711,8387,2379,332,249,887,498,1077,236,1194,1006,275,1624,1087,176,337,393,1805,245,1911,1837,3046,1348,52,0,0,52
747,1180,3615,1125,55,84,427,253,416,198,331,559,92,757,423,137,114,128,801,80,594,823,1289,829,0,0,0,0
748,1222,4207,1037,185,93,239,264,626,160,365,605,92,542,680,125,91,224,782,151,1064,1176,1258,558,14,0,0,14
749,2162,6820,1297,865,265,412,522,963,257,925,866,114,989,1173,224,420,511,1007,425,1709,2400,1616,670,0,0,0,0
750,705,2261,480,225,74,133,178,320,66,236,357,46,238,467,123,58,157,367,139,649,787,477,209,19,0,0,19
751,13,44,10,3,1,2,4,6,1,4,7,1,4,9,1,1,3,8,3,13,16,10,2,0,0,0,0
752,558,1693,278,280,89,143,146,180,48,320,175,15,283,275,46,83,124,305,176,272,870,294,81,169,0,0,169
753,1499,5029,1330,169,110,346,337,706,221,571,594,113,834,665,104,143,299,953,131,1198,1291,1532,877,12,0,0,12
754,1232,4054,1109,123,65,370,278,519,207,449,328,248,881,351,101,83,238,810,78,730,978,1436,832,77,0,0,77
755,3405,10943,2562,843,287,760,802,1556,408,1157,1479,361,1992,1413,379,442,585,1999,352,2582,2943,3551,1515,1,0,0,1
756,2197,7404,1790,407,187,473,459,1078,186,598,1186,227,1075,1122,191,208,410,1388,253,1773,1939,2417,1022,24,0,0,24
757,811,2939,600,211,81,177,158,395,60,345,331,75,400,411,159,126,244,282,154,613,982,809,381,31,0,0,31
758,1957,6767,1435,522,183,455,423,896,200,815,640,302,1024,933,393,434,340,790,361,1471,2179,1919,837,20,0,0,20
759,2394,7795,1607,787,290,627,581,896,169,923,1023,279,1140,1254,160,321,809,1104,563,1379,2983,1886,984,27,0,0,27
760,1978,6445,1295,683,237,573,439,729,250,704,695,329,1232,746,333,417,534,694,378,1087,2480,1706,794,22,0,0,22
761,3845,11664,1484,2361,712,951,809,1373,520,1357,1625,343,2013,1832,784,686,930,1445,664,2416,4444,2897,1243,194,0,0,194
762,1262,3763,424,838,240,373,282,367,93,473,451,245,856,406,52,243,415,552,277,484,1778,834,390,19,0,0,19
763,2989,8155,656,2333,655,745,707,882,510,1389,838,252,1903,1086,549,776,855,809,741,1296,3872,1361,885,36,0,0,36
764,2249,7534,1294,955,258,604,492,895,218,850,632,549,1505,744,246,792,509,702,463,1265,2784,1909,1113,37,0,0,37
765,957,3011,709,248,138,250,233,336,95,267,425,170,521,436,89,157,281,430,177,487,1068,777,502,34,0,0,34
766,1071,3196,795,276,158,277,270,366,160,384,449,78,647,424,110,99,323,539,202,589,1050,874,481,22,0,0,22
767,3710,11051,2930,780,513,1106,828,1263,368,1041,1698,603,2322,1388,325,599,823,1963,822,1624,4498,2694,1413,14,0,0,14
768,3438,11014,2253,1185,427,961,714,1336,343,904,1664,527,2141,1297,392,514,762,1770,814,1796,4619,2551,1234,75,0,0,75
769,4315,13693,2625,1690,462,812,1116,1925,379,1504,2150,282,1714,2601,198,369,966,2782,1047,3253,5396,3068,929,70,0,0,70
770,1966,6568,1428,538,260,488,414,804,138,693,732,403,1383,583,253,388,498,827,351,1093,2344,1858,922,11,0,0,11
771,2612,7838,2045,567,423,835,502,852,469,861,933,349,1877,735,545,366,735,966,502,1140,2511,2069,1616,21,0,0,21
772,1492,5344,826,666,216,354,281,641,196,352,604,340,817,675,248,479,490,275,338,911,2196,1319,580,139,0,0,139
773,1992,6557,884,1108,306,476,417,793,241,655,774,322,1150,842,258,430,603,701,409,1242,2628,1603,675,33,0,0,33
774,3153,9945,1443,1710,660,831,668,994,394,1502,1151,106,2186,967,722,847,648,936,629,1733,4021,2463,1099,885,0,0,885
775,3025,9342,1788,1237,400,834,648,1143,469,1329,914,313,1943,1082,632,557,663,1173,595,1815,3293,2450,1189,37,0,0,37
776,2421,7392,1422,999,372,608,531,910,359,1039,854,169,1469,952,448,397,604,972,474,1529,2791,1701,897,42,0,0,42
777,2437,6205,206,2231,616,675,585,561,382,1216,806,33,1486,951,404,561,763,709,580,907,3141,872,705,0,0,0,0
778,5648,14714,2063,3585,1021,1906,1366,1355,693,2649,1958,348,3845,1803,938,905,1534,2271,1281,2061,7482,2606,1284,26,0,0,26
779,1684,5352,1372,312,182,389,364,749,164,440,890,190,971,713,115,186,324,1059,136,1271,1364,1704,877,0,0,0,0
780,1061,3298,960,101,84,312,244,421,216,310,420,115,690,371,175,100,214,572,81,623,819,1165,610,19,0,0,19
781,1611,4514,1203,408,335,512,285,479,393,543,512,163,1195,416,397,223,310,681,198,734,1251,1298,1033,11,0,0,11
782,2570,7332,1625,945,470,790,510,800,305,1133,990,142,1476,1094,252,617,688,1013,394,1395,2559,1958,1026,51,0,0,51
783,1071,2972,513,558,154,364,231,322,108,433,473,57,738,333,140,152,305,474,169,555,1180,674,394,0,0,0,0
784,1875,5801,1279,596,255,494,392,734,332,495,861,187,1071,804,239,248,301,1087,312,1150,1946,1450,943,11,0,0,11
785,2287,7365,1249,1038,338,583,520,846,294,717,1022,254,1303,984,535,515,464,773,457,1492,2771,1754,891,93,0,0,93
786,1443,4697,1106,337,177,408,280,578,210,618,416,199,980,463,188,193,360,702,252,889,1530,1325,701,21,0,0,21
787,2393,7447,1504,889,306,594,546,947,347,969,836,241,1157,1236,334,240,642,1177,477,1501,2649,1807,1013,18,0,0,18
788,1842,6001,1439,403,239,422,392,789,237,597,693,315,1006,836,269,241,285,1047,250,1259,1846,1609,1037,18,0,0,18
789,1418,4803,1089,329,149,309,315,645,217,360,655,186,675,743,193,236,324,665,266,961,1634,1204,738,8,0,0,8
790,1947,6577,1617,330,178,468,415,886,270,696,749,232,1302,645,231,257,449,1010,291,1093,2080,1874,1239,34,0,0,34
791,1046,4041,677,369,69,215,226,536,152,281,336,277,690,356,103,423,213,307,205,784,1394,1113,545,21,0,0,21
792,886,3237,719,167,93,195,164,434,110,341,292,143,501,385,110,158,241,377,165,507,1063,809,693,61,0,0,61
793,1411,4981,908,503,137,335,313,626,263,243,592,313,933,478,215,361,334,501,273,907,1693,1261,847,20,0,0,20
794,878,3087,771,107,47,222,188,421,88,206,440,144,520,358,77,139,200,462,143,494,1056,966,428,0,0,0,0
795,902,3203,414,488,103,175,185,439,79,252,282,289,545,357,93,271,301,237,163,654,1152,846,388,21,0,0,21
796,1977,7141,1571,406,197,504,438,838,348,548,691,390,1238,739,290,446,593,648,386,1061,2332,1981,1381,82,0,0,82
797,2239,7311,1601,638,300,602,455,882,327,934,670,308,1394,845,487,525,368,859,358,1294,2493,2070,1096,35,0,0,35
798,1691,4537,1249,442,338,608,300,445,375,659,481,176,1296,395,430,417,288,556,168,577,1406,1223,1163,17,0,0,17
799,1739,5386,1261,478,193,458,427,661,324,576,680,159,1067,672,136,302,380,921,294,1020,1721,1462,889,14,0,0,14
800,1873,5840,982,891,381,571,311,610,460,632,424,357,1406,467,533,419,439,482,314,799,2074,1369,1284,186,0,0,186
801,4041,11824,1947,2094,689,1327,784,1241,376,1661,1593,411,2789,1252,461,671,1096,1813,640,1727,5192,2864,1401,120,0,0,120
802,1502,5905,788,714,144,297,296,765,163,529,446,364,826,676,226,442,505,329,338,1254,2227,1440,646,22,0,0,22
803,1102,2628,426,676,376,342,131,253,459,331,238,74,837,265,274,257,259,312,147,346,813,491,831,0,0,0,0
804,1158,3657,779,379,196,304,201,457,186,386,366,220,759,399,150,399,296,313,191,630,1289,989,558,32,0,0,32
805,2145,7756,1569,576,268,497,397,983,235,501,823,586,1230,915,230,442,645,828,425,1453,2786,2101,991,13,0,0,13
806,3209,10318,2469,740,562,867,623,1157,630,1004,1019,556,2414,795,699,941,758,811,460,1436,3253,2999,2170,169,0,0,169
807,1261,4835,1012,249,153,268,230,610,223,306,461,271,695,566,303,345,359,254,233,948,1660,1300,694,13,0,0,13
808,928,3933,693,235,85,183,179,481,94,209,333,292,469,459,124,249,311,244,218,711,1391,1048,565,26,0,0,26
809,747,2503,617,130,80,169,125,373,131,172,295,149,519,228,110,296,240,101,135,353,855,692,468,18,0,0,18
810,3660,12275,2523,1137,580,856,673,1551,507,1183,1065,905,2569,1091,903,993,627,1137,701,2015,4491,3231,1837,52,0,0,52
811,2930,8662,1755,1175,579,901,565,885,486,938,1031,475,1977,953,663,861,704,702,543,1165,3320,2123,1511,76,0,0,76
812,1266,3789,915,351,283,335,188,460,247,443,420,156,919,347,302,297,354,313,142,619,1308,1106,614,47,0,0,47
813,962,3415,516,446,124,213,178,447,135,410,205,212,659,303,421,205,185,151,192,686,1225,878,434,41,0,0,41
814,951,3570,772,179,125,202,191,433,197,270,234,250,616,335,188,334,234,195,185,686,1268,927,504,17,0,0,17
815,1215,4805,314,901,100,192,237,686,228,552,278,157,630,585,447,310,287,171,300,1278,1832,1008,387,23,0,0,23
816,953,3326,543,410,163,192,180,418,183,270,272,228,598,355,200,276,294,183,171,588,1133,842,592,23,0,0,23
817,2194,8542,265,1929,212,407,386,1189,253,737,629,575,1058,1136,636,886,472,200,633,2254,3531,1623,501,80,0,0,80
818,1405,4865,988,417,185,326,263,631,225,294,330,556,969,436,200,355,344,506,269,857,1801,1261,677,0,0,0,0
819,717,2469,303,414,112,182,115,308,138,288,170,121,423,294,240,202,155,120,148,438,1049,604,230,18,0,0,18
820,5164,15050,3043,2121,876,1673,967,1648,690,1604,2272,598,3406,1758,714,964,1238,2248,838,2628,5616,4123,1845,68,0,0,68
821,1455,5091,1073,382,312,518,249,376,223,458,604,170,1058,397,196,298,485,476,164,1216,1909,1063,739,1131,1104,0,27
822,1391,4047,1158,233,242,523,251,375,273,565,374,179,1006,385,53,263,523,552,180,525,1217,1174,951,208,178,0,30
823,2882,7762,1585,1297,708,913,520,741,410,1058,1101,313,2208,674,747,482,844,809,479,1185,2984,1940,1174,65,0,0,65
824,1946,5728,610,1336,409,630,323,584,181,889,679,197,1256,690,519,700,440,287,369,963,2902,1086,408,171,152,0,19
825,1912,6812,685,1227,281,412,397,822,325,578,686,323,1231,681,622,592,393,305,429,1498,2740,1489,656,32,0,0,32
826,1864,5497,509,1355,426,485,340,613,262,659,724,219,1038,826,529,577,547,211,369,1082,2307,1215,524,39,0,0,39
827,1384,4388,649,735,251,351,315,467,152,577,243,412,850,534,227,463,353,341,270,802,1796,1034,486,8,0,0,8
828,3136,9846,1314,1822,536,886,619,1095,386,1301,1150,299,1994,1142,587,929,711,909,648,1812,4316,2139,931,32,0,0,32
829,1137,3783,655,482,201,283,202,451,173,508,308,148,663,474,333,274,316,214,225,727,1486,909,436,20,0,0,20
830,1961,7224,813,1148,278,372,325,986,232,725,608,396,1049,912,719,392,516,334,454,1662,2726,1700,682,0,0,0,0
831,1299,4150,193,1106,314,263,228,494,215,472,330,282,841,458,424,471,254,150,249,934,1456,999,512,92,0,0,92
832,1820,5872,1065,755,329,462,344,685,327,478,487,528,1157,663,525,452,311,532,305,1007,1982,1634,944,0,0,0,0
833,1571,5138,1266,305,236,426,301,608,209,394,709,259,1033,538,342,392,459,378,286,869,1774,1411,798,21,0,0,21
834,1700,5526,1337,363,275,466,342,617,282,417,551,450,1118,582,289,444,527,440,260,952,1785,1606,923,28,0,0,28
835,1765,5836,1255,510,292,470,338,665,209,631,596,329,1036,729,432,484,508,341,267,1108,1968,1585,908,21,0,0,21
836,1503,4990,975,528,252,397,222,632,251,531,600,121,1104,399,258,563,393,289,303,980,1783,1314,610,24,0,0,24
837,3381,11072,973,2408,690,842,563,1286,523,1203,1258,397,2110,1271,909,1409,727,336,686,2267,4236,2649,1234,171,0,0,171
838,1488,4176,467,1021,437,369,257,425,265,610,397,216,1074,414,555,423,304,206,224,727,1523,1055,647,51,0,0,51
839,1985,4902,585,1400,731,528,277,449,429,638,713,205,1442,543,655,573,405,352,283,797,1993,1118,711,124,0,0,124
840,2621,6034,1421,1200,877,807,429,508,566,1121,776,158,2005,616,537,859,736,489,315,732,2139,1607,1241,33,0,0,33
841,1750,5000,722,1028,399,497,301,553,144,762,683,161,1302,448,484,529,452,285,297,851,1921,1219,712,0,0,0,0
842,1368,3563,453,915,326,445,217,380,130,440,658,140,1007,361,347,447,416,158,229,572,1488,883,391,20,0,0,20
843,1467,4527,1130,337,249,428,306,484,250,558,472,187,1009,458,187,352,525,403,254,676,1568,1256,773,34,0,0,34
844,3295,9569,2865,430,472,1080,653,1090,512,1064,1185,534,2255,1040,427,366,705,1797,432,1760,2502,2985,1890,24,3,0,21
845,2539,7549,2217,322,371,822,500,846,413,654,1144,328,1345,1194,299,449,569,1222,380,1416,2027,2139,1587,3,0,0,3
846,2236,6294,1439,797,496,639,408,693,430,751,628,427,1531,705,693,573,490,480,313,1247,2088,1711,935,14,0,0,14
847,1222,3103,385,837,342,357,230,293,211,467,423,121,837,385,297,438,271,216,163,563,1141,794,442,0,0,0,0
848,1887,5157,407,1480,425,542,354,566,229,724,771,163,1081,806,549,447,507,384,353,1038,1989,1200,577,49,0,0,49
849,1417,4283,1101,316,224,421,265,507,196,509,600,112,819,598,376,293,323,425,227,895,1295,1167,699,17,0,0,17
850,1351,4009,1170,181,197,437,270,447,184,362,566,239,805,546,136,171,392,652,217,746,1134,1108,804,0,0,0,0
851,754,2221,684,70,91,261,149,253,86,218,397,53,509,245,41,89,194,430,123,433,598,597,470,0,0,0,0
852,2184,6485,1760,424,383,650,408,743,312,587,1039,246,1474,710,417,509,412,846,320,1232,1928,1777,1228,17,0,0,17
853,2206,6189,1232,974,464,783,417,542,333,729,857,287,1596,610,619,607,566,414,347,1016,2378,1593,855,18,0,0,18
854,2368,6981,423,1945,491,658,425,794,339,919,1048,62,1226,1142,1010,722,504,132,491,1575,2830,1554,531,24,0,0,24
855,1827,5549,581,1246,416,468,350,593,271,817,456,283,1206,621,983,322,228,294,360,1181,2088,1294,626,66,0,0,66
856,2524,7863,1125,1399,530,604,500,890,232,870,1021,401,1661,863,757,651,699,417,439,1366,3004,2093,961,50,0,0,50
857,1115,3692,450,665,213,259,192,451,121,455,362,177,665,450,355,347,236,177,237,726,1453,928,348,27,0,0,27
858,2164,6418,1231,933,423,561,419,761,501,809,594,260,1513,651,641,706,488,329,258,1133,2103,1848,1076,34,0,0,34
859,1401,4559,1046,355,238,361,243,559,325,386,354,336,1102,299,592,233,278,298,199,766,1400,1356,838,10,0,0,10
860,2323,6635,1855,468,503,704,401,715,368,652,1051,252,1739,584,438,629,519,737,295,955,1887,2099,1399,23,0,0,23
861,2291,7692,1727,564,308,620,448,915,277,599,811,604,1567,724,474,723,729,365,343,1263,2423,2241,1422,31,0,0,31
862,2876,7716,1142,1734,813,767,583,713,479,1090,646,661,2127,749,1070,903,485,418,504,1263,2846,1854,1249,21,0,0,21
863,1331,4038,778,553,232,384,236,479,112,528,401,290,850,481,276,336,346,373,231,644,1388,1106,669,26,0,0,26
864,3431,8171,860,2571,1201,1061,476,693,599,1480,968,384,2636,795,1291,1148,599,393,414,1391,3282,2091,993,18,0,0,18
865,1474,4272,1099,375,332,421,276,445,224,585,452,213,1040,434,411,424,368,271,212,623,1415,1277,745,23,0,0,23
866,1483,4038,1148,335,341,517,239,386,366,469,388,260,1129,354,344,269,418,452,197,557,1196,1178,910,26,0,0,26
867,1104,2832,783,321,267,368,170,299,158,477,287,182,771,333,278,329,150,347,149,467,854,819,543,1,0,0,1
868,1397,3960,1016,381,326,449,250,372,118,523,509,247,985,412,212,194,303,688,212,649,1282,1178,639,201,0,0,201
869,1665,4106,745,920,548,497,255,365,306,718,478,163,1258,407,526,407,344,388,199,622,1364,1038,883,58,0,0,58
870,1662,4852,1033,629,346,455,330,531,198,526,700,238,1247,415,402,205,396,659,249,855,1722,1377,649,41,0,0,41
871,3179,7489,912,2267,1122,921,451,685,406,1413,1079,281,2441,738,930,914,821,514,359,1028,2781,1905,1416,78,0,0,78
872,2987,9974,1592,1395,517,740,578,1152,228,970,949,840,2008,979,834,690,775,688,507,1775,3618,2718,1356,22,0,0,22
873,1945,6480,878,1067,341,483,387,734,274,574,699,398,1068,877,572,565,500,308,357,1204,2286,1769,864,25,0,0,25
874,0,0,0,0,0,0,0,0,0,0,0,0,0,0,0,0,0,0,0,0,0,0,0,0,0,0,0
875,1119,5079,589,530,167,240,173,539,102,442,332,243,534,585,396,388,199,136,284,1052,1791,1424,528,762,0,0,762
876,628,2401,365,263,76,135,114,303,81,227,157,163,419,209,211,234,115,68,175,593,918,521,194,0,0,0,0
877,957,3821,508,449,122,178,149,508,136,388,273,160,581,376,293,426,188,50,266,908,1482,866,299,66,0,0,66
878,1604,5796,700,904,281,326,258,739,337,545,387,335,789,815,711,621,186,86,417,1384,2095,1331,569,93,0,0,93
879,1277,3980,757,520,288,345,219,425,122,529,305,321,861,416,419,304,381,173,221,799,1500,981,479,13,0,0,13
880,1180,4527,456,724,164,208,217,591,141,401,391,247,535,645,570,330,221,59,269,1209,1820,902,327,14,0,0,14
881,1143,3516,511,632,231,302,216,394,140,460,397,146,740,403,389,403,209,142,237,742,1330,794,413,30,0,0,30
882,1208,3385,660,548,347,310,225,326,175,502,460,71,718,490,382,333,298,195,221,623,1254,821,466,6,0,0,6
883,1242,3271,1067,175,233,479,219,311,295,296,570,81,980,262,239,236,247,520,161,503,924,954,729,11,0,0,11
884,1424,3581,1250,174,329,526,245,324,217,443,705,59,1013,411,200,275,367,582,178,497,941,1027,938,22,0,0,22
885,2819,6762,2263,556,696,1123,446,554,453,1017,1250,99,2032,787,374,523,613,1309,311,906,2056,1955,1534,0,0,0,0
886,1778,4823,1165,613,480,556,308,434,255,740,606,177,1461,317,479,348,438,513,297,814,1789,1249,674,33,0,0,33
887,1253,3325,796,457,356,379,201,317,178,601,318,156,828,425,288,340,283,342,188,564,1136,839,598,64,0,0,64
888,1681,5620,535,1146,322,401,320,638,379,663,465,174,1019,662,1000,457,164,60,376,1410,2131,1236,467,41,0,0,41
889,1221,3972,465,756,242,310,216,453,149,465,434,173,842,379,479,401,187,154,251,879,1602,874,366,16,0,0,16
890,1729,6096,699,1030,308,382,310,729,286,648,469,326,1084,645,754,463,316,196,406,1495,2334,1314,547,20,0,0,20
891,1505,5705,547,958,255,291,256,703,305,609,425,166,1112,393,760,412,126,207,386,1449,2214,1232,424,15,0,0,15
892,1256,5173,532,724,142,207,253,654,185,446,336,289,788,468,575,350,230,101,321,1386,2046,1112,308,104,0,0,104
893,998,4114,316,682,155,165,154,524,111,519,234,134,450,548,501,310,127,60,273,1102,1569,895,275,179,0,0,179
894,1153,4286,323,830,277,199,172,505,239,472,256,186,682,471,628,287,168,70,282,1037,1664,915,388,246,0,0,246
895,2248,7599,517,1731,546,513,368,821,378,979,509,382,1225,1023,1275,648,281,44,487,1941,2907,1498,766,223,0,0,223
896,793,3938,230,563,155,192,115,331,85,372,149,187,472,321,304,225,206,58,190,843,1739,908,258,1064,0,0,1064
897,1251,4551,364,887,270,249,232,500,283,405,307,256,739,512,607,357,238,49,315,1083,1873,915,365,75,0,0,75
898,1346,4420,321,1025,355,262,245,484,263,625,411,47,770,576,725,388,154,79,309,1077,1760,887,387,42,0,0,42
899,2504,7957,1024,1480,566,578,406,954,576,1221,294,413,1711,793,1348,624,280,252,480,1778,3141,1737,821,37,0,0,37
900,1847,6222,762,1085,425,444,293,685,242,659,578,368,1212,635,752,487,497,111,381,1386,2362,1442,651,161,0,0,161
901,1760,4496,832,928,515,553,278,414,295,718,580,167,1252,508,629,442,249,440,268,858,1700,1100,570,0,0,0,0
902,802,2469,522,280,184,296,128,194,116,292,366,28,561,241,240,149,178,235,147,423,1032,539,328,315,280,0,35
903,1813,4543,1379,434,475,612,346,380,276,710,727,100,1235,578,287,583,378,565,278,626,1498,1314,827,9,0,0,9
904,2220,6515,1078,1142,585,621,363,651,156,996,701,367,1400,820,673,671,496,380,373,1328,2534,1514,766,54,0,0,54
905,2508,8173,1044,1464,557,620,418,913,356,916,1010,226,1521,987,1149,621,350,388,482,1644,3187,1887,973,22,0,0,22
906,2163,6124,858,1305,575,629,378,581,253,741,971,198,1354,809,574,650,576,363,353,1119,2386,1519,747,28,0,0,28
907,1199,3142,854,345,244,420,257,278,101,612,451,35,714,485,172,304,295,428,192,489,1083,847,531,20,0,0,20
908,1456,3665,794,662,357,462,305,332,196,452,773,35,1168,288,259,303,469,425,198,625,1246,993,603,16,0,0,16
909,1528,3868,1038,490,362,500,307,359,197,545,733,53,1072,456,174,401,388,565,193,574,1284,1120,697,37,0,0,37
910,2320,5665,1569,751,729,777,381,433,278,769,945,328,1745,575,358,535,525,902,346,723,1876,1612,1108,241,0,0,241
911,1006,2523,847,159,230,400,167,209,216,320,349,121,804,202,121,194,171,520,101,335,661,743,683,106,106,0,0
912,1864,4614,1683,181,363,747,357,397,399,650,715,100,1314,550,191,231,339,1103,239,646,1112,1469,1148,1,1,0,0
913,2541,6334,2142,399,543,931,497,570,416,864,1095,166,1824,717,233,295,464,1549,389,954,1758,1921,1312,30,0,0,30
914,2420,5810,1992,428,630,911,417,462,403,1059,825,133,1814,606,444,316,392,1268,322,880,1656,1776,1176,0,0,0,0
915,1524,3770,1162,362,389,514,268,353,275,478,698,73,1023,501,149,234,253,888,222,614,1039,1039,856,7,2,0,5
916,1640,4146,1238,402,399,578,310,353,283,590,670,97,1130,510,121,242,349,928,222,707,1149,1207,861,118,106,0,12
917,2269,5917,1577,692,508,671,361,729,363,813,991,102,1437,832,328,335,345,1261,243,1298,1497,1721,1158,1,0,0,1
918,2071,6191,1880,191,257,645,346,823,281,728,927,135,1201,870,58,175,242,1596,272,1544,1119,1853,1403,9,0,0,9
919,724,1869,625,99,157,264,107,196,88,277,305,54,469,255,31,77,154,462,89,352,398,563,467,0,0,0,0
920,812,2035,705,107,139,321,151,201,124,266,338,84,599,213,70,95,122,525,104,316,517,649,449,0,0,0,0
921,1261,2805,596,665,442,378,199,242,280,546,375,60,976,285,348,289,210,414,158,432,978,716,521,0,0,0,0
922,2032,4458,1097,935,739,654,293,346,240,607,1113,72,1535,497,446,276,537,773,254,613,1389,1257,945,0,0,0,0
923,2737,7518,1017,1720,736,785,481,735,453,1206,876,202,2075,662,1082,809,404,442,432,1329,2973,1869,915,68,0,0,68
924,1988,6293,623,1365,419,523,352,694,173,726,747,342,1176,812,796,492,463,237,372,1296,2489,1404,732,47,0,0,47
925,1960,6833,474,1486,418,402,323,817,212,679,739,330,1160,800,844,686,282,148,466,1525,2773,1355,714,43,0,0,43
926,1906,5943,508,1398,622,531,287,466,337,751,633,185,1457,449,788,575,190,353,250,934,2537,1603,619,842,0,0,842
927,1390,4664,180,1210,288,292,211,599,253,508,307,322,890,500,691,438,143,118,260,1175,1879,879,471,0,0,0,0
928,1476,4931,323,1153,373,315,244,544,171,631,418,256,840,636,745,498,139,94,328,1030,2115,1038,420,40,0,0,40
929,1286,4021,471,815,326,330,200,430,161,480,406,239,769,517,573,320,194,199,183,854,1538,929,517,38,0,0,38
930,722,1937,361,361,205,213,122,182,126,336,167,93,424,298,295,188,111,128,80,253,632,413,559,57,0,0,57
931,1379,3429,394,985,470,388,198,323,104,692,477,106,1145,234,349,600,280,150,166,538,1442,849,434,9,0,0,9
932,1378,4433,514,864,270,344,277,487,171,644,353,210,855,523,555,459,209,155,267,873,1740,1021,532,0,0,0,0
933,2217,7725,566,1651,393,545,482,797,294,839,577,507,1308,909,1007,598,382,230,402,1593,3039,1778,913,221,0,0,221
934,3383,8139,390,2993,1175,1034,468,706,533,1416,1128,306,2763,620,1443,914,590,436,384,1119,3866,1766,1004,25,0,0,25
935,1616,3893,361,1255,542,522,230,322,250,721,538,107,1353,263,598,411,302,305,172,475,1866,915,465,85,0,0,85
936,1450,3262,352,1098,559,410,200,281,132,785,348,185,1230,220,547,394,218,291,154,421,1499,767,421,0,0,0,0
937,1551,3474,965,586,497,510,254,290,174,527,791,59,1087,464,299,184,386,682,240,474,1111,963,686,8,0,0,8
938,1615,4440,1471,144,266,574,318,457,196,488,828,103,1012,603,134,137,226,1118,294,827,1089,1214,1016,10,0,0,10
939,1970,3872,693,1277,785,750,216,219,158,1064,713,35,1597,373,327,327,483,833,187,352,1750,969,614,12,0,0,12
940,2446,4353,775,1671,1194,836,218,198,447,1097,881,21,2110,336,562,615,536,733,166,299,2226,982,680,21,0,0,21
941,2902,5156,529,2373,1438,1008,248,208,449,1366,1051,36,2426,476,565,1048,707,582,217,332,2892,1100,615,35,0,0,35
942,2863,4749,433,2430,1524,980,215,144,472,1305,1050,36,2524,339,636,910,745,572,159,214,2640,893,843,68,0,0,68
943,2610,5153,691,1919,1145,871,295,299,270,1296,932,112,2203,407,656,582,745,627,228,420,2545,1193,767,11,0,0,11
944,2584,4625,181,2403,1285,867,236,196,363,1246,821,154,2379,205,907,589,420,668,161,300,2335,968,861,50,0,0,50
945,3765,6228,396,3369,2218,1124,236,187,837,2202,694,32,3545,220,1667,895,567,636,190,323,2992,1216,1507,293,0,0,293
946,2519,5220,496,2023,1041,979,260,239,365,1009,891,254,2170,349,833,294,666,726,166,335,2708,1256,755,325,0,0,325
947,1886,5363,240,1646,693,581,233,379,339,714,542,291,1471,415,881,429,253,323,181,692,2423,1263,804,896,0,109,787
948,1740,4560,700,1040,515,513,315,397,140,765,735,100,1026,714,490,347,474,429,240,719,1681,1320,600,124,0,106,18
949,1475,3952,1041,434,298,442,295,440,218,437,681,139,872,603,123,193,328,831,209,763,983,1167,830,0,0,0,0
950,2035,4991,1034,1001,598,610,331,496,279,703,870,183,1363,672,302,389,534,810,237,930,1480,1515,829,0,0,0,0
951,2706,6735,1571,1135,740,860,476,630,606,951,989,160,1884,822,764,576,532,834,316,1221,2008,1949,1241,0,0,0,0
952,2513,7168,1936,577,501,702,497,813,294,690,1106,423,1537,976,192,445,574,1302,418,1409,2043,2103,1195,46,0,0,46
953,2628,7176,2287,341,446,892,486,804,516,681,1103,328,1701,927,340,224,514,1550,352,1227,1654,2123,1820,18,0,0,18
954,1943,4425,588,1355,647,650,299,347,242,892,719,90,1331,612,555,535,425,428,222,607,1578,1151,867,0,0,0,0
955,1368,3050,209,1159,509,392,215,252,182,735,437,14,923,445,350,461,384,173,152,452,1272,842,332,0,0,0,0
956,2118,4827,789,1329,740,662,313,403,354,765,847,152,1470,648,464,560,441,653,265,685,1691,1342,844,47,0,0,47
957,1475,3406,492,983,471,479,238,287,207,610,631,27,1141,334,254,270,434,517,162,543,1193,942,566,14,0,0,14
958,1548,3288,791,757,576,520,231,221,190,780,518,60,1267,281,252,390,386,520,158,380,1156,850,744,10,0,0,10
959,2104,4942,842,1262,664,693,329,418,245,1003,726,130,1529,575,649,358,286,811,256,738,1735,1448,765,2,0,0,2
960,2161,5669,1011,1150,661,677,336,487,302,799,940,120,1414,747,543,464,401,753,273,863,1850,1521,1162,311,0,0,311
961,1275,3895,722,553,180,344,249,502,240,384,562,89,697,578,366,136,170,603,356,826,1504,721,488,43,0,0,43
962,1792,4780,370,1422,427,599,311,455,260,728,693,111,1345,447,520,619,407,246,263,839,2070,1040,568,1,0,0,1
963,2399,5137,847,1552,901,824,294,380,292,1004,972,131,1958,441,582,520,544,753,224,648,2009,1378,878,0,0,0,0
964,243,721,3,240,57,63,54,69,46,73,107,17,133,110,140,70,7,26,36,207,228,200,50,8,0,0,8
965,263,994,122,141,64,91,34,74,39,78,106,40,220,43,73,46,64,80,34,94,392,390,84,237,0,0,237
966,37,210,22,15,7,7,7,16,3,29,5,0,37,0,0,3,23,11,23,28,76,57,26,115,0,0,115
967,455,887,320,135,190,144,63,58,34,262,159,0,438,17,48,60,141,206,32,39,458,241,117,123,0,0,123
968,1286,2303,422,864,615,492,85,94,498,462,301,25,1193,93,700,241,210,135,44,126,706,476,951,96,0,0,96
969,1190,2277,265,925,535,426,122,107,221,625,322,22,1084,106,421,155,288,326,70,136,1131,503,437,151,0,0,151
970,2476,4713,182,2294,1418,697,198,163,541,1298,556,81,1970,506,1213,341,455,467,132,387,2394,1080,720,536,289,0,247
971,786,1247,3,783,489,250,23,24,272,351,161,2,748,38,390,113,141,142,24,56,661,227,279,39,9,0,30
972,4447,7840,521,3926,2226,1609,366,246,759,2182,1348,158,3881,566,1489,888,997,1073,285,452,4605,1383,1115,124,0,0,124
973,1428,2596,391,1037,676,528,118,106,184,791,427,26,1182,246,384,382,325,337,113,180,1401,552,350,9,0,0,9
974,3028,5146,768,2260,1616,962,260,190,602,1277,1111,38,2712,316,792,645,677,914,205,277,2367,995,1302,24,0,0,24
975,1291,2763,445,846,469,507,158,157,115,566,531,79,1099,192,270,313,211,497,133,229,1492,622,287,158,0,0,158
976,2412,4994,480,1932,1029,813,301,269,256,1268,719,169,1922,490,572,816,468,556,229,459,3008,933,365,191,0,0,191
977,2994,7150,951,2043,973,1069,468,484,279,1175,1165,375,2414,580,658,502,701,1133,331,833,3897,1424,665,202,0,0,202
978,1640,5146,345,1295,495,516,276,353,179,560,527,374,1310,330,495,518,339,288,234,692,2677,1127,416,684,0,0,684
979,2349,5698,231,2118,1165,789,233,162,218,1376,656,99,2091,258,677,592,632,448,204,366,3107,1329,692,1433,0,0,1433
980,519,1331,121,398,172,133,88,126,77,220,149,73,424,95,144,83,133,159,64,201,688,273,105,14,0,0,14
981,368,690,58,310,167,108,45,48,101,182,53,32,315,53,227,72,23,46,20,62,240,152,216,23,0,0,23
982,759,2045,111,648,253,199,131,176,210,318,206,25,546,213,436,199,88,36,139,506,827,414,159,7,0,0,7
983,1126,2492,210,916,467,348,136,175,335,540,152,99,921,205,774,132,117,103,106,263,1187,480,456,30,0,0,30
984,176,486,18,158,67,45,27,37,31,90,44,11,105,71,110,32,10,24,26,109,182,117,52,53,0,0,53
985,715,2111,90,625,239,191,112,173,124,368,177,46,424,291,409,129,61,116,136,470,835,466,204,217,0,0,217
986,718,2363,201,517,190,235,128,165,111,213,279,115,595,123,201,214,168,135,108,339,1185,488,243,413,0,0,413
987,788,2016,176,612,232,265,142,149,102,371,248,67,549,239,243,282,106,157,75,250,1122,414,155,22,0,0,22
988,1767,6146,787,980,594,648,273,252,27,950,659,131,1446,321,214,322,616,615,213,449,2964,2111,409,2136,0,0,2136
989,975,3031,218,757,285,311,178,201,104,455,299,117,675,300,313,218,139,305,136,476,1552,692,175,445,0,0,445
990,1163,2767,361,802,479,305,181,198,219,481,272,191,961,202,503,228,231,201,118,290,1448,638,273,109,0,0,109
991,6520,11991,1977,4543,2986,2248,707,579,755,3622,1877,266,5930,590,1505,1578,1434,2003,528,820,6872,2353,1418,258,0,0,258
992,1100,2517,424,676,361,377,170,192,90,385,443,182,767,333,167,376,199,358,130,305,1259,596,227,12,0,0,12
993,1844,4299,682,1162,653,651,247,293,183,823,701,137,1489,355,550,418,365,511,214,469,2173,882,561,124,0,0,124
994,931,2256,355,576,291,306,139,195,131,371,357,72,660,271,259,221,246,205,113,386,990,495,272,28,0,0,28
995,1559,4147,410,1149,483,536,253,287,190,793,415,161,1194,365,581,299,318,361,158,548,2193,840,408,402,43,0,359
996,1999,4687,817,1182,593,705,375,326,175,859,700,265,1572,427,464,539,495,501,244,472,2409,1003,559,37,2,0,35
997,668,1657,273,395,164,232,128,144,48,240,330,50,495,173,103,98,197,270,116,185,835,341,180,17,0,0,17
998,2411,5168,1017,1394,924,844,303,340,438,902,903,168,1871,540,419,491,412,1089,285,596,2076,1288,923,133,28,0,105
999,1002,2374,574,428,276,398,115,213,126,451,360,65,767,235,108,137,193,564,121,316,879,539,519,67,0,0,67
1000,1830,4121,794,1036,566,683,254,327,273,590,834,133,1348,482,327,255,423,825,226,503,1919,888,585,25,0,0,25
1001,1638,3703,674,964,544,582,235,277,213,708,525,192,1346,292,478,395,343,422,216,384,1839,804,460,4,0,0,4
1002,879,2005,297,582,312,297,151,119,135,290,337,117,701,178,260,180,161,278,77,235,985,411,297,69,1,0,68
1003,729,1559,301,428,250,260,106,113,98,294,281,56,604,125,194,81,104,350,63,166,695,347,288,1,0,0,1
1004,1357,3193,995,362,361,508,222,266,236,658,422,41,1037,320,190,180,250,737,142,414,883,805,949,0,0,0,0
1005,1266,2976,1089,177,305,522,222,217,254,599,323,90,915,351,162,98,254,752,105,346,705,936,884,0,0,0,0
1006,1454,4308,489,965,552,439,210,253,312,548,472,122,1138,316,409,318,171,556,112,1297,1659,538,702,1050,1039,0,11
1007,1125,4953,133,992,490,304,157,174,370,431,185,139,1070,55,582,209,162,172,60,801,3748,186,158,2389,2381,0,8
1008,1880,11442,21,1859,884,512,286,198,514,1094,118,154,1880,0,1341,376,123,40,80,5295,5702,222,143,7572,7494,0,78
1009,2433,5601,323,2110,936,759,374,364,456,836,809,332,2212,221,1076,691,267,399,135,546,4012,505,403,168,115,0,53
1010,1306,2937,496,810,483,423,183,217,147,601,428,130,1080,226,251,237,296,522,110,304,1475,543,505,20,2,0,18
1011,1522,3425,433,1089,629,492,211,190,226,677,506,113,1188,334,497,361,264,400,138,308,1637,715,627,242,46,0,196
1012,2135,5146,792,1343,692,680,329,434,374,580,785,396,1638,497,643,419,404,669,218,755,2329,1179,665,55,0,0,55
1013,1609,3804,862,747,536,482,236,355,329,568,637,75,1171,438,591,310,229,479,201,617,1396,1009,581,0,0,0,0
1014,1310,4214,329,981,536,466,156,152,99,600,561,50,1135,175,175,284,437,414,165,462,2048,1158,381,1554,0,0,1554
1015,1178,2930,358,820,390,349,195,244,208,509,373,88,882,296,487,244,170,277,146,474,1260,687,363,61,0,0,61
1016,1970,4364,781,1189,773,565,301,331,541,956,408,65,1422,548,925,353,370,322,195,592,1734,1042,801,144,124,0,20
1017,2070,4642,833,1237,754,764,271,281,244,951,592,283,1718,352,654,508,277,631,164,499,2146,1037,796,181,37,0,144
1018,2319,5354,57,2262,1066,589,320,344,441,1323,427,128,2090,229,1199,595,364,161,166,638,3449,742,359,548,139,0,409
1019,202,1295,14,188,87,53,23,39,50,95,39,18,181,21,116,58,12,16,13,162,1028,69,23,904,867,0,37
1020,1853,5670,295,1558,850,575,240,188,263,1023,427,140,1728,125,889,399,287,278,86,1301,3393,494,396,2022,1944,0,78
1021,1869,3806,267,1602,795,636,244,194,399,795,511,164,1767,102,681,483,246,459,95,327,2459,491,434,60,0,0,60
1022,1750,3752,556,1194,640,621,260,229,419,812,394,125,1466,284,454,508,365,423,146,442,1713,785,666,36,0,0,36
1023,1614,3452,688,926,633,527,208,246,215,783,548,68,1164,450,362,457,284,511,166,446,1498,780,562,43,0,0,43
1024,1137,2772,477,660,357,363,197,220,130,472,491,44,847,290,265,243,269,360,127,430,1103,710,402,0,0,0,0
1025,1733,3997,1080,653,516,629,264,324,216,643,699,175,1190,543,341,300,351,741,191,610,1272,1081,843,15,0,0,15
1026,788,1895,535,253,207,254,156,171,124,344,252,68,620,168,110,119,219,340,64,298,538,523,472,0,0,0,0
1027,1706,3698,613,1093,602,619,245,240,390,754,453,109,1427,279,540,307,419,440,110,433,1655,764,736,39,0,0,39
1028,1604,3893,1196,408,454,632,242,276,345,631,557,71,1271,333,188,183,306,927,149,518,1052,1020,1154,98,8,0,90
1029,1537,3723,1252,285,366,613,255,303,270,582,632,53,1158,379,179,191,321,846,133,537,876,1055,1122,47,28,0,19
1030,848,2050,763,85,157,375,142,174,151,329,312,56,657,191,75,99,135,539,75,273,410,621,671,20,0,0,20
1031,1474,3721,1327,147,264,611,277,322,292,480,635,67,1085,389,65,252,242,915,129,567,749,1030,1246,0,0,0,0
1032,663,1708,545,118,162,209,115,177,175,121,298,69,526,137,80,111,124,348,66,268,441,446,487,0,0,0,0
1033,1735,4158,1404,331,445,639,300,351,412,654,557,112,1356,379,457,279,289,710,149,706,843,1219,1241,0,0,0,0
1034,1330,3459,989,341,276,435,222,397,165,606,506,53,810,520,280,240,196,614,150,706,870,979,754,13,0,0,13
1035,869,2335,646,223,137,287,153,292,170,227,451,21,518,351,108,158,161,442,85,515,530,722,483,0,0,0,0
1036,1276,3291,515,761,291,387,256,342,174,385,529,188,805,471,206,286,331,453,185,664,1130,856,456,13,0,0,13
1037,955,2486,461,494,221,253,197,284,111,425,341,78,585,370,169,243,202,341,127,508,815,665,371,13,0,0,13
1038,1083,3818,9,1074,231,476,170,206,199,467,406,11,709,374,467,277,201,138,248,1189,2019,138,224,1350,1244,0,106
1039,2069,5107,1067,1002,584,555,410,520,273,919,805,72,1276,793,299,630,497,643,275,990,1726,1347,769,19,0,0,19
1040,749,1845,79,670,219,231,126,173,64,321,279,85,515,234,243,233,223,50,107,226,960,367,185,10,0,0,10
1041,1045,2493,413,632,297,348,183,217,168,435,309,133,835,210,285,253,252,255,150,333,1082,580,348,2,0,0,2
1042,740,1770,622,118,177,261,152,150,155,295,258,32,574,166,103,123,134,380,94,247,442,519,468,50,40,0,10
1043,1192,2939,961,231,291,436,193,272,321,426,400,45,844,348,125,181,280,606,112,462,709,818,838,13,3,0,10
1044,1032,2487,870,162,249,370,162,251,280,188,483,81,749,283,78,200,192,562,117,379,558,709,724,0,0,0,0
1045,1155,2934,991,164,258,443,202,252,356,388,356,55,908,247,186,241,176,552,122,382,731,822,877,0,0,0,0
1046,936,2434,792,144,195,319,183,239,231,368,302,35,719,217,155,131,229,421,123,388,573,762,588,0,0,0,0
1047,1259,3066,568,691,344,416,237,262,263,450,416,130,827,432,346,307,250,356,189,456,1154,733,534,8,0,0,8
1048,1183,2887,563,620,315,372,249,247,183,490,474,36,758,425,234,323,312,314,147,422,1047,779,492,12,0,0,12
1049,2118,5229,1143,975,609,716,364,429,278,750,924,166,1413,705,697,443,480,498,273,678,1967,1359,952,35,0,0,35
1050,2805,8509,972,1833,678,737,504,886,531,1231,699,344,1622,1183,1360,761,437,247,552,1786,3349,1827,995,265,0,0,265
1051,1441,3562,436,1005,442,434,247,318,400,377,484,180,1138,303,644,348,273,176,162,493,1493,805,609,13,0,0,13
1052,592,1488,485,107,109,232,96,155,175,175,205,37,372,220,127,92,144,229,66,225,361,438,398,0,0,0,0
1053,1653,4126,1384,269,358,577,302,416,296,649,666,42,1208,445,242,309,322,780,193,626,1161,1205,941,1,0,0,1
1054,1173,3047,857,316,276,409,207,281,149,339,600,85,797,376,144,208,355,466,156,417,987,872,615,47,0,0,47
1055,2035,6140,1092,943,458,562,316,699,215,857,548,415,1427,608,294,886,543,312,319,1049,2309,1577,886,53,0,0,53
1056,1801,5115,922,879,498,490,274,539,448,631,624,98,1184,617,724,415,508,154,262,933,1861,1319,740,3,0,0,3
1057,1286,4984,438,848,151,194,240,701,278,314,341,353,529,757,520,365,310,91,338,1330,2025,1001,290,10,0,0,10
1058,2221,7426,926,1295,505,539,388,789,614,779,552,276,1337,884,907,572,462,280,456,1607,2826,1692,845,290,0,0,290
1059,3277,7602,2022,1255,1178,1102,470,527,602,1756,860,59,2731,546,1010,729,803,735,409,996,3045,2034,1118,296,0,0,296
1060,2003,7350,896,1107,344,393,348,918,208,768,582,445,789,1214,801,707,395,100,517,1816,2839,1536,642,32,0,0,32
1061,2471,7912,883,1588,612,531,426,902,831,838,548,254,1364,1107,1461,598,316,96,552,1924,2980,1622,834,32,0,0,32
1062,1971,3986,1107,864,761,732,230,248,453,730,648,140,1650,321,352,414,506,699,150,402,1091,1195,1148,10,0,0,10
1063,1942,7109,680,1262,322,352,371,897,330,645,587,380,1032,910,819,633,335,155,463,1769,2798,1498,581,41,0,0,41
1064,1228,4789,657,571,178,184,222,644,149,362,518,199,626,602,321,431,343,133,260,1170,1825,1050,484,0,0,0,0
1065,2398,8198,1430,968,419,601,399,979,158,962,924,354,1586,812,511,1029,625,233,448,1631,3021,2150,948,54,0,0,54
1066,2391,6599,817,1574,695,558,365,773,495,1142,505,249,1499,892,932,992,389,78,331,1209,2330,1551,1178,47,0,0,47
1067,2547,9848,1045,1502,237,483,477,1350,368,1000,898,281,1191,1356,862,963,564,158,674,2414,3853,2144,763,9,0,0,9
1068,1487,6233,663,824,213,266,264,744,168,484,500,335,635,852,440,515,368,164,416,1508,2460,1399,450,394,0,0,394
1069,4189,11499,1651,2538,1127,1244,682,1136,732,1645,1566,246,2924,1265,1115,1498,875,701,614,1912,4700,2920,1353,0,0,0,0
1070,1303,4601,754,549,208,233,244,618,153,517,381,252,705,598,415,396,324,168,243,945,1705,1167,541,0,0,0,0
1071,1849,6683,899,950,259,370,346,874,362,551,557,379,875,974,689,624,404,132,392,1583,2483,1524,701,0,0,0,0
1072,1773,6052,892,881,268,420,346,739,264,737,441,331,1073,700,565,483,439,286,347,1232,2242,1569,662,0,0,0,0
1073,2096,6010,987,1109,592,562,335,607,390,934,484,288,1368,728,734,696,517,149,367,1068,2265,1476,834,24,0,0,24
1074,2744,7797,1752,992,628,837,526,753,432,1069,849,394,1983,761,463,1057,773,451,435,1208,2732,2130,1292,66,0,0,66
1075,1110,2959,615,495,301,296,186,327,157,478,414,61,748,362,299,462,194,155,155,492,1086,759,467,34,0,0,34
1076,1256,3096,1002,254,321,427,240,268,230,448,427,151,1027,229,288,295,383,290,152,429,874,892,749,10,0,0,10
1077,1976,5372,1255,721,468,612,316,580,309,721,763,183,1298,678,448,484,613,431,254,837,1772,1564,945,3,0,0,3
1078,1666,4699,978,688,380,523,304,459,267,529,543,327,1049,617,321,454,547,344,222,762,1592,1276,847,15,0,0,15
1079,3335,9489,2813,522,573,1210,645,907,916,1198,625,596,2447,888,769,661,941,964,386,1383,2651,2671,2398,1,0,0,1
1080,1905,5914,1272,633,391,522,331,661,412,458,791,244,1101,804,432,506,610,357,308,1045,2016,1619,926,11,0,0,11
1081,1483,4947,1140,343,310,384,225,564,244,426,384,429,994,489,259,430,467,327,233,926,1553,1324,911,19,0,0,19
1082,1969,5666,1222,747,409,581,364,615,328,854,590,197,1333,636,502,483,639,345,251,976,1942,1519,978,34,0,0,34
1083,6019,16864,4274,1745,1290,1736,1140,1853,919,2376,1997,727,4122,1897,1430,1403,1427,1759,860,2804,5742,4835,2623,17,0,0,17
1084,2227,6065,1902,325,476,823,345,583,481,654,826,266,1673,554,246,670,586,725,251,876,1708,1685,1545,27,0,0,27
1085,1492,4665,1195,297,249,477,267,499,391,337,410,354,1069,423,295,319,445,433,206,627,1369,1317,1146,9,0,0,9
1086,2432,7279,1890,542,437,737,420,838,349,817,864,402,1623,809,414,585,642,791,332,1231,2271,1924,1521,18,0,0,18
1087,2236,6023,1860,376,430,783,384,639,475,651,688,422,1617,619,448,373,541,874,265,862,1697,1847,1352,4,1,0,3
1088,1266,4137,1009,257,184,397,211,474,214,544,241,267,823,443,229,315,346,376,195,696,1287,1128,831,14,0,0,14
1089,2148,6249,1093,1055,549,569,438,592,452,814,762,120,1401,747,926,533,459,230,355,1321,2141,1555,877,167,0,0,167
1090,1558,3280,814,744,581,545,217,215,443,535,452,128,1289,269,411,471,344,332,130,379,1080,998,693,0,0,0,0
1091,1528,3439,801,727,528,512,219,269,324,755,335,114,1155,373,442,394,280,412,176,500,1147,963,653,0,0,0,0
1092,522,1056,86,436,254,141,59,68,206,244,72,0,422,100,267,169,64,22,26,96,524,288,122,105,0,0,105
1093,1053,2128,409,644,446,306,143,158,263,466,313,11,773,280,456,221,231,145,96,273,745,671,343,11,0,0,11
1094,3365,8542,2036,1329,896,1028,607,834,421,1217,1542,185,2031,1334,563,842,1112,848,468,1498,2988,2362,1226,11,0,0,11
1095,1242,3714,863,379,234,339,265,404,177,488,454,123,924,318,191,443,355,253,208,762,1256,982,506,18,0,0,18
1096,3876,10087,2847,1029,881,1264,701,1030,665,1369,1520,322,2569,1307,517,1051,964,1344,595,1821,3371,2911,1389,30,0,0,30
1097,1238,3508,1009,229,241,386,239,372,211,345,405,277,831,407,166,535,239,298,171,553,1208,1093,483,25,0,0,25
1098,3760,13191,2625,1135,431,893,774,1662,402,1227,1243,888,2024,1736,438,731,1347,1244,805,2512,4950,3553,1371,0,0,0,0
1099,3093,8498,2243,850,555,1095,598,845,674,1081,905,433,2186,907,551,811,934,797,399,1446,2607,2483,1563,30,0,0,30
1100,3159,8208,2663,496,685,1096,539,839,770,1116,1038,235,2117,1042,437,633,843,1246,366,1484,1967,2634,1757,16,0,0,16
1101,1480,4146,1361,119,223,548,226,483,379,422,534,145,985,495,188,266,428,598,202,810,948,1269,917,0,0,0,0
1102,391,975,341,50,71,137,86,97,100,112,141,38,260,131,70,84,93,144,42,164,192,347,230,0,0,0,0
1103,2881,8124,2428,453,459,974,559,889,627,773,1028,453,1961,920,553,525,757,1046,380,1519,2224,2483,1518,9,0,0,9
1104,1308,3797,1090,218,182,459,242,425,226,494,465,123,816,492,191,138,368,611,172,777,1013,1046,789,0,0,0,0
1105,448,1201,352,96,87,161,83,117,78,169,159,42,280,168,70,83,204,91,56,176,390,354,225,0,0,0,0
1106,3369,8210,1720,1649,1010,1040,564,755,880,1324,1024,141,2665,704,1020,591,1022,736,440,1302,2759,2144,1565,151,0,0,151
1107,1527,3895,852,675,403,478,297,349,345,519,468,195,1167,360,415,372,422,318,242,568,1364,977,744,14,0,0,14
1108,2236,6099,1719,517,490,764,415,567,417,743,846,230,1538,698,240,698,576,722,311,982,1803,1761,1242,40,0,0,40
1109,2874,7877,2145,729,558,996,557,763,426,877,1283,288,1833,1041,476,719,834,845,441,1294,2573,2140,1429,22,0,0,22
1110,2785,7400,1656,1129,684,924,462,715,623,1024,868,270,2154,631,937,521,623,704,396,1233,2582,1975,1214,37,0,0,37
1111,2097,5901,1522,575,433,725,397,542,407,549,803,338,1441,656,378,474,796,449,391,896,2139,1606,869,16,0,0,16
1112,2281,6579,1478,803,490,740,424,627,465,537,960,319,1599,682,572,558,527,624,363,986,2403,1812,1015,92,0,0,92
1113,1396,2362,68,1328,779,403,102,112,521,499,332,44,1307,89,691,365,300,40,84,131,982,524,641,29,0,0,29
1114,2645,7633,485,2160,610,691,496,848,338,1258,851,198,1519,1126,958,930,607,150,583,1666,3401,1514,469,0,0,0,0
1115,1612,4925,253,1359,328,405,289,590,200,563,564,285,1051,561,511,570,319,212,349,1147,2138,953,338,0,0,0,0
1116,1267,3547,870,397,259,449,223,336,187,389,507,184,822,445,229,252,312,474,210,524,1259,1009,545,38,0,0,38
1117,1245,3320,913,332,225,499,187,334,264,339,404,238,895,350,212,329,221,483,154,492,990,980,704,17,0,0,17
1118,3142,7586,1945,1197,881,1062,526,673,483,1441,902,316,2226,916,1094,825,648,575,414,1110,2521,2068,1473,18,0,0,18
1119,3210,8852,1925,1285,670,1037,606,897,567,1369,707,567,2119,1091,663,1151,677,719,534,1536,3099,2311,1372,15,0,0,15
1120,2967,10072,1072,1895,527,702,506,1232,506,1191,793,477,1943,1024,1049,883,711,324,719,2295,4187,2019,852,33,0,0,33
1121,5698,11605,1461,4237,2296,1874,721,807,845,3061,1497,295,4676,1022,1367,1516,1302,1513,682,1303,5045,2594,1981,43,0,0,43
1122,2946,7858,1979,967,905,856,451,734,599,962,1040,345,2117,829,764,1070,671,441,423,1280,2761,2033,1361,163,0,0,163
1123,2343,5724,1107,1236,693,769,398,483,482,800,818,243,1520,823,557,577,754,455,269,949,2247,1491,768,39,0,0,39
1124,2574,6489,1926,648,668,859,504,543,402,905,986,281,1618,956,305,549,819,901,340,1009,1906,1812,1422,0,0,0,0
1125,1944,4980,1563,381,420,745,273,506,499,548,694,203,1343,601,262,372,437,873,255,872,1346,1383,1124,0,0,0,0
1126,2848,7089,2479,369,644,1069,516,619,606,1209,899,134,2154,694,550,588,737,973,326,1054,1811,2180,1718,10,0,0,10
1127,2611,6681,1865,746,586,887,469,669,550,934,773,354,1714,897,600,353,510,1148,346,1143,1898,1906,1388,17,0,0,17
1128,1759,4717,1401,358,369,555,343,492,240,622,812,85,1087,672,204,408,591,556,360,833,1474,1269,781,57,0,0,57
1129,2214,5694,1585,629,555,718,367,574,534,643,776,261,1566,648,369,369,773,703,352,928,1650,1550,1214,99,0,0,99
1130,1385,3577,1165,220,291,470,260,364,388,464,397,136,901,484,280,240,360,505,226,588,888,1016,859,6,0,0,6
1131,2272,6238,1988,284,347,852,390,683,449,674,801,348,1348,924,189,218,312,1553,263,1221,1296,1923,1535,1,0,0,1
1132,1684,4934,1510,174,226,604,263,591,370,458,729,127,936,748,161,158,180,1185,213,1195,935,1480,1111,22,0,0,22
1133,3116,7886,2441,675,707,1098,626,685,815,1082,1001,218,2210,906,665,475,581,1395,439,1292,2132,2264,1759,53,0,0,53
1134,2523,6411,1374,1149,653,836,475,559,363,1050,931,179,1731,792,620,505,438,960,442,1071,2272,1566,1060,33,0,0,33
1135,2963,6421,1727,1236,1019,1034,413,497,542,1154,1049,218,2335,628,574,543,886,960,370,896,2348,1609,1198,10,0,0,10
1136,2647,5474,1080,1567,962,947,370,368,370,1080,1052,145,2205,442,372,447,956,872,294,638,2638,1229,675,12,0,0,12
1137,1456,3855,1234,222,291,555,286,324,294,573,455,134,1033,423,163,196,300,797,212,577,1020,1035,1011,87,0,0,87
1138,2329,6283,1773,556,407,855,457,610,597,871,741,120,1669,660,403,414,464,1048,339,1096,1701,1832,1315,2,0,0,2
1139,1240,3548,1141,99,154,464,234,388,301,410,462,67,739,501,91,149,185,815,156,706,715,1133,838,3,0,0,3
1140,1072,3125,998,74,161,385,189,337,222,376,373,101,753,319,57,144,215,656,140,638,568,917,862,76,0,0,76
1141,2203,6126,1889,314,365,793,396,649,463,718,925,97,1613,590,251,344,437,1171,324,1182,1384,1810,1426,7,0,0,7
1142,1551,4143,1288,263,260,574,277,440,339,518,547,147,1071,480,141,326,389,695,191,764,957,1269,962,0,0,0,0
1143,2029,4601,1309,720,659,716,267,387,376,731,815,107,1362,667,471,209,481,868,216,724,1201,1185,1275,0,0,0,0
1144,2178,5182,1170,1008,632,763,338,445,423,774,708,273,1571,607,264,391,561,962,262,855,1668,1433,964,10,0,0,10
1145,4220,7849,944,3276,1861,1511,432,416,702,2153,1150,215,3619,601,856,937,1145,1282,364,754,3997,1644,1090,61,0,0,61
1146,1966,3690,143,1823,928,614,191,233,146,1275,508,37,1696,270,413,768,560,225,154,439,1999,731,367,11,0,0,11
1147,2317,5920,1764,553,631,719,387,580,793,629,707,188,1565,752,409,353,468,1087,264,1113,1185,1662,1696,0,0,0,0
1148,6364,8862,5983,381,4017,2089,142,116,5306,876,182,0,6354,10,2376,2005,1238,745,33,85,118,863,7763,6,0,0,6
1149,2156,5485,1498,658,550,739,328,539,407,1005,607,137,1526,630,331,489,462,874,268,965,1540,1610,1102,138,0,0,138
1150,2163,5313,1224,939,583,692,339,549,589,895,549,130,1467,696,587,333,449,794,266,1125,1360,1463,1099,1,0,0,1
1151,2089,6081,1943,146,270,686,366,767,372,561,1149,7,1216,873,185,220,378,1306,281,1412,1250,1852,1286,0,0,0,0
1152,2609,6331,1415,1194,648,921,378,662,344,1026,1141,98,1793,816,209,491,438,1471,313,1222,1879,1748,1169,0,0,0,0
1153,1509,4340,1400,109,198,521,252,538,282,548,650,29,886,623,72,194,249,994,233,987,883,1248,989,0,0,0,0
1154,2756,7339,2348,408,557,964,415,820,854,911,893,98,2035,721,415,122,375,1844,308,1554,1307,2108,2062,4,0,0,4
1155,764,2050,666,98,128,268,127,241,126,330,298,10,390,374,89,98,121,456,102,414,442,627,465,0,0,0,0
1156,1508,4460,1334,174,188,479,293,548,300,347,673,188,820,688,136,174,289,909,281,986,1082,1278,833,0,0,0,0
1157,1038,2621,829,209,243,328,165,302,309,293,305,131,727,311,191,140,222,485,122,540,544,769,646,0,0,0,0
1158,2383,6370,1705,678,457,769,439,718,426,998,777,182,1606,777,506,376,395,1106,289,1390,1577,1872,1242,0,0,0,0
1159,901,3425,813,88,124,318,143,316,249,295,301,56,593,308,86,109,153,553,121,1061,914,740,589,933,917,0,16
1160,1884,5863,1702,182,273,635,324,652,420,565,822,77,1069,815,152,221,302,1209,209,1404,1376,1708,1166,548,537,0,11
1161,4576,11958,3466,1110,1047,1582,703,1244,873,1725,1507,471,3009,1567,803,641,714,2418,496,2478,2670,3861,2453,10,0,0,10
1162,478,1169,350,128,114,166,90,108,163,130,146,39,322,156,80,146,83,169,51,220,248,370,280,0,0,0,0
1163,1347,3641,1209,138,217,527,215,388,396,405,434,112,920,427,107,224,256,760,173,712,754,1072,930,0,0,0,0
1164,2012,5887,1867,145,249,746,350,667,371,658,768,215,1461,551,144,70,184,1614,207,1253,1058,1921,1448,51,0,0,51
1165,2735,7859,2543,192,352,1011,463,909,886,713,933,203,1840,895,397,305,374,1659,316,1723,1536,2485,1799,43,0,0,43
1166,4055,11558,3643,412,573,1392,760,1330,855,1367,1553,280,2467,1588,255,382,860,2558,453,2680,2320,3761,2344,23,0,0,23
1167,4216,11439,3717,499,724,1535,652,1305,958,1646,1356,256,2572,1644,638,549,753,2276,457,2513,2233,3554,2682,16,0,0,16
1168,3516,8472,2499,1017,994,1074,622,826,595,1611,1135,175,2383,1133,525,615,741,1635,369,1685,2379,2738,1301,0,0,0,0
1169,2255,6630,1842,413,356,682,420,797,369,860,854,172,1301,954,175,256,691,1133,301,1605,1644,1975,1105,29,0,0,29
1170,3234,8362,1856,1378,722,996,622,894,356,1540,1072,266,1940,1294,251,605,1023,1355,507,1655,2932,2324,944,0,0,0,0
1171,3088,9515,2505,583,330,929,601,1228,539,791,1512,246,1642,1446,370,360,526,1832,355,2286,2281,3112,1481,16,0,0,16
1172,2179,6407,1606,573,357,659,380,783,325,611,988,255,1161,1018,269,349,452,1109,353,1428,1976,1800,850,13,0,0,13
1173,1471,4549,1263,208,181,410,324,556,143,511,633,184,748,723,172,164,356,779,197,1126,1207,1358,661,13,0,0,13
1174,1925,5236,1491,434,396,586,360,583,532,439,685,269,1289,636,320,234,305,1066,182,1096,1191,1623,1144,11,0,0,11
1175,5679,16644,3180,2499,939,1425,1219,2096,688,2577,2035,379,2875,2804,784,987,1214,2694,953,4154,5488,4391,1658,0,0,0,0
1176,15522,50092,11977,3545,1663,3581,3240,7038,1834,5885,6468,1335,7586,7936,1660,1769,2802,9291,1966,14102,12501,15866,5657,143,0,0,143
1177,6696,18163,5585,1111,1166,2714,1040,1776,1573,2379,2020,724,4458,2238,1009,1335,1733,2619,837,3445,4448,5392,4041,0,0,0,0
1178,15203,46829,11851,3352,2532,4265,2579,5827,2985,5319,4514,2385,8915,6288,2301,3825,3959,5118,2406,10831,13324,12748,7520,151,0,0,151
1179,8462,27904,5860,2602,1110,2161,1535,3656,1159,3441,2570,1292,3976,4486,1638,2004,2346,2474,1771,6902,9142,6885,3204,69,0,0,69
1180,5296,18628,4115,1181,565,1254,1018,2459,773,1946,2014,563,2905,2391,1179,1092,1687,1338,1261,4585,6651,4384,1747,15,0,0,15
1181,2083,5650,1628,455,520,646,318,599,464,881,583,155,1472,611,452,617,519,495,322,1064,1772,1571,921,24,0,0,24
1182,3862,11394,2495,1367,865,986,706,1305,634,1126,1144,958,2258,1604,1108,883,1000,871,705,2431,3856,2904,1498,52,0,0,52
1183,1208,3767,931,277,197,329,242,440,257,641,187,123,791,417,323,390,314,181,229,749,1240,969,580,16,0,0,16
1184,1602,5417,1249,353,173,468,296,665,226,543,662,171,1007,595,302,382,457,461,236,1036,1819,1634,692,18,0,0,18
1185,5781,19662,4650,1131,652,1572,1092,2465,709,1697,2540,835,3293,2488,843,1196,2033,1709,1110,4259,6440,5561,2292,46,0,0,46
1186,5648,19218,4014,1634,785,1395,1110,2358,833,2235,1547,1033,3596,2052,1347,1503,1450,1348,998,3966,6237,5395,2622,22,0,0,22
1187,2604,8011,1751,853,510,773,461,860,728,1129,397,350,1590,1014,523,1047,661,373,463,1606,2573,2076,1293,0,0,0,0
1188,3038,9383,1553,1485,647,790,523,1078,877,1031,642,488,1925,1113,1228,911,546,353,648,2076,3281,2153,1225,31,0,0,31
1189,2481,7184,704,1777,572,616,466,827,463,1207,595,216,1485,996,1214,718,286,263,517,1556,2681,1657,773,59,0,0,59
1190,1597,4461,263,1334,376,446,299,476,338,709,393,157,801,796,861,481,197,58,363,1121,1732,934,311,8,0,0,8
1191,1853,6016,851,1002,319,460,353,721,386,575,597,295,1159,694,745,611,331,166,456,1459,2111,1333,657,0,0,0,0
1192,1371,4636,989,382,202,395,243,531,258,399,551,163,938,433,210,548,397,216,255,939,1594,1178,670,15,0,0,15
1193,2705,7655,1158,1547,625,748,531,801,398,1024,1027,256,1756,949,838,1126,397,344,516,1571,2806,1794,968,30,0,0,30
1194,1678,4612,997,681,471,455,277,475,481,498,385,314,1178,500,685,357,416,220,215,855,1386,1191,965,0,0,0,0
1195,5292,18689,4192,1100,608,1441,954,2289,656,1878,1648,1110,3540,1752,1170,1131,1261,1730,897,3951,5777,5404,2660,125,0,0,125
1196,2845,9167,1808,1037,466,808,518,1053,366,913,947,619,1747,1098,344,668,1058,775,501,1705,3218,2386,1357,23,0,0,23
1197,1150,3886,490,660,175,263,245,467,112,514,322,202,575,575,521,261,184,184,285,1016,1374,795,416,10,0,0,10
1198,1538,4594,682,856,326,475,283,454,270,694,378,196,971,567,390,536,391,221,269,864,1630,1208,623,216,0,0,216
1199,3342,9468,1325,2017,894,825,550,1073,584,1061,1557,140,2230,1112,1074,1236,814,218,645,2008,3296,2028,1491,22,0,0,22
1200,2904,9278,1863,1041,461,887,519,1037,379,1197,903,425,1767,1137,502,953,954,495,539,1788,3191,2456,1304,43,0,0,43
1201,1269,4738,926,343,123,300,267,579,192,404,410,263,679,590,228,425,442,174,313,1036,1714,1112,563,7,0,0,7
1202,1001,3624,443,558,121,203,206,471,164,306,315,216,525,476,410,308,256,27,242,911,1333,774,364,9,0,0,9
1203,1630,5805,790,840,250,340,290,750,289,524,528,289,925,705,633,424,257,316,388,1385,2157,1300,575,23,0,0,23
1204,958,3007,398,560,219,218,145,376,314,265,234,145,624,334,505,192,197,64,191,651,1085,689,391,0,0,0,0
1205,1400,3789,818,582,403,405,201,391,399,482,417,102,1025,375,475,502,264,159,203,680,1254,1047,605,1,0,0,1
1206,1839,6254,858,981,318,403,337,781,432,595,465,347,1176,663,769,429,354,287,451,1466,2308,1474,555,8,0,0,8
1207,1827,6574,1321,506,244,430,296,857,153,718,471,485,1120,707,293,789,517,228,385,1509,2309,1614,757,0,0,0,0
1208,2558,8466,1159,1399,509,605,438,1006,396,1025,624,513,1522,1036,913,781,483,381,580,2101,3151,1875,759,18,0,0,18
1209,1721,6050,707,1014,268,382,340,731,193,633,588,307,892,829,520,739,333,129,403,1474,2326,1309,538,23,0,0,23
1210,1857,7342,1205,652,191,372,321,973,222,650,746,239,860,997,711,573,363,210,431,1861,2764,1666,620,3,0,0,3
1211,1689,4106,1031,658,445,556,284,404,385,663,582,59,1235,454,439,440,384,426,231,731,1266,1188,690,6,0,0,6
1212,2165,4486,1318,847,839,809,225,292,576,1017,470,102,1839,326,758,463,596,348,146,606,1069,1328,1337,0,0,0,0
1213,1128,2745,796,332,274,405,185,264,197,491,399,41,869,259,195,152,321,460,87,462,743,805,648,17,0,0,17
1214,1514,3806,1054,460,350,541,242,381,358,552,443,161,1072,442,417,258,334,505,190,713,1060,1021,822,15,0,0,15
1215,1966,4927,1249,717,499,650,322,495,413,876,524,153,1276,690,406,516,416,628,213,903,1413,1392,1006,1,0,0,1
1216,1297,3167,1036,261,328,457,183,329,217,568,383,129,990,307,185,302,435,375,135,504,838,934,756,0,0,0,0
1217,1843,5719,1669,174,155,653,349,686,265,573,818,187,1008,835,223,324,477,819,260,1175,1491,1827,966,0,0,0,0
1218,2168,5919,1207,961,475,699,434,560,408,658,836,266,1345,823,521,636,553,458,313,894,2070,1479,1163,11,0,0,11
1219,1189,3347,876,313,237,441,193,318,258,571,290,70,894,295,281,334,254,320,139,523,976,965,744,36,0,0,36
1220,3073,8084,2324,749,749,1050,539,735,643,1066,1038,326,2399,674,662,715,879,817,323,1073,2415,2502,1771,0,0,0,0
1221,1577,4971,964,613,320,444,308,505,244,598,435,300,922,655,479,497,358,243,291,1015,1782,1205,678,0,0,0,0
1222,1299,3851,521,778,403,417,189,290,239,643,312,105,1052,247,298,429,402,170,173,779,1625,781,493,647,644,0,3
1223,1170,3581,658,512,304,240,215,411,128,736,272,34,749,421,575,348,209,38,225,744,1237,928,447,21,0,0,21
1224,1556,3009,145,1411,832,374,148,202,645,709,172,30,1273,283,1122,300,94,40,186,454,966,704,699,110,0,0,110
1225,1202,2780,341,861,436,341,197,228,186,798,195,23,814,388,613,309,149,131,170,457,1023,744,386,0,0,0,0
1226,1190,3590,512,678,285,312,201,392,342,316,324,208,934,256,431,483,208,68,239,712,1382,845,412,8,0,0,8
1227,1276,3468,711,565,322,401,203,350,189,639,338,110,848,428,377,505,352,42,212,605,1224,907,520,5,0,0,5
1228,777,2278,486,291,174,243,115,245,111,259,328,79,476,301,191,216,200,170,125,402,732,651,368,36,0,0,36
1229,1530,4356,803,727,324,458,259,489,249,540,552,189,955,575,477,534,330,189,284,875,1491,1000,706,9,0,0,9
1230,2510,7246,1541,969,608,746,432,724,670,811,600,429,1943,567,743,625,680,462,337,1253,2156,1926,1574,38,0,0,38
1231,1198,3596,710,488,262,359,185,392,217,512,317,152,843,355,302,596,209,91,203,661,1243,909,580,27,0,0,27
1232,1212,3743,530,682,278,334,222,378,223,514,267,208,878,334,478,421,186,127,207,756,1329,970,481,93,0,0,93
1233,1273,3258,899,374,311,451,194,317,240,504,483,46,898,375,250,481,329,213,174,502,990,942,650,0,0,0,0
1234,1521,4146,470,1051,457,415,225,424,354,765,249,153,1033,488,771,421,190,139,265,833,1603,1002,443,29,0,0,29
1235,1166,2800,298,868,412,356,141,257,283,703,165,15,816,350,616,353,131,66,169,502,1008,772,349,10,0,0,10
1236,1558,3880,530,1028,492,487,219,360,281,783,433,61,1184,374,619,554,326,59,259,698,1430,980,513,29,0,0,29
1237,1041,2899,609,432,238,295,183,325,140,323,432,146,667,374,319,354,276,92,172,576,1055,770,326,0,0,0,0
1238,353,1205,232,121,38,134,77,104,65,175,84,29,286,67,22,103,135,93,63,182,509,295,156,182,181,0,1
1239,1029,3630,741,288,106,242,256,425,86,245,567,131,763,266,58,359,348,264,145,564,1186,1000,735,26,0,0,26
1240,1434,5462,973,461,209,312,249,664,216,690,272,256,940,494,268,629,369,168,345,1085,1837,1377,818,122,0,0,122
1241,1286,3210,427,859,507,354,129,296,351,595,312,28,951,335,846,247,105,88,147,566,937,813,747,186,0,0,186
1242,2276,6182,1325,951,548,748,400,580,467,864,708,237,1719,557,590,743,476,467,335,1072,1973,1665,1137,13,0,0,13
1243,1828,5158,898,930,487,480,352,509,588,559,508,173,1264,564,680,585,362,201,289,931,1693,1267,978,72,0,0,72
1244,1733,6310,1157,576,269,421,341,702,332,503,631,267,1059,674,421,668,430,214,355,1313,2084,1593,965,70,0,0,70
1245,1689,6075,1193,496,245,386,354,704,337,639,528,185,928,761,509,516,381,283,334,1229,2094,1509,909,14,0,0,14
1246,3632,11219,2655,977,537,1188,696,1211,653,1409,1198,372,2409,1223,609,799,1193,1031,463,1716,3461,3339,2240,52,0,0,52
1247,4253,13965,3639,614,464,1161,819,1809,458,1228,1955,612,2601,1652,548,950,1191,1564,837,2882,4603,3921,1722,51,0,0,51
1248,3642,10523,3069,573,676,1130,620,1216,604,997,1755,286,1990,1652,398,740,1119,1385,533,2164,2878,3059,1889,0,0,0,0
1249,2198,6258,1349,849,432,695,346,725,321,600,967,310,1450,748,345,568,787,498,354,1186,2178,1623,917,15,0,0,15
1250,1779,5574,841,938,347,468,346,618,298,881,501,99,950,829,604,709,324,142,373,1159,2071,1397,574,48,0,0,48
1251,2415,7229,1598,817,431,683,474,827,544,1199,518,154,1676,739,991,684,376,364,408,1378,2397,1977,1069,22,0,0,22
1252,862,3857,17,845,22,221,204,415,0,481,377,4,265,597,157,478,178,49,507,946,2262,132,10,943,0,943,0
1253,1320,4301,1067,253,168,369,236,547,98,395,512,315,714,606,220,348,469,283,245,872,1520,1133,531,0,0,0,0
1254,1918,6312,1481,437,237,536,421,724,193,669,744,312,1266,652,249,724,611,334,344,1253,2144,1592,979,9,0,0,9
1255,1801,5477,914,887,375,503,286,637,314,659,590,238,1169,632,562,506,482,251,338,1051,2073,1304,711,0,0,0,0
1256,1738,5188,1199,539,369,434,359,576,420,610,434,274,1352,386,687,474,427,150,285,1018,1719,1273,893,0,0,0,0
1257,2292,7072,1217,1075,472,625,413,782,470,802,625,395,1430,862,613,985,576,118,432,1524,2515,1664,937,0,0,0,0
1258,1330,4310,564,766,232,353,241,504,164,623,442,101,774,556,408,602,225,95,281,1077,1551,974,427,0,0,0,0
1259,1815,5578,719,1096,415,454,295,651,432,619,489,275,1080,735,809,585,301,120,413,1303,2099,1105,658,19,0,0,19
1260,1162,3865,409,753,170,266,260,466,176,703,243,40,566,596,526,474,124,38,318,965,1492,772,318,3,0,0,3
1261,1347,4385,947,400,201,364,297,485,324,349,500,174,895,452,372,445,327,203,260,903,1639,1059,524,22,0,0,22
1262,688,1897,138,550,193,186,93,216,97,330,206,55,464,224,231,326,96,35,130,396,744,426,201,39,0,0,39
1263,997,2948,371,626,280,196,176,345,221,353,345,78,601,396,456,364,147,30,170,604,1009,714,451,23,0,0,23
1264,1991,6156,679,1312,377,557,370,687,246,980,552,213,1067,924,800,637,386,168,496,1418,2357,1319,566,0,0,0,0
1265,1256,3631,508,748,277,390,216,373,92,547,362,255,708,548,309,383,398,166,261,768,1305,825,472,36,22,0,14
1266,1491,4964,801,690,258,380,269,584,321,534,349,287,805,686,479,577,351,84,284,1148,1837,1146,549,4,0,0,4
1267,1313,3624,980,333,296,419,193,405,324,434,314,241,993,320,256,367,429,261,180,644,1050,937,813,0,0,0,0
1268,4365,11451,3042,1323,954,1613,681,1117,1022,1335,1567,441,3165,1200,732,1045,1130,1458,466,1804,3149,3570,2462,20,0,0,20
1269,4025,10839,2312,1713,1079,1231,680,1035,1249,1427,808,541,3136,889,1131,1238,905,751,562,1811,3356,2742,2368,49,0,0,49
1270,6238,20532,4795,1443,785,1794,1267,2392,1029,1895,1994,1320,3641,2597,926,1431,2063,1818,1183,4309,7069,5341,2630,11,0,0,11
1271,5535,17005,4385,1150,744,1683,1066,2042,645,2137,2162,591,3200,2335,718,1385,1768,1664,1048,3735,5684,4550,1988,16,0,0,16
1272,4,23,3,1,0,1,2,1,4,0,0,0,0,4,4,0,0,0,0,0,12,8,3,0,0,0,0
1273,1630,4477,985,645,371,489,330,440,338,797,334,161,1218,412,587,539,265,239,224,844,1499,1245,665,19,0,0,19
1274,2443,6170,1114,1329,716,779,403,545,573,692,857,321,1753,690,755,933,519,236,389,1096,2254,1460,971,0,0,0,0
1275,1330,3525,644,686,327,401,259,343,245,591,379,115,978,352,329,522,313,166,217,669,1466,772,401,0,0,0,0
1276,1329,3934,668,661,241,455,228,405,144,548,469,168,844,485,207,521,454,147,230,833,1561,866,444,0,0,0,0
1277,2101,6183,1516,585,369,641,436,655,397,649,880,175,1304,797,292,631,751,427,402,1252,2027,1601,901,10,0,0,10
1278,1511,4506,1266,245,196,495,313,507,300,261,574,376,916,595,169,399,472,471,358,866,1644,1106,532,0,0,0,0
1279,3363,9468,2181,1182,670,1169,538,986,572,1213,1279,299,2201,1162,555,964,988,856,578,1671,3496,2374,1349,26,0,0,26
1280,4970,10902,3258,1712,1886,1666,526,892,1492,1901,838,739,4090,880,1244,1325,1295,1106,416,1502,2551,2816,3617,0,0,0,0
1281,2559,6674,962,1597,633,838,440,648,308,951,1100,200,1706,853,500,1074,683,302,461,1253,2983,1324,653,0,0,0,0
1282,4869,14694,3214,1655,706,1503,976,1684,707,1787,1904,471,3029,1840,1108,1115,1255,1391,894,3394,4599,4031,1776,77,0,0,77
1283,1618,4239,960,658,391,498,293,436,298,772,445,103,1026,592,549,508,396,165,245,917,1441,1007,629,0,0,0,0
1284,2141,5453,1308,833,547,725,341,528,612,579,602,348,1639,502,503,565,565,508,266,1026,1829,1383,949,24,0,0,24
1285,1898,4959,1663,235,351,731,316,500,430,840,436,192,1275,623,277,437,510,674,237,884,1230,1384,1224,0,0,0,0
1286,1750,4751,1431,319,283,720,329,418,510,499,611,130,1411,339,258,535,395,562,152,718,1126,1539,1216,6,0,0,6
1287,340,969,169,171,66,118,50,106,93,115,88,44,252,88,78,125,44,93,47,160,282,294,186,1,0,0,1
1288,3910,11629,2803,1107,562,1189,795,1364,535,1420,1098,857,2137,1773,858,1375,1189,488,636,2419,3746,3120,1708,4,0,0,4
1289,2961,8852,1728,1233,631,751,505,1074,375,1194,1039,353,1751,1210,847,931,597,586,605,1934,3076,2098,1139,0,0,0,0
1290,5438,11496,4277,1161,1690,2452,537,759,2745,1870,576,247,4998,440,1801,1894,1166,577,428,1208,2252,2754,4854,6,0,0,6
1291,3572,12384,2619,953,511,794,640,1627,460,1046,1280,786,1932,1640,634,925,924,1089,531,2919,3882,3397,1655,14,0,0,14
1292,3011,10664,2319,692,358,760,522,1371,413,773,1185,640,1733,1278,619,709,877,806,507,2285,3333,2989,1550,69,0,0,69
1293,2204,5599,1127,1077,599,776,345,484,430,888,562,324,1380,824,581,559,546,518,276,956,1844,1322,1201,25,0,0,25
1294,24,68,3,21,12,3,4,5,3,21,0,0,18,6,24,0,0,0,5,16,13,34,0,22,0,0,22
1295,2962,8392,1685,1277,669,964,497,832,506,1216,912,328,1983,979,801,861,754,546,440,1662,2944,2186,1160,105,0,0,105
1296,1588,3608,987,601,437,689,228,234,461,713,382,32,1308,280,333,338,327,590,152,498,1039,1043,876,16,0,0,16
1297,3441,9073,1374,2067,997,1034,550,860,433,1286,1322,400,2284,1157,985,1056,876,524,486,1724,3300,2091,1472,28,0,0,28
1298,685,2609,190,495,237,216,105,127,58,255,320,52,549,136,111,208,201,165,64,302,1096,921,226,998,0,0,998
1299,1087,2302,295,792,483,330,113,161,274,550,211,52,862,225,436,340,202,109,98,287,962,550,405,57,0,0,57
1300,836,2331,401,435,244,234,116,242,155,372,239,70,544,292,306,259,151,120,130,435,847,607,312,52,0,0,52
1301,1286,3284,589,697,385,408,188,305,179,579,472,56,873,413,331,494,219,242,157,619,1126,905,477,20,0,0,20
1302,2463,7646,1329,1134,462,663,403,935,408,840,908,307,1467,996,479,800,605,579,486,1698,2665,1820,977,23,0,0,23
1303,1225,3103,1084,141,247,491,187,300,359,408,304,154,854,371,167,214,444,400,130,499,643,943,888,0,0,0,0
1304,2763,7420,1452,1311,782,828,397,756,681,945,688,449,1996,767,1003,749,617,394,391,1394,2351,1855,1429,0,0,0,0
1305,1741,5163,823,918,356,502,297,586,193,573,774,201,976,765,399,632,489,221,260,1115,1893,1353,542,9,0,0,9
1306,5012,13044,3540,1472,1311,1682,777,1242,1435,1498,1491,588,3722,1290,1343,1239,1072,1358,552,2216,3595,3581,3100,25,0,0,25
1307,2786,7123,1912,874,718,1020,393,655,722,831,967,266,2055,731,628,525,822,811,310,1170,1935,2054,1654,44,34,0,10
1308,1561,3953,1293,268,295,676,212,378,459,547,367,188,1261,300,248,387,447,479,175,596,849,1241,1092,34,0,0,34
1309,156,296,129,27,64,60,17,15,62,42,47,5,123,33,69,32,29,26,7,27,38,76,148,0,0,0,0
1310,1072,2427,685,387,464,418,74,116,410,467,169,26,958,114,411,290,178,193,36,108,263,411,1609,467,0,0,467
1311,2633,6381,2167,466,575,1174,382,502,857,753,834,189,2255,378,433,449,680,1071,192,816,1283,1953,2137,106,0,0,106
1312,759,1864,571,188,202,280,125,152,145,373,207,34,591,168,252,213,203,91,85,299,538,595,347,39,4,0,35
1313,1692,4875,950,742,450,663,236,343,257,794,583,58,1246,446,403,334,553,402,150,851,1599,1173,1102,679,565,0,114
1314,2356,5475,1293,1063,766,782,258,550,533,1238,498,87,1764,592,565,444,454,893,187,993,1341,1486,1468,45,21,0,24
1315,808,1962,509,299,197,363,80,168,209,288,236,75,628,180,204,152,176,276,60,256,461,532,653,20,0,0,20
1316,277,656,184,93,73,121,26,57,41,100,94,42,232,45,45,57,77,98,16,74,155,201,210,42,0,0,42
1317,2243,5552,1246,997,678,727,253,585,409,1112,480,242,1765,478,670,589,518,466,258,976,1520,1443,1355,37,0,0,37
1318,2092,4821,1467,625,611,827,277,377,484,1091,425,92,1850,242,329,318,490,955,161,607,1138,1354,1561,54,0,0,54
1319,3529,9635,1868,1661,905,1155,490,979,660,1247,840,782,2326,1203,868,903,936,822,535,1994,3049,2484,1573,44,0,0,44
1320,2612,5569,1515,1097,934,939,327,412,676,1052,746,138,2238,374,650,783,485,694,211,713,1251,1592,1802,47,0,0,47
1321,2631,6855,1587,1044,700,960,377,594,763,1170,489,209,2239,392,767,778,600,486,305,1202,1950,1943,1455,16,0,0,16
1322,35,66,30,5,12,19,2,2,15,14,4,2,33,2,6,4,3,22,1,5,7,17,36,0,0,0,0
1323,3886,8274,2364,1522,1422,1400,430,634,1538,1306,931,111,3182,704,1094,1029,802,961,250,1145,1756,2222,2901,3,0,0,3
1324,1887,3765,1490,397,695,820,174,198,587,765,369,166,1709,178,617,415,336,519,88,375,529,969,1804,4,0,0,4
1325,3636,9365,2189,1447,803,1345,587,901,770,1117,1285,464,2503,1133,516,986,934,1200,423,1699,2841,2577,1825,12,0,0,12
1326,2027,5327,1674,353,362,742,373,550,405,761,730,131,1489,538,426,477,314,810,220,1031,1207,1626,1243,24,0,0,24
1327,2044,4814,1142,902,589,731,326,398,454,838,592,160,1519,525,569,514,441,520,209,778,1303,1389,1135,0,0,0,0
1328,1759,5003,1114,645,359,664,307,429,332,598,626,203,1113,646,360,439,339,621,226,834,1586,1304,1053,286,0,286,0
1329,1415,3454,914,501,357,551,194,313,256,693,362,104,994,421,457,259,277,422,112,502,865,1073,902,0,0,0,0
1330,1460,3502,1015,445,369,525,249,317,354,591,287,228,1082,378,303,333,378,446,160,574,961,1016,791,21,0,0,21
1331,2056,5248,937,1119,592,635,328,501,311,802,808,135,1348,708,521,564,640,331,274,1054,1862,1267,791,9,0,0,9
1332,2157,4878,880,1277,794,718,289,356,541,571,920,125,1609,548,504,612,503,538,188,690,1636,1389,975,155,0,0,155
1333,1550,4535,1026,524,292,453,293,512,252,702,421,175,1124,426,246,684,412,208,231,941,1511,1146,706,33,0,0,33
1334,1581,4470,1258,323,274,542,301,464,317,497,446,321,1040,541,246,438,456,441,226,765,1299,1263,917,0,0,0,0
1335,2944,7403,1613,1331,930,861,441,712,983,894,753,314,2228,716,1014,728,672,530,401,1119,2306,1835,1742,21,0,0,21
1336,5505,14499,4097,1408,1307,1795,908,1495,1458,1746,1774,527,3960,1545,1147,1418,1264,1676,650,2821,3833,4344,2851,4,0,0,4
1337,3252,8191,1743,1509,930,1081,473,768,889,1316,569,478,2587,665,1089,999,493,671,410,1341,2790,2239,1411,24,0,0,24
1338,1532,3754,879,653,450,504,240,338,261,664,450,157,1128,404,548,437,290,257,182,624,1326,1019,603,7,0,0,7
1339,2120,5418,1238,882,529,694,321,576,345,1089,567,119,1618,502,534,607,689,290,257,909,2017,1359,876,3,0,0,3
1340,2530,6965,1482,1048,480,850,501,699,246,653,1390,241,1756,774,500,714,646,670,372,1198,2900,1744,751,11,0,0,11
1341,2430,6644,1707,723,507,817,481,625,527,942,822,139,1801,629,538,562,648,682,327,1087,2405,1699,1126,101,100,0,1
1342,1521,7052,786,735,333,503,294,391,221,479,619,202,1188,333,432,515,369,205,218,1441,3725,1117,551,2870,2855,0,15
1343,1620,4593,839,781,373,457,289,501,289,825,379,127,1015,605,558,616,295,151,263,801,1851,1153,525,40,0,0,40
1344,2315,5689,646,1669,793,649,338,535,555,754,727,279,1682,633,815,861,494,145,360,1046,2294,1235,754,9,0,0,9
1345,1651,3902,932,719,499,519,286,347,348,569,544,190,1165,486,421,590,452,188,236,557,1420,909,780,0,0,0,0
1346,2112,4998,1185,927,643,771,264,434,460,389,1031,232,1572,540,499,523,574,516,190,725,1626,1176,1281,5,0,0,5
1347,1938,5365,1427,511,345,676,388,529,315,793,519,311,1353,585,329,497,614,498,266,914,1792,1482,911,31,0,0,31
1348,3782,10702,1419,2363,1055,938,625,1164,750,1315,1435,282,2551,1231,1713,1317,538,214,688,2411,4108,2344,1151,40,0,0,40
1349,2632,8454,1359,1273,506,712,471,943,376,1002,899,355,1462,1170,637,1123,589,283,546,1938,3140,2023,807,105,0,0,105
1350,3066,7115,1686,1380,1000,1064,424,578,609,1157,1124,176,2197,869,769,761,868,668,325,1094,2097,1921,1678,43,0,0,43
1351,1382,3725,1079,303,296,518,248,320,233,528,458,163,956,426,130,322,387,543,154,629,1019,952,971,123,0,0,123
1352,1260,3140,1184,76,182,625,209,244,348,339,454,119,984,276,231,185,299,545,86,477,526,925,1126,21,0,0,21
1353,3818,6384,2942,876,1693,1784,158,183,2553,904,246,115,3682,136,1040,1092,841,845,43,218,390,1087,4646,0,0,0,0
1354,2996,7905,2513,483,572,1163,442,819,679,1319,781,217,2182,814,447,661,715,1173,281,1497,1708,2427,1992,37,0,0,37
1355,1526,3578,1061,465,430,548,268,280,438,607,325,156,1108,418,541,391,388,206,115,576,1009,959,919,21,0,0,21
1356,3069,7322,1668,1401,1021,941,463,644,957,945,1009,158,2298,771,934,793,606,736,357,1338,2205,1683,1739,60,0,0,60
1357,1748,4484,857,891,443,592,277,436,297,651,589,211,1168,580,497,361,472,418,227,867,1569,1102,719,32,0,0,32
1358,3237,7638,1422,1815,1011,1149,431,646,1018,940,1015,264,2526,711,992,941,922,382,355,1270,2314,1829,1870,54,0,0,54
1359,2197,5220,1453,744,598,851,368,380,286,948,868,95,1524,673,215,726,653,603,267,782,1626,1483,1062,25,0,0,25
1360,1401,2976,479,922,568,423,205,205,380,500,453,68,1037,364,582,401,270,148,118,429,1149,760,520,36,0,0,36
1361,1099,2167,133,966,549,333,97,120,159,618,210,112,865,234,433,453,139,74,118,332,1000,483,234,28,0,0,28
1362,1894,3730,702,1192,823,634,204,233,536,908,367,83,1614,280,773,431,432,258,118,494,1200,908,1010,8,0,0,8
1363,916,2194,380,536,266,301,148,201,149,322,313,132,717,199,235,322,230,129,86,264,909,678,257,5,0,0,5
1364,1758,3929,645,1113,564,623,277,294,231,707,690,130,1297,461,578,529,468,183,201,607,1550,1004,567,21,0,0,21
1365,1804,4219,1426,378,496,686,285,337,598,724,364,118,1456,348,292,471,464,577,161,613,944,1191,1310,41,0,0,41
1366,3127,7472,2129,998,809,1316,420,582,1208,808,928,183,2468,659,588,629,729,1181,211,1018,1510,2124,2609,266,0,0,266
1367,2057,5249,1463,594,554,717,319,467,768,548,660,81,1597,460,653,653,350,401,230,882,1457,1459,1221,58,0,0,58
1368,1950,4994,957,993,530,655,292,473,305,898,605,142,1308,642,474,518,529,429,234,1017,1599,1356,788,41,0,0,41
1369,1666,4654,1268,398,326,548,320,472,354,542,580,190,1252,414,543,459,454,210,235,778,1575,1342,724,51,0,0,51
1370,3819,10428,2515,1304,849,1246,670,1054,701,1358,1248,512,2727,1092,969,658,1079,1113,581,1838,3482,2770,1757,38,0,0,38
1371,2009,5443,1267,742,448,640,368,553,287,612,676,434,1336,673,293,545,734,437,267,988,1905,1421,862,20,0,0,20
1372,1598,5405,751,847,278,384,288,648,305,500,544,249,956,642,434,473,529,162,338,1242,1973,1213,639,49,0,0,49
1373,2756,7132,650,2106,880,724,433,719,469,1016,1102,169,1705,1051,967,1101,568,120,464,1467,2860,1511,830,57,0,0,57
1374,2887,7598,807,2080,805,884,486,712,581,954,827,525,2248,639,1011,805,663,408,451,1531,3227,1516,873,22,0,0,22
1375,2926,7550,1875,1051,849,935,421,721,451,1145,1008,322,2017,909,673,1067,750,436,386,1252,2389,1852,1671,79,0,0,79
1376,2090,6764,1064,1026,465,590,345,690,292,752,621,425,1341,749,701,785,468,136,391,1373,2505,1728,767,181,0,0,181
1377,2076,5999,996,1080,481,626,398,571,332,878,684,182,1327,749,737,698,494,147,347,1192,2361,1402,697,22,0,0,22
1378,2809,9206,1081,1728,574,648,433,1154,541,865,947,456,1673,1136,1111,964,548,186,552,2220,3450,2105,879,72,0,0,72
1379,1456,5675,679,777,167,299,263,727,138,319,502,497,583,873,380,478,457,141,338,1419,2120,1250,548,41,0,0,41
1380,2468,8851,1361,1107,352,599,434,1083,486,632,1028,322,1440,1028,762,807,651,248,548,2118,3142,2256,787,130,0,0,130
1381,3788,12578,2195,1593,718,1034,655,1381,660,1170,1336,622,2262,1526,971,1384,828,605,701,2504,4680,3325,1368,385,0,0,385
1382,2453,6787,1926,527,543,878,413,619,519,851,814,269,1774,679,561,569,687,636,286,1159,1972,1849,1521,21,0,0,21
1383,2443,6179,1782,661,535,1045,395,468,651,821,709,262,2081,362,624,336,541,942,201,828,1446,1754,1950,14,0,0,14
1384,2683,6281,1536,1147,776,908,447,552,616,815,910,342,1855,828,604,770,850,459,202,1078,1607,1760,1634,16,0,0,16
1385,2052,4923,1334,718,599,741,327,385,583,724,530,215,1630,422,639,456,491,466,173,720,1099,1385,1546,0,0,0,0
1386,1729,4076,1119,610,541,604,224,360,551,648,396,134,1367,362,534,450,390,355,157,624,1029,1154,1112,40,0,0,40
1387,1918,4921,1372,546,422,803,295,398,514,667,547,190,1348,570,470,477,586,385,182,643,1226,1431,1439,0,0,0,0
1388,459,1169,341,118,107,189,69,94,153,184,74,48,348,111,69,109,133,148,41,158,297,304,369,0,0,0,0
1389,1908,4289,1357,551,542,840,252,274,605,760,390,153,1594,314,330,495,464,619,141,462,954,1252,1480,14,0,0,14
1390,1600,3256,1050,550,626,606,195,173,618,560,354,68,1391,209,630,463,257,250,109,297,775,1151,924,39,0,0,39
1391,1765,3969,1019,746,621,681,195,268,680,479,457,149,1505,260,585,512,349,319,129,547,1104,1269,920,126,0,0,126
1392,1868,4295,1361,507,580,708,261,319,575,479,730,84,1255,613,473,585,442,368,161,589,1045,1260,1240,0,0,0,0
1393,1516,3441,1131,385,466,602,226,222,397,470,510,139,1222,294,406,391,358,361,133,407,902,1037,962,0,0,0,0
1394,2990,9526,2270,720,395,912,580,1103,374,746,1454,416,1513,1477,434,587,938,1031,473,2090,2907,2731,1325,69,0,0,69
1395,3322,9072,2303,1019,806,1038,516,962,844,1143,800,535,2199,1123,917,732,1010,663,413,1749,2684,2413,1813,46,0,0,46
1396,3685,10167,3022,663,728,1246,624,1087,831,1050,1331,473,2523,1162,737,860,997,1091,443,1938,2565,3141,2080,90,0,0,90
1397,2198,5258,1435,763,628,811,250,509,703,727,602,166,1772,426,566,669,518,445,208,802,1349,1475,1424,0,0,0,0
1398,1577,3710,1005,572,375,672,218,312,368,598,535,76,1188,389,438,400,317,422,159,526,920,1074,1031,0,0,0,0
1399,1667,4506,745,922,431,541,211,484,314,652,596,105,1194,473,460,488,339,380,243,834,1564,1127,738,26,0,0,26
1400,953,2279,696,257,236,413,130,174,283,323,269,78,744,209,170,190,223,370,70,259,473,663,814,40,0,0,40
1401,1335,3518,886,449,299,589,180,267,363,341,498,133,1121,214,271,268,349,447,111,470,890,1104,943,34,0,0,34
1402,4032,10634,2568,1464,989,1347,591,1105,834,1478,1350,370,2980,1052,1185,1040,1067,740,527,1878,3244,2735,2250,25,0,0,25
1403,1881,3865,1442,439,636,858,186,201,782,675,415,9,1629,252,598,650,324,309,108,305,741,1112,1599,44,0,0,44
1404,1054,2675,900,154,233,447,174,200,331,315,337,71,881,173,209,169,177,499,79,383,534,819,860,55,0,0,55
1405,1085,2909,857,228,212,397,180,296,182,429,338,136,702,383,175,208,207,495,124,492,771,904,618,35,0,0,35
1406,675,1555,566,109,154,301,99,121,131,181,327,36,539,136,96,88,161,330,59,178,279,561,478,0,0,0,0
1407,2642,6807,1683,959,795,715,472,660,738,938,752,214,1825,817,710,729,514,689,346,1388,1820,1923,1330,126,0,0,126
1408,2293,5546,1577,716,613,892,296,492,483,816,787,207,1803,490,324,839,525,605,227,905,1411,1512,1491,0,0,0,0
1409,3090,7871,2164,926,828,1023,489,750,603,1144,1106,237,2293,797,431,789,693,1177,360,1349,2046,2303,1813,21,0,0,21
1410,2063,5293,1094,969,564,650,371,478,516,630,689,228,1323,740,684,435,469,475,281,1017,1798,1429,768,29,0,0,29
1411,2583,6527,1493,1090,791,802,395,595,1001,614,685,283,1963,620,890,486,525,682,324,1088,1806,1761,1548,82,0,0,82
1412,4115,11080,2361,1754,962,1367,700,1086,1083,1445,1331,256,2989,1126,1127,1140,750,1098,563,2118,3163,3062,2174,127,0,0,127
1413,934,2278,803,131,211,388,145,190,332,242,322,38,772,162,230,206,232,266,65,378,447,708,680,15,0,0,15
1414,2724,7338,2358,366,455,1086,457,726,682,950,835,257,1905,819,516,494,475,1239,287,1333,1569,2195,1954,41,0,0,41
1415,1613,3789,955,658,515,594,216,288,350,694,486,83,1338,275,409,284,383,537,140,520,887,1091,1151,27,0,0,27
1416,634,1325,365,269,239,242,72,81,246,250,116,22,593,41,228,171,130,105,40,163,272,352,498,3,0,0,3
1417,143,357,86,57,36,54,26,27,26,65,47,5,93,50,36,13,25,69,15,62,95,107,78,8,2,0,6
1418,1643,3899,1172,471,467,622,266,288,412,617,384,230,1399,244,342,330,420,551,122,574,820,1241,1142,19,0,0,19
1419,1314,3108,853,461,354,433,226,301,305,555,369,85,995,319,366,260,288,400,116,591,709,975,717,3,0,0,3
1420,2750,7450,2219,531,504,922,506,818,526,1160,843,221,1679,1071,242,631,611,1266,299,1739,1391,2435,1586,32,10,0,22
1421,3165,7559,1746,1419,1132,908,425,700,1169,1038,670,288,2536,629,969,837,621,738,356,1273,1948,1905,2077,189,24,0,165
1422,2288,5906,1983,305,513,779,413,583,528,801,783,176,1578,710,347,599,567,775,269,1098,1304,1801,1434,43,0,0,43
1423,2392,6263,1957,435,528,832,418,614,577,717,926,172,1685,707,341,278,433,1340,255,1248,1289,1892,1579,65,0,0,65
1424,1899,4090,812,1087,803,634,225,237,308,708,513,370,1610,289,435,406,549,509,177,554,1475,952,932,17,0,0,17
1425,2407,5906,1606,801,738,834,366,469,702,726,708,271,1831,576,602,474,501,830,237,819,1600,1730,1520,56,0,0,56
1426,2155,5310,1965,190,427,961,323,444,554,570,938,93,1647,508,247,229,438,1241,198,848,929,1573,1762,0,0,0,0
1427,2840,8139,1339,1501,802,879,413,746,784,1134,680,242,2055,785,724,762,394,960,430,1684,2608,1935,1482,604,479,0,125
1428,2640,10441,643,1997,417,470,339,1414,270,779,726,865,1302,1338,805,783,574,478,660,2292,4458,2206,825,68,0,0,68
1429,1846,4587,930,916,505,637,302,402,288,744,712,102,1334,512,395,478,377,596,301,668,1567,1265,786,31,0,0,31
1430,2731,6089,824,1907,1087,805,372,467,528,1327,764,112,2397,334,851,755,491,634,290,791,2243,1755,1010,194,0,0,194
1431,3702,8603,1757,1945,1225,1226,507,744,754,1361,1424,163,2794,908,839,839,827,1197,428,1355,2641,2379,1800,48,4,0,44
1432,2061,4775,1203,858,655,706,255,445,380,665,929,87,1362,699,354,320,397,990,179,861,1118,1535,1082,43,0,0,43
1433,1303,3134,876,427,372,401,240,290,204,508,476,115,890,413,231,256,179,637,155,641,662,1083,593,14,0,0,14
1434,2245,5272,1521,724,614,817,389,425,532,622,976,115,1678,567,537,377,566,765,194,851,1193,1802,1232,14,0,0,14
1435,792,2308,692,100,127,237,121,307,151,345,253,43,433,359,78,75,131,508,116,589,416,674,513,50,0,0,50
1436,1818,4732,1295,523,430,608,282,498,381,858,551,28,1202,616,359,256,263,940,186,1099,936,1455,1056,18,0,0,18
1437,3158,7085,1705,1453,1072,1064,396,626,783,1324,841,210,2400,758,684,633,500,1341,299,1256,1530,2054,1946,0,0,0,0
1438,2057,4977,1150,907,558,638,331,530,359,809,823,66,1540,517,173,454,280,1150,182,664,1615,1736,780,15,0,0,15
1439,0,0,0,0,0,0,0,0,0,0,0,0,0,0,0,0,0,0,0,0,0,0,0,0,0,0,0
1440,2925,6570,1745,1180,982,984,393,566,728,1181,802,214,1953,972,645,418,481,1381,235,1225,1382,2121,1607,13,0,0,13
1441,2492,6084,1542,950,689,776,416,611,703,947,788,54,1498,994,327,496,401,1268,306,1262,1501,1880,1135,4,0,0,4
1442,2319,5924,1660,659,583,691,397,648,450,969,760,140,1447,872,239,295,371,1414,257,1419,1110,1945,1193,11,0,0,11
1443,2027,4446,1146,881,831,583,239,374,648,826,467,86,1507,520,288,362,477,900,163,800,882,1322,1279,114,0,0,114
1444,1903,4198,873,1030,743,634,214,312,503,730,591,79,1414,489,372,512,298,721,178,731,1032,1217,1040,108,102,0,6
1445,2487,6240,1538,949,648,763,403,673,377,1034,923,153,1710,777,324,233,471,1459,239,1451,1289,1949,1312,2,0,0,2
1446,2459,5800,1574,885,663,936,314,546,609,1263,532,55,1749,710,278,298,534,1349,232,1046,1124,1698,1700,0,0,0,0
1447,896,2120,641,255,245,321,105,225,273,348,246,29,598,298,117,108,112,559,65,435,297,612,711,0,0,0,0
1448,4370,7894,2275,2095,1904,1725,410,331,1155,2095,1036,84,3961,409,764,744,1108,1754,265,541,2152,2685,2251,157,0,0,157
1449,1137,2720,273,864,341,386,196,214,168,643,308,18,718,419,480,197,167,293,138,533,992,692,365,19,0,0,19
1450,2726,6841,1981,745,651,959,466,650,427,1107,1023,169,1577,1149,219,414,431,1662,339,1370,1589,2183,1360,22,0,0,22
1451,1917,4851,1540,377,480,626,292,519,440,648,728,101,1141,776,289,221,268,1139,209,1053,936,1621,1032,0,0,0,0
1452,1913,4536,1289,624,573,637,259,444,339,855,608,111,1340,573,232,286,287,1108,189,862,988,1526,971,13,0,0,13
1453,272,677,166,106,68,103,50,51,49,124,89,10,177,95,68,25,48,131,28,117,180,205,147,15,4,0,11
1454,986,2116,584,402,378,354,130,124,296,432,161,97,874,112,371,181,130,304,57,246,453,550,810,27,0,0,27
