"TAZ","TOTHH","TOTPOP","hh_own","hh_rent","hh_size_1","hh_size_2","hh_size_3","hh_size_4_plus","hh_wrks_0","hh_wrks_1","hh_wrks_2","hh_wrks_3_plus","hh_kids_no","hh_kids_yes","HHINCQ1","HHINCQ2","HHINCQ3","HHINCQ4","AGE0004","AGE0519","AGE2044","AGE4564","AGE65P","gq_tot_pop","gq_type_univ","gq_type_mil","gq_type_othnon"
1,48,108,6,42,26,14,3,5,13,24,8,3,42,6,25,11,4,8,4,8,48,24,24,11,2,0,9
2,150,338,19,131,80,45,10,15,41,75,26,8,132,18,78,35,13,24,13,25,150,76,74,33,5,0,28
3,265,401,8,257,153,81,19,12,71,133,46,15,232,33,120,31,55,59,11,14,191,120,65,39,6,0,33
4,157,261,14,143,99,39,12,7,42,79,27,9,138,19,56,26,41,34,1,12,125,80,43,24,3,0,21
5,479,802,56,423,304,119,30,26,129,240,83,27,420,59,187,79,100,113,5,42,362,254,139,81,12,0,69
6,2128,3465,102,2026,1391,578,93,66,195,1512,400,21,2035,93,676,539,291,622,45,236,2298,597,289,376,376,0,0
7,3346,5981,24,3322,2287,720,180,159,1208,1605,492,41,3215,131,2048,690,423,185,103,290,2963,1723,902,991,39,0,952
8,5008,11031,66,4942,3533,837,283,355,2108,1841,694,365,4251,757,3448,881,606,73,239,772,3773,3557,2690,2943,0,0,2943
9,6071,12106,142,5929,3368,1627,546,530,1534,3226,1059,252,5496,575,3139,1386,832,714,410,1026,6357,3010,1303,1284,173,0,1111
10,4034,8265,463,3571,2131,1227,331,345,992,1772,991,279,3440,594,1198,864,789,1183,226,709,4880,1757,693,1126,328,0,798
11,2548,4950,183,2365,1638,504,190,216,461,1373,610,104,2248,300,1353,386,444,365,124,325,2092,1777,632,728,0,0,728
12,811,1317,211,600,423,284,66,38,197,363,251,0,767,44,103,25,96,587,30,65,707,287,228,21,0,0,21
13,51,96,23,28,22,20,5,4,12,23,16,0,48,3,19,1,2,29,4,6,46,28,12,2,0,0,2
14,393,736,165,228,173,152,36,32,91,176,125,1,371,22,143,12,15,223,33,46,359,211,87,13,0,0,13
15,274,544,14,260,130,93,26,25,7,103,142,22,250,24,37,80,74,83,23,55,309,110,47,28,0,0,28
16,5429,9794,1320,4109,2403,2084,572,370,422,2099,2745,163,5203,226,562,389,864,3614,395,479,6651,1757,512,151,0,0,151
17,4560,8169,1562,2998,2079,1783,442,256,671,2498,1284,107,4292,268,812,561,852,2335,287,334,5073,1801,674,282,92,0,190
18,1027,1916,359,668,500,364,100,63,92,542,320,73,924,103,93,252,235,447,58,63,1276,432,87,189,0,0,189
19,883,2029,167,716,361,372,82,68,79,466,275,63,794,89,242,66,84,491,55,116,1378,422,58,274,0,0,274
20,2235,4794,506,1729,1030,743,252,210,326,1164,626,119,1981,254,700,289,412,834,151,285,2822,1109,427,442,11,0,431
21,3623,5811,596,3027,2098,1136,228,161,1303,1621,608,91,3465,158,2045,253,544,781,94,156,2619,995,1947,220,10,0,210
22,1213,1963,93,1120,685,390,73,65,261,743,185,24,1096,117,117,158,250,688,48,74,1010,378,453,35,0,0,35
23,644,1281,320,324,274,239,66,65,138,395,98,13,582,62,184,93,84,283,63,130,387,332,369,23,0,0,23
24,490,868,50,440,259,131,57,43,225,161,99,5,383,107,402,38,0,50,21,69,153,244,381,11,0,0,11
25,1603,3597,38,1565,522,547,274,260,538,729,242,94,1215,388,1161,246,142,54,111,440,925,1017,1104,14,0,0,14
26,750,1594,21,729,316,216,100,118,169,378,162,41,658,92,458,139,115,38,36,153,559,433,413,9,0,0,9
27,1525,3077,165,1360,707,444,187,187,479,709,211,126,1360,165,887,266,162,210,75,254,1036,690,1022,39,0,0,39
28,1968,3451,453,1515,938,698,188,144,421,859,642,46,1801,167,385,347,409,827,94,128,1665,744,820,13,0,0,13
29,3245,5028,424,2821,1950,1003,187,105,558,1760,912,15,3031,214,986,864,663,732,79,152,3057,1059,681,97,79,0,18
30,3945,7012,209,3736,2340,1047,250,308,1193,2080,590,82,3560,385,2177,909,404,455,159,499,3591,1813,950,340,0,0,340
31,2725,4282,137,2588,1693,760,146,126,523,1448,696,58,2663,62,1035,819,432,439,78,200,2538,952,514,134,14,0,120
32,3281,5511,311,2970,1809,1037,259,176,530,1638,924,189,3130,151,811,882,821,767,116,177,3072,1138,1008,47,0,0,47
33,2816,5458,459,2357,1263,970,330,253,616,988,1101,111,2579,237,958,461,507,890,170,241,3193,1016,838,23,0,0,23
34,2650,4684,515,2135,1242,989,258,161,428,1036,772,414,2526,124,571,311,598,1170,144,195,2717,820,808,0,0,0,0
35,2372,4587,547,1825,1025,857,275,215,432,798,892,250,2273,99,766,349,271,986,132,243,2364,891,957,0,0,0,0
36,2631,5581,168,2463,1012,928,415,276,889,1183,407,152,2301,330,1776,462,158,235,147,485,1870,1522,1557,93,0,0,93
37,1818,3565,161,1657,876,581,204,157,345,989,344,140,1645,173,870,351,268,329,69,217,1718,864,697,48,0,0,48
38,2373,4468,702,1671,990,890,296,197,465,1140,693,75,1964,409,516,354,279,1224,116,277,2281,1001,793,14,0,0,14
39,2072,4096,528,1544,812,778,325,157,345,949,624,154,1838,234,417,324,434,897,118,232,2147,875,724,1,0,0,1
40,2602,4556,794,1808,1188,1014,237,163,365,1212,962,63,2408,194,363,273,677,1289,145,233,2421,896,861,25,0,0,25
41,2134,4016,387,1747,1001,745,216,172,634,1007,425,68,1785,349,1008,332,329,465,114,274,1892,849,887,88,0,0,88
42,645,2741,3,642,114,189,141,201,78,167,132,268,509,136,222,127,94,202,93,350,1295,751,252,639,0,68,571
43,3192,5652,646,2546,1553,1056,296,287,414,1609,1098,71,2754,438,406,366,781,1639,293,383,3344,1012,620,14,0,0,14
44,3685,6519,609,3076,1791,1316,371,207,371,1559,1471,284,3234,451,406,528,644,2107,223,269,4314,1000,713,34,34,0,0
45,2470,4563,604,1866,1080,916,258,216,202,1361,646,261,2079,391,345,186,554,1385,195,277,2688,780,623,12,0,0,12
46,4052,7157,820,3232,1869,1559,380,244,614,2089,1087,262,3606,446,527,526,669,2330,313,308,4113,1361,1062,112,84,0,28
47,1723,2921,443,1280,919,558,115,131,227,1096,398,2,1599,124,271,294,346,812,106,209,1521,586,499,18,0,0,18
48,2004,3864,664,1340,824,737,223,220,272,1115,595,22,1748,256,287,158,540,1019,178,355,1974,793,564,12,0,0,12
49,2265,4478,862,1403,981,778,252,254,466,1188,554,57,2079,186,282,289,456,1238,196,498,1812,1103,869,18,9,0,9
50,2423,4657,701,1722,1084,832,256,251,271,1127,906,119,1924,499,228,258,284,1653,208,353,2523,893,680,40,0,0,40
51,2088,3780,523,1565,1006,735,188,159,239,937,867,45,1882,206,245,270,325,1248,170,273,2061,784,492,0,0,0,0
52,1358,3701,14,1344,335,324,299,400,125,429,583,221,863,495,74,220,182,882,200,625,1897,776,203,0,0,0,0
53,33,285,0,33,16,7,7,3,0,25,8,0,33,0,13,0,16,4,3,15,163,76,28,215,0,0,215
54,2800,6829,1376,1424,866,909,477,548,758,752,937,353,2142,658,732,590,478,1000,256,753,2471,1848,1501,90,0,0,90
55,1539,3595,711,828,474,549,239,277,342,630,476,91,1273,266,375,366,272,526,132,396,1261,1008,798,0,0,0,0
56,50,110,27,23,16,19,8,7,11,21,15,3,41,9,5,11,7,27,2,8,22,22,56,0,0,0,0
57,946,2440,708,238,222,314,157,253,162,298,393,93,634,312,99,74,160,613,112,456,561,736,575,0,0,0,0
58,2455,5513,622,1833,823,838,410,384,564,949,750,192,1942,513,740,538,536,641,219,564,2278,1339,1113,54,0,0,54
59,3179,7938,1306,1873,881,1041,564,693,537,1113,1065,464,2408,771,658,586,629,1306,320,945,3037,2092,1544,21,0,0,21
60,1567,3835,636,931,469,499,241,358,327,569,555,116,1197,370,310,455,279,523,131,443,1454,988,819,6,0,0,6
61,1883,4448,579,1304,573,654,305,351,340,740,699,104,1419,464,522,371,368,622,187,454,1981,1027,799,0,0,0,0
62,3225,7408,983,2242,998,1109,566,552,591,1222,1284,128,2493,732,619,637,824,1145,352,908,3053,1783,1312,13,0,0,13
63,2169,5318,900,1269,595,727,422,425,307,684,1064,114,1560,609,292,305,590,982,251,614,2065,1304,1084,16,0,0,16
64,2863,6793,1019,1844,811,982,520,550,423,1112,1166,162,2169,694,622,541,418,1282,271,744,2990,1615,1173,14,0,0,14
65,2442,5556,700,1742,818,832,419,373,366,925,989,162,1937,505,289,569,340,1244,225,640,2440,1309,942,71,0,0,71
66,2004,4386,553,1451,663,718,285,338,330,576,719,379,1524,480,406,405,425,768,162,443,1993,993,795,0,0,0,0
67,2142,5063,620,1522,677,731,346,388,332,713,834,263,1591,551,301,395,416,1030,209,491,2497,1070,796,100,89,0,11
68,1466,3284,452,1014,468,524,263,211,392,579,326,169,1291,175,486,296,208,476,118,309,1580,669,608,31,0,0,31
69,2690,8209,818,1872,890,933,433,434,290,847,1102,451,2144,546,307,439,619,1325,270,1794,4251,1138,756,2264,2141,0,123
70,2893,6093,840,2053,998,1105,409,381,414,1111,1056,312,2377,516,490,403,588,1412,311,607,2970,1326,879,6,0,0,6
71,1942,4351,879,1063,695,614,248,385,416,947,473,106,1448,494,505,200,294,943,263,690,1515,1005,878,19,0,0,19
72,1105,2286,420,685,423,395,162,125,174,455,326,150,932,173,146,230,177,552,93,163,1254,434,342,27,0,0,27
73,2434,4101,520,1914,1276,772,196,190,678,920,533,303,2160,274,762,414,451,807,153,186,2034,787,941,0,0,0,0
74,2163,3708,170,1993,1218,626,158,161,1014,690,356,103,2096,67,928,216,396,623,85,195,1546,588,1294,54,0,0,54
75,1966,3076,564,1402,1142,620,116,88,505,945,457,59,1885,81,394,385,312,875,81,63,1647,483,802,16,0,0,16
76,1699,2978,403,1296,952,570,93,84,385,999,304,11,1699,0,524,264,513,398,55,85,1402,696,740,373,0,0,373
77,2134,4567,562,1572,816,764,341,213,416,900,604,214,1747,387,753,274,386,721,144,362,2304,772,985,237,0,0,237
78,2881,5677,207,2674,1358,884,289,350,1516,843,309,213,2626,255,1803,512,336,230,180,616,1996,1203,1682,40,0,0,40
79,2168,3569,295,1873,1234,644,163,127,183,1147,683,155,2101,67,345,464,262,1097,102,162,2186,768,351,67,1,0,66
80,1999,4309,354,1645,850,652,279,218,318,814,718,149,1755,244,543,323,378,755,152,343,2525,848,441,58,0,0,58
81,4203,8098,769,3434,1953,1437,458,355,384,1959,1484,376,3843,360,878,860,658,1807,296,479,4822,1799,702,225,0,0,225
82,1780,3429,486,1294,720,679,229,152,294,868,498,120,1577,203,462,321,182,815,94,201,1912,890,332,30,0,0,30
83,2112,3977,1015,1097,817,900,214,181,276,822,950,64,1845,267,263,162,269,1418,173,223,1713,1234,634,20,0,0,20
84,2324,4850,657,1667,861,912,289,262,160,587,1251,326,2038,286,241,249,347,1487,155,331,2872,1086,406,64,0,0,64
85,1860,3775,336,1524,714,722,257,167,135,757,713,255,1567,293,217,219,375,1049,118,176,2431,656,394,28,0,0,28
86,3300,6920,731,2569,1320,1141,414,425,496,1366,1223,215,2889,411,691,644,664,1301,274,646,3628,1451,921,105,0,0,105
87,2377,5141,584,1793,862,862,347,306,309,951,915,202,2040,337,405,330,490,1152,242,437,2879,944,639,144,24,0,120
88,2578,5500,491,2087,898,1006,354,320,211,1092,961,314,2355,223,419,379,517,1263,186,290,3586,952,486,91,19,0,72
89,3491,7710,1306,2185,1173,1312,489,517,408,1283,1561,239,2788,703,376,633,667,1815,405,804,3742,1781,978,138,0,0,138
90,2094,4606,608,1486,728,702,356,308,219,933,760,182,1832,262,259,474,768,593,209,305,2629,902,561,167,110,0,57
91,2314,5517,977,1337,733,868,326,387,446,1046,726,96,1871,443,447,260,303,1304,263,588,2680,1215,771,488,474,0,14
92,1024,2494,735,289,287,309,144,284,223,268,421,112,754,270,211,130,155,528,100,314,593,770,717,19,0,0,19
93,4210,7896,1501,2709,1660,1754,439,357,641,1845,1387,337,3847,363,703,786,889,1832,272,478,3663,2429,1054,6,0,0,6
94,1329,2661,588,741,461,546,204,118,189,502,559,79,1060,269,209,165,183,772,92,210,1177,803,379,14,0,0,14
95,1420,3024,766,654,475,550,198,197,227,571,572,50,1169,251,195,194,289,742,178,330,1224,842,450,10,0,0,10
96,1148,2570,619,529,343,398,184,223,110,502,504,32,870,278,85,208,237,618,177,302,1031,712,348,16,0,0,16
97,1609,3414,699,910,500,629,233,247,248,650,621,90,1326,283,245,194,227,943,203,309,1607,825,470,0,0,0,0
98,1902,4123,838,1064,597,726,301,278,231,838,714,119,1557,345,220,277,294,1111,206,414,1886,1014,603,0,0,0,0
99,2035,4226,502,1533,815,756,250,214,416,872,564,183,1772,263,432,325,389,889,173,261,2369,945,478,116,0,0,116
100,1827,4309,313,1514,664,598,251,314,199,750,700,178,1460,367,458,446,204,719,145,369,2325,1023,447,83,27,0,56
101,2959,6781,486,2473,1174,910,380,495,550,925,1059,425,2528,431,772,676,586,925,244,625,3682,1496,734,49,0,0,49
102,2713,5524,676,2037,1080,983,362,288,258,1013,1274,168,2377,336,436,334,553,1390,221,391,2980,1315,617,129,0,0,129
103,2729,5194,948,1781,1074,1111,310,234,574,910,947,298,2545,184,571,459,372,1327,171,300,2547,1491,685,32,0,0,32
104,1901,3635,459,1442,796,752,209,144,238,1075,513,75,1759,142,327,250,350,974,132,171,2063,877,392,23,0,0,23
105,3229,6382,545,2684,1474,1052,376,327,499,1162,1278,290,2859,370,801,512,513,1403,195,455,3323,1499,910,120,0,0,120
106,3224,6943,559,2665,1647,913,296,368,549,1116,1132,427,3004,220,911,529,697,1087,179,539,3549,1859,817,730,0,0,730
107,893,2850,217,676,310,305,122,156,56,443,328,66,737,156,202,143,184,364,80,219,1596,708,247,735,0,0,735
108,1260,2743,268,992,482,478,142,158,271,336,603,50,1117,143,455,145,91,569,105,327,1626,494,191,221,169,0,52
109,3527,7272,1121,2406,1189,1532,474,332,284,1382,1338,523,2920,607,756,402,274,2095,266,410,4764,1196,636,357,142,0,215
110,2998,7470,632,2366,866,1312,426,394,218,940,1789,51,2403,595,572,271,518,1637,529,611,5200,849,281,872,851,0,21
111,2383,5016,589,1794,890,1043,270,180,47,1058,1239,39,2069,314,123,203,518,1539,190,190,3788,695,153,577,553,0,24
112,1035,2201,407,628,333,407,144,151,104,442,355,134,879,156,189,127,125,594,90,179,1188,488,256,8,0,0,8
113,2484,5837,1089,1395,711,924,437,412,500,1063,795,126,2010,474,547,278,456,1203,284,768,2906,1310,569,22,0,0,22
114,1753,3807,881,872,543,686,270,254,206,613,809,125,1379,374,218,239,221,1075,226,308,1890,943,440,62,0,0,62
115,675,1840,181,494,174,239,119,143,46,312,219,98,545,130,101,206,77,291,72,152,872,511,233,131,0,0,131
116,1875,4971,717,1158,525,627,324,399,211,695,689,280,1416,459,341,343,317,874,195,586,2473,1211,506,187,0,0,187
117,1588,4369,495,1093,375,509,304,400,103,641,563,281,1114,474,250,229,398,711,192,507,2283,941,446,28,0,0,28
118,1431,4288,287,1144,311,425,266,429,151,423,618,239,960,471,464,303,290,374,176,606,2175,911,420,22,0,0,22
119,786,2290,293,493,141,253,175,217,100,209,326,151,618,168,165,90,124,407,80,259,1099,559,293,17,0,0,17
120,1126,3016,402,724,280,367,228,251,140,310,515,161,936,190,263,227,50,586,127,305,1489,735,360,35,0,0,35
121,1306,3374,850,456,301,460,250,295,152,538,551,65,922,384,161,357,277,511,211,370,1389,869,535,60,0,0,60
122,2098,5180,1281,817,495,785,423,395,425,669,822,182,1579,519,525,382,256,935,272,648,2011,1472,777,26,0,0,26
123,1748,4227,752,996,452,627,345,324,148,683,696,221,1380,368,222,309,439,778,224,458,1990,1075,480,23,0,0,23
124,1269,3341,566,703,351,378,239,301,98,436,667,68,803,466,223,298,173,575,176,490,1382,827,466,34,0,0,34
125,1039,2878,739,300,221,359,199,260,121,350,436,132,795,244,219,136,227,457,163,386,1041,831,457,6,0,0,6
126,1520,4502,784,736,294,485,301,440,187,483,589,261,854,666,338,234,234,714,245,690,1760,1129,678,0,0,0,0
127,1766,4103,1077,689,511,612,295,348,254,516,761,235,1428,338,154,222,307,1083,268,530,1498,1114,693,7,0,0,7
128,2474,5451,1003,1471,790,870,417,397,191,1015,1104,164,1918,556,230,376,530,1338,331,587,2576,1278,679,24,0,0,24
129,2105,4416,1255,850,751,732,304,318,263,996,749,97,1689,416,173,211,463,1258,228,478,1630,1261,819,0,0,0,0
130,1840,4235,1257,583,595,604,291,350,366,750,664,60,1297,543,458,293,304,785,192,615,1209,1224,995,0,0,0,0
131,2638,6780,2184,454,541,953,492,652,642,752,1122,122,1859,779,395,539,474,1230,381,1075,1819,2061,1444,0,0,0,0
132,1551,4205,1036,515,319,509,311,412,336,421,508,286,1148,403,320,254,297,680,180,609,1362,1221,833,0,0,0,0
133,2455,6324,1566,889,563,866,465,561,353,651,1076,375,1921,534,363,308,522,1262,326,725,2356,1739,1178,13,0,0,13
134,2488,8046,1514,974,439,697,461,891,305,886,649,648,1639,849,359,466,640,1023,327,1157,2880,2222,1460,46,0,0,46
135,1567,5570,793,774,251,370,302,644,159,518,510,380,1089,478,349,362,399,457,196,861,2066,1498,949,0,0,0,0
136,966,3036,680,286,190,240,185,351,130,249,365,222,754,212,196,187,188,395,108,373,1065,853,637,11,0,0,11
137,1571,5440,1076,495,262,425,280,604,140,393,730,308,1077,494,361,382,340,488,213,723,1908,1509,1087,20,0,0,20
138,2627,9295,1455,1172,434,603,484,1106,328,793,945,561,1969,658,547,718,651,711,362,1305,3252,2603,1773,32,0,0,32
139,1323,5428,901,422,206,276,228,613,263,256,297,507,839,484,340,463,311,209,239,811,1789,1556,1033,37,0,0,37
140,1192,4156,782,410,224,327,189,452,230,270,370,322,882,310,336,278,222,356,196,640,1462,1167,691,0,0,0,0
141,765,2740,261,504,188,215,102,260,109,259,216,181,478,287,170,211,173,211,152,513,1060,690,325,57,0,0,57
142,273,1187,32,241,95,103,45,30,85,82,93,13,200,73,105,51,43,74,38,83,597,385,84,566,0,0,566
143,437,1438,212,225,126,123,72,116,62,149,123,103,274,163,167,121,94,55,88,193,520,381,256,29,0,0,29
144,1500,4156,447,1053,408,413,325,354,354,716,301,129,1006,494,901,252,170,177,258,824,1501,1005,568,23,0,0,23
145,1369,4148,110,1259,376,340,237,416,379,689,172,129,750,619,1025,303,38,3,276,1217,1459,833,363,20,0,0,20
146,552,1344,323,229,149,190,99,114,64,271,201,16,358,194,104,106,151,191,98,184,647,296,119,0,0,0,0
147,1311,5002,699,612,239,325,283,464,213,268,455,375,866,445,331,296,300,384,301,927,1954,1231,589,185,0,0,185
148,1132,4122,398,734,222,229,262,419,228,492,135,277,602,530,507,136,252,237,238,872,1542,1004,466,22,0,0,22
149,1606,5059,933,673,326,470,301,509,235,521,573,277,1113,493,440,391,252,523,276,821,1961,1317,684,110,0,0,110
150,1374,4382,608,766,353,349,197,475,317,403,392,262,940,434,542,301,337,194,239,674,1548,1100,821,106,0,0,106
151,620,2036,303,317,169,114,93,244,165,109,244,102,468,152,272,84,114,150,95,271,756,570,344,18,0,0,18
152,1395,4467,1004,391,282,358,231,524,230,426,457,282,1072,323,260,255,320,560,191,553,1511,1266,946,37,0,0,37
153,1087,4000,751,336,159,243,229,456,138,279,351,319,780,307,227,309,230,321,185,577,1351,1178,709,0,0,0,0
154,1064,4027,618,446,156,211,210,487,178,338,383,165,873,191,291,287,252,234,156,579,1293,1220,779,11,0,0,11
155,1019,3966,610,409,124,228,207,460,144,350,264,261,606,413,232,333,208,246,190,653,1282,1073,768,12,0,0,12
156,742,3109,353,389,89,149,160,344,78,230,202,232,491,251,222,227,160,133,139,554,1109,869,438,0,0,0,0
157,711,2564,194,517,105,188,152,266,189,291,107,124,406,305,427,130,77,77,138,641,883,603,299,0,0,0,0
158,386,1055,77,309,105,107,57,117,161,107,59,59,283,103,265,53,17,51,48,234,334,227,212,1,0,0,1
159,1438,4774,942,496,229,341,312,556,331,359,502,246,1085,353,375,456,340,267,178,683,1621,1349,943,26,0,0,26
160,1365,4905,902,463,202,330,269,564,104,522,498,241,890,475,153,586,305,321,181,769,1730,1357,868,0,0,0,0
161,1167,4175,693,474,173,298,208,488,119,268,478,302,842,325,206,371,223,367,159,626,1480,1170,740,6,0,0,6
162,1320,4775,765,555,211,296,236,577,250,399,485,186,929,391,351,452,309,208,181,655,1640,1318,981,17,0,0,17
163,1231,4462,788,443,199,311,240,481,181,313,361,376,786,445,207,438,209,377,177,651,1524,1240,870,4,0,0,4
164,1964,7543,1184,780,289,448,367,860,214,532,609,609,1366,598,383,441,504,636,335,1126,2628,2116,1338,32,0,0,32
165,1944,6818,1079,865,325,468,341,810,207,569,746,422,1318,626,462,499,420,563,310,900,2497,1862,1249,0,0,0,0
166,2712,9135,1571,1141,492,712,436,1072,288,929,909,586,2044,668,756,610,553,793,340,1177,3642,2353,1623,35,0,0,35
167,1925,7282,1247,678,309,454,367,795,179,481,679,586,1139,786,426,438,460,601,338,1052,2904,1814,1174,60,0,0,60
168,3059,9488,2026,1033,630,838,531,1060,440,1213,846,560,2465,594,627,774,831,827,375,1175,3745,2484,1709,36,0,0,36
169,2301,6684,1996,305,378,747,470,706,338,873,799,291,1527,774,339,524,300,1138,275,1032,1807,1919,1651,18,11,0,7
170,2177,5912,1631,546,469,712,405,591,444,681,792,260,1543,634,298,351,379,1149,257,958,1629,1700,1368,41,0,0,41
171,916,2449,761,155,188,301,171,256,114,352,376,74,693,223,59,95,182,580,117,407,661,748,516,12,0,0,12
172,1959,5322,1450,509,389,671,351,548,663,548,557,191,1556,403,287,406,459,807,245,788,1571,1510,1208,0,0,0,0
173,1379,3644,974,405,284,450,265,380,239,435,497,208,1057,322,188,228,239,724,139,494,1175,1009,827,0,0,0,0
174,2438,6037,1300,1138,601,833,460,544,437,1011,795,195,1892,546,535,334,380,1189,290,685,2511,1416,1135,14,0,0,14
175,2127,4521,455,1672,757,743,305,322,312,915,785,115,1771,356,272,476,483,896,184,351,2520,844,622,12,0,0,12
176,1874,4000,484,1390,647,686,273,268,349,844,546,135,1450,424,492,336,430,616,167,308,1980,901,644,55,43,0,12
177,3310,8727,1391,1919,879,974,654,803,471,1223,1205,411,2579,731,584,648,741,1337,356,934,3675,2073,1689,129,0,0,129
178,2389,6492,1437,952,504,757,466,662,403,945,665,376,1910,479,546,477,434,932,289,729,2378,1672,1424,16,0,0,16
179,2732,7827,1537,1195,519,811,544,858,477,868,924,463,1943,789,496,704,474,1058,337,952,2973,2083,1482,7,0,0,7
180,1770,4366,575,1195,512,572,303,383,203,711,559,297,1276,494,497,440,370,463,182,473,1960,1049,702,4,0,0,4
181,1913,5304,1113,800,414,572,387,540,304,596,722,291,1454,459,396,360,482,675,261,660,2034,1360,989,0,0,0,0
182,2404,6716,1474,930,542,759,479,624,470,870,672,392,1574,830,460,371,587,986,288,822,2408,1820,1378,17,0,0,17
183,2499,7382,1589,910,466,731,511,791,528,657,884,430,1804,695,650,304,615,930,328,970,2579,1943,1562,24,0,0,24
184,3047,8878,2058,989,553,890,624,980,608,991,883,565,2318,729,568,654,692,1133,355,1111,3049,2316,2047,8,0,0,8
185,2905,8249,1663,1242,629,858,543,875,638,909,717,641,2293,612,680,647,591,987,309,980,3060,2121,1779,7,0,0,7
186,2707,7915,1835,872,523,812,511,861,433,1001,822,451,1964,743,341,631,534,1201,292,1103,2669,2098,1753,29,0,0,29
187,1436,4022,1150,286,281,424,278,453,338,416,483,199,953,483,308,242,223,663,130,666,1085,1202,939,0,0,0,0
188,544,1868,14,530,210,165,79,90,59,213,116,156,492,52,261,84,123,76,32,488,917,218,213,628,576,0,52
189,3183,7742,127,3056,948,1024,617,594,805,1538,435,405,2812,371,1375,609,571,628,354,1068,3561,1600,1159,0,0,0,0
190,1323,2365,240,1083,670,362,140,151,315,730,200,78,1055,268,356,412,318,237,83,208,1022,581,471,42,0,0,42
191,1440,4068,1075,365,273,458,303,406,350,386,540,164,1073,367,277,350,294,519,202,536,1366,1136,828,13,0,0,13
192,2654,7702,162,2492,518,749,592,795,232,984,865,573,1697,957,847,920,670,217,426,1237,3681,1636,722,10,0,0,10
193,2169,6849,1158,1011,364,562,426,817,231,650,902,386,1313,856,406,520,584,659,362,1068,2527,1815,1077,77,0,0,77
194,2004,7254,1201,803,328,514,375,787,371,513,623,497,1495,509,362,549,550,543,276,966,2507,1960,1545,195,0,0,195
195,1786,5638,1251,535,324,462,356,644,207,510,599,470,1323,463,235,358,480,713,249,796,1893,1607,1093,9,0,0,9
196,1921,6512,1463,458,295,500,365,761,214,480,853,374,1361,560,206,610,459,646,290,896,2391,1758,1177,7,0,0,7
197,1559,5939,1049,510,230,369,256,704,194,385,378,602,1157,402,347,272,310,630,222,823,2065,1617,1212,18,0,0,18
198,1691,5091,266,1425,372,418,338,563,158,514,692,327,1216,475,575,380,388,348,231,817,2105,1149,789,0,0,0,0
199,1155,2510,763,392,407,339,171,238,62,549,470,74,987,168,150,370,401,234,100,264,1001,749,396,1,0,0,1
200,968,2873,660,308,222,227,156,363,128,365,318,157,708,260,214,321,241,192,130,434,867,853,589,26,26,0,0
201,2796,8672,789,2007,570,707,482,1037,434,736,1222,404,1681,1115,1121,590,715,370,416,1508,3373,2068,1307,36,0,0,36
202,2242,7702,1385,857,343,577,445,877,393,543,657,649,1612,630,427,645,517,653,365,1152,2952,1948,1285,20,0,0,20
203,1565,5503,738,827,234,400,266,665,168,585,375,437,1162,403,350,468,441,306,266,895,2116,1444,782,0,0,0,0
204,2178,7898,1021,1157,362,492,395,929,335,503,1007,333,1685,493,718,406,564,490,347,1167,3151,1938,1295,59,0,0,59
205,2418,8334,1696,722,415,590,406,1007,363,661,556,838,1845,573,450,443,806,719,386,1178,3042,2331,1397,13,0,0,13
206,1221,3844,926,295,200,342,264,415,328,223,389,281,905,316,277,183,263,498,160,552,1333,1122,677,0,0,0,0
207,1177,4387,664,513,167,254,226,530,137,288,413,339,757,420,336,276,263,302,206,768,1561,1168,684,0,0,0,0
208,2210,5513,1416,794,541,708,381,580,500,737,844,129,1664,546,439,430,386,955,320,787,1897,1643,866,14,0,0,14
209,2565,7845,1870,695,478,693,507,887,279,916,1025,345,1849,716,299,660,636,970,378,1141,2705,2189,1432,19,0,0,19
210,1059,3911,310,749,155,199,211,494,150,324,314,271,632,427,344,310,247,158,243,855,1548,874,391,0,0,0,0
211,2902,8849,433,2469,670,830,439,963,409,1175,827,491,1926,976,780,1157,398,567,472,1572,3702,2028,1075,84,0,0,84
212,1245,4258,691,554,193,301,233,518,98,417,346,384,793,452,307,143,282,513,181,793,1465,1197,622,25,0,0,25
213,2689,6973,1499,1190,804,771,479,635,657,638,1047,347,2114,575,590,610,684,805,331,959,2154,1874,1655,31,0,0,31
214,2052,6411,1581,471,342,586,410,714,284,539,964,265,1565,487,352,526,573,601,353,978,2065,1817,1198,62,0,0,62
215,2176,6232,845,1331,446,615,422,693,273,815,900,188,1527,649,432,595,590,559,319,991,2419,1600,903,12,0,0,12
216,1511,3797,867,644,437,486,249,339,174,553,676,108,1091,420,342,302,414,453,194,464,1529,997,613,7,0,0,7
217,1337,4269,1105,232,187,417,281,452,162,288,677,210,836,501,133,223,365,616,224,626,1407,1177,835,64,0,0,64
218,1363,4148,783,580,280,404,204,475,290,379,408,286,1028,335,405,350,221,387,202,551,1476,1058,861,18,0,0,18
219,1929,6948,1428,501,228,487,362,852,329,573,569,458,1409,520,363,382,452,732,315,918,2410,1712,1593,11,0,0,11
220,1892,6037,1131,761,301,559,341,691,177,618,751,346,1247,645,385,343,524,640,330,1076,2238,1561,832,20,0,0,20
221,1526,4741,1061,465,284,434,316,492,232,331,671,292,1011,515,295,220,372,639,228,755,1670,1254,834,0,0,0,0
222,1787,4461,934,853,476,624,316,371,251,670,574,292,1303,484,308,414,397,668,214,558,1772,1256,661,12,0,0,12
223,1949,4630,928,1021,561,724,317,347,191,897,703,158,1592,357,340,452,475,682,225,605,1699,1327,774,31,0,0,31
224,1282,3376,1067,215,227,449,253,353,146,546,416,174,907,375,175,194,223,690,171,556,882,1091,676,0,0,0,0
225,1444,3967,1091,353,241,482,287,434,275,583,456,130,1044,400,246,309,325,564,242,682,1168,1208,667,0,0,0,0
226,2430,6555,1922,508,436,840,494,660,433,737,949,311,1794,636,258,592,658,922,328,1099,1841,1953,1334,14,0,0,14
227,2117,5601,1649,468,474,686,415,542,669,533,707,208,1405,712,305,571,439,802,259,909,1439,1545,1449,0,0,0,0
228,74,253,60,14,6,16,21,31,8,22,28,16,47,27,4,2,25,43,8,39,96,78,32,1,0,0,1
229,1864,5692,1202,662,255,580,398,631,198,547,711,408,1170,694,198,243,452,971,257,922,2077,1548,888,24,0,0,24
230,2894,8934,1988,906,506,776,584,1028,451,785,1154,504,2024,870,547,533,558,1256,483,1271,3227,2344,1609,10,0,0,10
231,1505,5185,1249,256,183,424,314,584,199,445,474,387,1106,399,261,224,327,693,225,762,1736,1310,1152,73,0,0,73
232,1817,5689,1421,396,284,545,377,611,384,552,632,249,1257,560,412,392,388,625,250,870,1835,1585,1149,128,0,0,128
233,3246,7612,2253,993,1004,1013,505,724,554,1395,1132,165,2396,850,525,834,835,1052,415,1005,2562,2160,1470,7,0,0,7
234,1936,3590,479,1457,823,706,223,184,256,951,597,132,1583,353,535,419,474,508,139,247,1933,699,572,0,0,0,0
235,1169,3338,909,260,226,363,178,402,211,274,523,161,788,381,182,220,280,487,199,541,1083,937,578,13,0,0,13
236,2213,5708,1212,1001,600,691,336,586,531,515,1008,159,1597,616,333,638,476,766,271,866,2072,1528,971,42,0,0,42
237,2633,8144,734,1899,513,700,532,888,224,888,786,735,1715,918,709,628,757,539,441,1474,3324,2023,882,31,0,0,31
238,1128,4227,651,477,184,235,216,493,125,183,472,348,612,516,123,308,314,383,221,777,1632,1086,511,0,0,0,0
239,0,0,0,0,0,0,0,0,0,0,0,0,0,0,0,0,0,0,0,0,0,0,0,0,0,0,0
240,1899,5190,692,1207,417,606,366,510,240,791,644,224,1317,582,480,328,504,587,296,808,1991,1325,770,42,0,0,42
241,1308,3653,979,329,298,366,223,421,307,430,402,169,803,505,282,200,295,531,167,649,919,1018,900,24,0,0,24
242,952,2828,837,115,152,274,191,335,254,157,376,165,662,290,149,160,203,440,135,528,714,810,641,0,0,0,0
243,984,2899,785,199,154,293,214,323,140,287,454,103,695,289,169,100,147,568,111,461,814,855,658,9,0,0,9
244,1903,5240,799,1104,416,544,365,578,381,450,829,243,1316,587,442,296,428,737,243,907,1694,1482,914,20,0,0,20
245,1281,3487,952,329,266,394,217,404,359,438,392,92,884,397,297,357,190,437,164,574,989,978,782,26,0,0,26
246,2939,8224,1781,1158,589,889,540,921,524,913,1255,247,1948,991,509,482,394,1554,394,1678,2183,2219,1750,130,0,0,130
247,1309,3870,994,315,197,353,247,512,297,444,504,64,875,434,184,170,287,668,208,948,916,1182,616,10,0,0,10
248,1404,3363,530,874,445,425,196,338,194,531,605,74,893,511,275,268,327,534,176,619,1221,927,420,77,0,0,77
249,2539,6278,1055,1484,710,857,389,583,245,1170,904,220,1821,718,355,378,686,1120,335,1163,2342,1609,829,14,0,0,14
250,1941,5014,1043,898,491,584,332,534,287,845,690,119,1146,795,302,301,404,934,290,1032,1550,1334,808,49,0,0,49
251,2757,5529,710,2047,1132,930,282,413,377,1375,906,99,2194,563,544,696,491,1026,294,727,2315,1345,848,5,0,0,5
252,1923,5924,1759,164,221,651,289,762,260,767,741,155,1012,911,210,146,169,1398,209,1434,1141,1767,1373,11,0,0,11
253,976,2588,736,240,169,384,155,268,232,284,374,86,678,298,126,90,267,493,79,508,643,795,563,0,0,0,0
254,1878,5785,1749,129,198,610,333,737,339,588,736,215,1184,694,84,258,218,1318,201,1319,1112,1830,1323,0,0,0,0
255,1286,3536,1073,213,224,443,206,413,287,446,467,86,812,474,167,112,247,760,166,806,764,1062,738,2,0,0,2
256,2488,4996,834,1654,1001,898,276,313,624,1041,819,4,1994,494,661,432,305,1090,245,566,1976,1067,1142,10,0,0,10
257,1766,3967,780,986,745,535,205,281,533,596,545,92,1416,350,374,448,314,630,237,470,1507,876,877,150,0,0,150
258,2892,6553,736,2156,1069,960,379,484,422,1135,1146,189,2302,590,767,582,731,812,346,839,2901,1508,959,119,0,0,119
259,2218,5410,919,1299,784,617,344,473,296,1118,571,233,1653,565,569,540,531,578,347,835,2255,1254,719,17,0,0,17
260,2470,8439,821,1649,476,710,431,853,283,790,979,418,1519,951,763,538,432,737,510,1595,3734,1724,876,51,0,0,51
261,1400,4411,834,566,243,376,307,474,177,343,642,238,825,575,290,235,481,394,291,837,1683,1044,556,8,0,0,8
262,1202,3997,709,493,211,381,214,396,98,572,263,269,941,261,290,187,288,437,206,658,1528,1063,542,90,0,0,90
263,803,2955,626,177,92,215,160,336,129,226,234,214,507,296,157,103,239,304,158,470,1035,828,464,122,0,0,122
264,1037,3251,846,191,159,299,203,376,171,284,462,120,730,307,155,153,206,523,156,565,992,948,590,76,0,0,76
265,1822,3543,924,898,743,616,253,210,272,1061,466,23,1480,342,366,412,441,603,207,300,1532,839,665,0,0,0,0
266,3032,7109,1135,1897,834,1086,520,592,456,1236,1112,228,2031,1001,583,345,504,1600,418,1039,2830,1430,1392,121,0,0,121
267,1314,3763,791,523,200,391,285,438,266,473,507,68,805,509,177,164,320,653,194,722,1193,979,675,48,0,0,48
268,1291,3656,773,518,224,360,279,428,184,405,573,129,795,496,52,227,247,765,191,751,1193,926,595,0,0,0,0
269,1605,4071,697,908,372,512,291,430,183,769,573,80,1109,496,200,233,370,802,225,705,1603,959,579,4,0,0,4
270,1281,3196,708,573,317,405,267,292,186,594,441,60,836,445,161,182,272,666,183,525,1200,714,574,0,0,0,0
271,2088,5618,1277,811,385,686,446,571,365,899,734,90,1286,802,299,277,458,1054,342,994,1998,1318,966,47,0,0,47
272,780,2330,621,159,105,253,154,268,143,208,365,64,500,280,44,133,140,463,108,481,568,671,502,3,0,0,3
273,1592,4275,855,737,274,557,322,439,192,607,735,58,984,608,220,247,400,725,266,731,1533,1127,618,0,0,0,0
274,2142,5696,744,1398,568,736,357,481,286,841,768,247,1745,397,381,384,539,838,330,814,2757,1155,640,0,0,0,0
275,1877,4799,730,1147,458,624,342,453,367,609,778,123,1387,490,505,279,374,719,303,711,2122,1112,551,12,0,0,12
276,1234,2839,596,638,357,447,165,265,233,323,589,89,973,261,235,207,378,414,148,348,1249,646,448,3,0,0,3
277,1750,4983,1091,659,320,537,381,512,189,510,742,309,1080,670,266,222,498,764,304,864,1843,1328,644,75,0,0,75
278,2540,6561,947,1593,540,956,513,531,150,1048,1282,60,1755,785,296,387,483,1374,545,960,3212,1351,493,177,0,0,177
279,1745,4553,870,875,387,602,321,435,211,887,601,46,1244,501,278,521,363,583,299,767,1820,1121,546,19,0,0,19
280,1349,3507,722,627,300,435,249,365,216,477,528,128,919,430,107,248,255,739,202,620,1151,1028,506,0,0,0,0
281,2052,4837,903,1149,668,630,309,445,393,713,838,108,1613,439,573,243,423,813,256,685,1725,1238,933,61,0,0,61
282,986,2594,746,240,247,284,148,307,192,331,371,92,643,343,154,166,180,486,151,523,636,753,531,0,0,0,0
283,1321,3592,1107,214,241,459,235,386,175,358,546,242,859,462,166,196,115,844,206,597,937,1051,801,47,0,0,47
284,1774,4948,364,1410,426,541,313,494,175,767,622,210,1282,492,356,436,424,558,344,788,2160,1057,599,21,0,0,21
285,1107,2995,951,156,203,362,235,307,176,372,431,128,739,368,120,114,128,745,197,483,836,896,583,1,0,0,1
286,2691,7388,1871,820,589,872,490,740,322,981,1269,119,1775,916,318,374,423,1576,390,1430,2465,1947,1156,373,325,0,48
287,992,2598,659,333,195,321,161,315,203,295,418,76,650,342,179,174,185,454,120,486,731,731,530,50,17,0,33
288,3049,7301,1155,1894,855,1071,438,685,572,1234,1200,43,1963,1086,605,550,590,1304,376,1236,2672,1801,1216,81,0,0,81
289,2146,6161,1924,222,303,663,428,752,272,586,1111,177,1139,1007,130,110,338,1568,306,1342,1479,1886,1148,0,0,0,0
290,1468,3685,879,589,337,522,263,346,308,585,463,112,1054,414,242,230,286,710,220,588,1100,1023,754,0,0,0,0
291,1227,3173,899,328,237,424,245,321,208,361,584,74,775,452,133,186,247,661,157,534,860,934,688,8,0,0,8
292,881,2447,738,143,142,295,140,304,134,316,340,91,588,293,88,134,134,525,127,485,560,739,536,0,0,0,0
293,2149,5970,1780,369,387,826,380,556,403,782,609,355,1670,479,227,551,445,926,266,995,1598,1816,1295,31,0,0,31
294,2413,6097,1827,586,499,930,433,551,283,1295,547,288,1890,523,318,260,496,1339,265,923,1540,2104,1265,11,0,0,11
295,1374,4178,937,437,254,453,245,422,216,410,632,116,997,377,134,306,380,554,233,755,1302,1170,718,13,0,0,13
296,3636,9278,2375,1261,1091,1245,447,853,717,1453,918,548,2690,946,781,587,819,1449,396,1529,2346,2713,2294,102,0,0,102
297,1679,4307,1007,672,481,612,248,338,202,582,661,234,1242,437,201,284,231,963,195,568,1282,1330,932,107,0,0,107
298,2639,6879,2109,530,536,973,415,715,730,1017,713,179,2128,511,247,274,473,1645,248,1298,1262,2072,1999,4,0,0,4
299,1159,3156,931,228,225,402,183,349,227,411,457,64,703,456,192,86,126,755,132,583,674,1011,756,0,0,0,0
300,965,2651,848,117,152,343,169,301,143,360,393,69,642,323,89,116,60,700,91,508,531,887,634,0,0,0,0
301,2212,6116,1807,405,374,761,406,671,342,682,997,191,1317,895,67,328,498,1319,392,1106,1649,1822,1147,42,0,0,42
302,1630,4442,1450,180,253,627,300,450,226,456,888,60,1022,608,107,191,128,1204,221,736,1060,1437,988,24,0,0,24
303,1690,4723,1357,333,281,587,303,519,329,568,656,137,1145,545,190,265,284,951,306,759,1401,1399,858,26,0,0,26
304,2121,5553,1842,279,413,788,390,530,327,872,768,154,1524,597,177,296,291,1357,259,947,1248,1809,1290,90,0,0,90
305,726,2007,629,97,115,253,149,209,113,247,314,52,449,277,80,57,81,508,127,394,511,587,388,2,0,0,2
306,1348,3617,1020,328,229,444,267,408,206,505,486,151,804,544,173,155,270,750,207,694,970,1091,655,10,0,0,10
307,1800,5242,1557,243,260,535,363,642,228,683,713,176,1054,746,185,245,247,1123,291,1140,1354,1559,898,2,0,0,2
308,1630,4572,1275,355,317,462,288,563,186,399,872,173,859,771,169,201,319,941,273,1051,1194,1395,659,8,0,0,8
309,3670,8455,1663,2007,1158,1184,544,784,479,1489,1437,265,2569,1101,509,649,840,1672,494,1371,3209,2130,1251,42,0,0,42
310,677,1830,455,222,149,178,156,194,75,230,320,52,461,216,110,112,76,379,130,322,623,555,200,19,0,0,19
311,1748,4133,1270,478,503,571,303,371,262,725,702,59,1119,629,233,236,376,903,220,693,1256,1211,753,17,0,0,17
312,3310,8739,2099,1211,645,1065,673,927,507,1453,1249,101,2227,1083,546,303,583,1878,433,1796,2849,2655,1006,2,0,0,2
313,1647,4083,806,841,476,656,198,317,103,760,596,188,1130,517,340,356,292,659,168,475,1956,1098,386,153,0,0,153
314,1912,6250,416,1496,436,436,335,705,222,687,698,305,1286,626,642,653,341,276,356,1280,2601,1386,627,79,0,0,79
315,2387,4901,57,2330,818,1136,216,217,216,955,1141,75,2161,226,421,414,481,1071,183,350,3337,725,306,203,0,0,203
316,1000,2654,389,611,235,349,173,243,101,332,449,118,719,281,240,202,240,318,144,425,1228,616,241,17,0,0,17
317,2252,5418,901,1351,646,802,348,456,236,1018,869,129,1616,636,275,443,605,929,291,792,2198,1428,709,27,0,0,27
318,1072,2955,794,278,216,312,202,342,141,378,485,68,607,465,133,144,118,677,158,665,797,888,447,1,0,0,1
319,1194,3383,998,196,180,412,244,358,237,356,507,94,877,317,186,107,222,679,186,592,881,1047,677,11,0,0,11
320,2235,5844,997,1238,545,729,430,531,258,801,930,246,1421,814,342,540,390,963,373,879,2269,1523,800,41,0,0,41
321,1062,3034,871,191,176,317,192,377,221,276,481,84,682,380,173,96,204,589,209,518,941,824,542,16,0,0,16
322,1966,4925,1399,567,470,668,338,490,352,733,723,158,1495,471,274,320,284,1088,297,771,1445,1425,987,2,0,0,2
323,1802,5309,661,1141,468,528,301,505,232,817,569,184,1169,633,445,484,334,539,301,812,2093,1143,960,290,0,0,290
324,1423,4090,196,1227,340,421,238,424,113,487,625,198,793,630,395,479,308,241,262,770,1839,858,361,6,0,0,6
325,2178,6247,676,1502,469,648,408,653,148,1019,746,265,1629,549,499,603,473,603,387,1132,2701,1440,587,22,0,0,22
326,861,2767,91,770,164,198,182,317,65,349,274,173,529,332,272,349,139,101,154,592,1310,559,152,38,0,0,38
327,1518,5579,391,1127,257,274,302,685,146,634,432,306,751,767,456,350,391,321,342,1273,2229,1277,458,135,0,0,135
328,1162,3394,780,382,257,354,206,345,201,375,393,193,842,320,210,155,250,547,174,583,1209,935,493,0,0,0,0
329,1286,4622,648,638,221,288,229,548,130,523,377,256,864,422,334,380,339,233,260,980,1772,1114,496,72,0,0,72
330,1639,5535,675,964,300,389,295,655,147,487,568,437,843,796,507,418,359,355,360,1134,2195,1275,571,23,0,0,23
331,2012,6483,683,1329,513,521,321,657,187,724,568,533,1376,636,444,462,420,686,402,1182,3020,1303,576,13,0,0,13
332,963,4495,581,382,80,170,151,562,79,294,288,302,546,417,176,267,281,239,240,971,1850,983,451,25,0,0,25
333,2682,10877,1330,1352,372,479,443,1388,114,741,994,833,1725,957,382,634,580,1086,681,2333,4364,2499,1000,77,0,0,77
334,1665,7421,763,902,230,304,259,872,210,358,613,484,969,696,390,595,325,355,434,1569,3069,1625,724,28,0,0,28
335,2784,8421,437,2347,712,535,402,1135,232,1654,515,383,1832,952,1082,651,462,589,539,2151,3562,1657,512,9,0,0,9
336,1639,4383,1028,611,357,496,294,492,190,751,573,125,1007,632,196,192,294,957,249,913,1368,1233,620,0,0,0,0
337,571,1488,333,238,147,173,81,170,66,263,199,43,350,221,77,64,116,314,68,287,416,451,266,0,0,0,0
338,821,2484,657,164,143,206,130,342,77,282,374,88,478,343,72,112,123,514,163,640,649,709,323,65,0,0,65
339,901,2668,805,96,125,297,180,299,184,332,306,79,554,347,67,54,74,706,84,579,498,853,654,0,0,0,0
340,2032,4792,798,1234,565,699,306,462,264,976,650,142,1397,635,358,193,571,910,316,795,1995,1089,597,23,0,0,23
341,2137,4561,557,1580,787,690,300,360,373,845,879,40,1467,670,392,392,403,950,303,599,1950,954,755,8,0,0,8
342,1337,4485,1176,161,205,505,222,405,298,571,385,83,937,400,142,116,214,865,107,1023,1033,1136,1186,596,539,0,57
343,811,2351,681,130,120,283,132,276,141,367,296,7,472,339,83,65,120,543,102,528,469,758,494,13,0,0,13
344,1152,3384,1013,139,183,330,204,435,123,452,524,53,573,579,147,92,91,822,147,952,587,1103,595,0,0,0,0
345,1752,4659,1318,434,399,528,309,516,300,654,725,73,1019,733,156,229,209,1158,236,1059,1121,1343,900,10,0,0,10
346,1358,3383,920,438,330,489,210,329,323,491,443,101,965,393,188,142,197,831,120,675,939,816,833,0,0,0,0
347,2848,7822,2546,302,498,1087,471,792,752,817,1108,171,2205,643,317,394,302,1835,199,1285,1472,2416,2450,83,0,0,83
348,0,0,0,0,0,0,0,0,0,0,0,0,0,0,0,0,0,0,0,0,0,0,0,0,0,0,0
349,369,1014,271,98,67,100,64,138,53,85,153,78,243,126,52,23,38,256,50,194,290,273,207,4,0,0,4
350,1007,3662,900,107,177,379,148,303,193,423,305,86,743,264,58,111,79,759,93,565,1470,751,783,979,977,0,2
351,2115,4870,819,1296,713,690,317,395,368,665,951,131,1538,577,381,269,322,1143,202,841,1722,1170,935,23,0,0,23
352,427,2806,6,421,92,227,66,42,104,216,100,7,377,50,163,228,30,6,47,71,2529,155,4,1857,1854,0,3
353,1965,6352,30,1935,873,797,139,156,477,996,461,31,1738,227,1095,492,158,220,234,324,5510,269,15,2901,2896,0,5
354,972,5399,6,966,603,262,39,68,236,494,227,15,860,112,616,212,106,38,29,173,4931,252,14,3797,3791,0,6
355,2143,7168,158,1985,1039,623,228,253,437,1108,574,24,1683,460,414,469,444,816,249,561,4982,539,837,3207,3191,0,16
356,3944,7859,1235,2709,1770,1221,433,520,936,1692,1181,135,3251,693,1134,535,617,1658,308,1012,2861,1756,1922,23,0,0,23
357,1734,4800,1327,407,300,595,327,512,188,750,622,174,1054,680,91,85,355,1203,192,1058,1073,1461,1016,20,0,0,20
358,1919,5623,1593,326,251,608,359,701,415,706,724,74,1157,762,264,192,243,1220,177,1341,1128,1832,1145,0,0,0,0
359,1326,3722,941,385,212,454,260,400,187,439,641,59,738,588,99,63,147,1017,126,764,941,1106,785,15,0,0,15
360,2033,5512,1165,868,408,628,374,623,385,758,736,154,1468,565,236,275,470,1052,228,1138,1675,1527,944,0,0,0,0
361,2473,7077,1391,1082,483,679,481,830,220,964,932,357,1211,1262,204,283,488,1498,336,1648,2191,1975,927,6,0,0,6
362,2181,6118,1564,617,448,614,397,722,374,734,993,80,1196,985,253,175,349,1404,256,1370,1481,1684,1327,6,0,0,6
363,1126,2836,570,556,309,327,186,304,176,359,369,222,633,493,236,89,160,641,82,587,789,772,606,0,0,0,0
364,706,2010,532,174,119,215,136,236,161,266,237,42,461,245,70,71,80,485,91,468,442,578,431,4,0,0,4
365,1837,3829,314,1523,763,510,263,301,184,957,562,134,1502,335,359,300,476,702,154,591,1839,886,359,0,0,0,0
366,2229,5596,826,1403,635,649,379,566,240,983,924,82,1661,568,306,396,320,1207,252,1117,2089,1421,717,20,0,0,20
367,2379,6411,1383,996,526,758,448,647,420,864,974,121,1648,731,390,342,490,1157,259,1326,1751,1844,1231,0,0,0,0
368,1450,4370,1259,191,150,485,273,542,358,571,402,119,1091,359,153,221,202,874,117,924,868,1359,1102,4,0,0,4
369,1996,5272,1465,531,490,592,289,625,581,467,888,60,1275,721,220,254,305,1217,168,1141,958,1521,1484,12,0,0,12
370,1792,4713,1284,508,400,574,277,541,383,674,684,51,1123,669,233,160,247,1152,201,1051,993,1416,1052,0,0,0,0
371,1348,3725,994,354,240,410,247,451,166,522,557,103,803,545,106,124,158,960,155,831,996,1132,611,7,0,0,7
372,2871,6783,833,2038,909,931,485,546,319,1559,875,118,2116,755,519,355,729,1268,407,1076,3468,1218,614,19,0,0,19
373,1259,3205,787,472,292,374,237,356,187,483,518,71,861,398,219,233,175,632,206,548,967,868,616,1,0,0,1
374,1316,3347,540,776,337,476,252,251,117,495,594,110,934,382,214,207,295,600,253,400,1729,725,240,41,0,0,41
375,1851,3621,501,1350,802,605,221,223,337,663,719,132,1481,370,481,195,310,865,208,323,1712,624,754,0,0,0,0
376,1843,4748,842,1001,531,591,314,407,182,747,747,167,1358,485,310,277,312,944,286,680,1970,1111,701,65,0,0,65
377,2594,5430,1010,1584,957,932,382,323,321,1225,872,176,2082,512,274,588,594,1138,292,512,2959,1088,579,29,0,0,29
378,1699,3673,433,1266,504,698,285,212,166,780,703,50,1346,353,239,245,304,911,228,370,1952,829,294,41,0,0,41
379,2420,5664,470,1950,793,811,367,449,215,1186,808,211,1916,504,469,533,423,995,321,752,3081,1113,397,19,0,0,19
380,2177,5196,212,1965,758,687,287,445,48,1222,787,120,1640,537,552,393,362,870,344,734,3023,809,286,68,0,0,68
381,2520,6110,1274,1246,768,718,407,627,277,1371,695,177,1745,775,513,249,520,1238,297,1189,2153,1660,811,0,0,0,0
382,1090,2966,642,448,237,312,181,360,100,446,531,13,650,440,88,214,183,605,199,618,938,809,402,6,0,0,6
383,726,2087,588,138,105,213,158,250,65,235,289,137,352,374,22,59,109,536,98,467,413,631,478,0,0,0,0
384,1591,4849,1415,176,187,466,311,627,332,604,524,131,972,619,127,156,198,1110,180,1170,991,1554,954,6,0,0,6
385,988,2964,883,105,115,324,193,356,184,479,262,63,607,381,92,116,112,668,92,703,572,924,673,0,0,0,0
386,1060,2972,959,101,161,383,176,340,203,427,394,36,658,402,201,92,114,653,94,649,526,980,723,0,0,0,0
387,1320,3896,1118,202,168,426,246,480,162,470,569,119,734,586,114,57,169,980,139,888,841,1291,737,17,0,0,17
388,2124,6394,1882,242,257,686,382,799,353,753,789,229,1297,827,149,188,347,1440,213,1556,1239,2051,1335,0,0,0,0
389,1948,5391,1382,566,391,597,334,626,405,673,712,158,1185,763,373,205,245,1125,238,1150,1362,1496,1145,13,0,0,13
390,1446,3294,592,854,449,513,219,265,247,503,646,50,1080,366,248,220,216,762,199,490,1485,751,369,0,0,0,0
391,3063,7248,938,2125,860,1093,524,586,417,1598,873,175,2144,919,412,499,716,1436,381,1001,3527,1362,977,157,0,0,157
392,2373,5907,161,2212,528,899,505,441,132,1037,1060,144,1725,648,262,624,478,1009,471,692,3644,838,262,1,0,0,1
393,1923,4765,515,1408,462,731,365,365,198,1071,517,137,1595,328,324,397,470,732,339,598,2345,973,510,1,0,0,1
394,1492,4252,834,658,301,472,288,431,175,454,659,204,1000,492,271,147,263,811,270,724,1623,1063,572,182,0,0,182
395,2387,5185,746,1641,655,995,448,289,145,1221,853,168,1810,577,209,288,596,1294,392,395,3149,899,350,0,0,0,0
396,4,10,2,2,1,1,1,1,0,2,2,0,3,1,0,1,1,2,1,1,5,2,1,0,0,0,0
397,981,2619,656,325,162,337,236,246,48,444,392,97,663,318,54,75,167,685,241,394,1271,563,150,0,0,0,0
398,1363,3157,554,809,393,463,281,226,66,617,545,135,921,442,159,321,214,669,242,329,1749,610,227,0,0,0,0
399,16,41,9,7,4,5,4,3,1,7,6,2,11,5,4,4,3,5,3,6,20,7,5,0,0,0,0
400,1899,4681,689,1210,541,587,363,408,156,902,661,180,1340,559,279,327,298,995,322,682,2325,931,421,0,0,0,0
401,347,1052,227,120,76,107,96,68,51,180,82,34,268,79,146,93,52,56,24,131,455,287,155,102,0,0,102
402,194,699,4,190,20,35,45,94,4,90,99,1,56,138,14,73,39,68,70,207,292,106,24,0,0,0,0
403,2,8,1,1,0,1,0,1,0,1,1,0,1,1,0,1,0,1,0,1,4,2,1,0,0,0,0
404,598,2080,379,219,94,137,118,249,79,203,252,64,401,197,165,136,117,180,106,361,743,609,261,18,0,0,18
405,3,9,2,1,0,1,1,1,0,2,1,0,2,1,0,1,1,1,0,2,3,3,1,0,0,0,0
406,726,1678,180,546,174,270,151,131,9,420,266,31,537,189,45,59,138,484,163,148,1060,247,60,12,0,0,12
407,43,93,4,39,10,22,7,4,1,25,15,2,32,11,3,3,9,28,7,4,68,11,3,1,0,0,1
408,15,34,1,14,4,6,3,2,0,8,6,1,11,4,1,1,3,10,3,1,25,4,1,0,0,0,0
409,0,0,0,0,0,0,0,0,0,0,0,0,0,0,0,0,0,0,0,0,0,0,0,0,0,0,0
410,4925,10346,546,4379,1391,2188,861,485,65,2848,1804,208,3646,1279,457,490,1188,2790,925,498,7299,1346,278,78,0,0,78
411,0,0,0,0,0,0,0,0,0,0,0,0,0,0,0,0,0,0,0,0,0,0,0,0,0,0,0
412,8542,19982,1294,7248,2072,3710,1515,1245,329,3816,3425,972,6707,1835,902,1283,2367,3990,1391,1877,13047,2821,846,0,0,0,0
413,4008,10130,1168,2840,829,1399,862,918,245,1657,1936,170,2666,1342,659,423,736,2190,864,1596,5495,1663,512,15,0,0,15
414,996,3648,611,385,139,217,239,401,130,311,326,229,613,383,170,261,188,377,181,648,1286,883,650,57,22,0,35
415,744,2213,424,320,136,204,164,240,84,251,251,158,409,335,139,111,232,262,121,326,952,542,272,14,0,0,14
416,2877,7806,1078,1799,676,891,592,718,245,1103,1162,367,1932,945,369,315,658,1535,471,1093,3914,1651,677,15,0,0,15
417,0,0,0,0,0,0,0,0,0,0,0,0,0,0,0,0,0,0,0,0,0,0,0,0,0,0,0
418,605,1609,582,23,158,181,108,158,63,239,191,112,423,182,126,162,157,160,61,228,483,526,311,6,0,0,6
419,1197,3858,595,602,207,335,254,401,125,472,378,222,838,359,233,248,314,402,240,553,1701,870,494,15,0,0,15
420,758,2765,530,228,104,184,155,315,86,217,299,156,521,237,130,198,161,269,161,395,1096,716,397,9,0,0,9
421,3129,7602,2062,1067,822,1208,532,567,278,1517,1024,310,2688,441,557,748,802,1022,266,887,3094,2111,1244,0,0,0,0
422,3362,7776,1237,2125,946,1328,547,541,203,1550,1183,426,2634,728,311,526,664,1861,495,759,4317,1342,863,84,0,0,84
423,1708,4997,712,996,359,520,336,493,178,571,712,247,1167,541,418,342,379,569,275,768,2301,1134,519,0,0,0,0
424,2569,7345,1209,1360,572,735,540,722,185,928,1145,311,1682,887,500,680,516,873,416,1160,3190,1827,752,13,0,0,13
425,1440,3681,372,1068,379,513,248,300,89,494,662,195,1079,361,235,324,383,498,227,476,2007,683,288,0,0,0,0
426,1871,4537,674,1197,526,640,386,319,113,854,693,211,1393,478,208,344,324,995,281,523,2598,829,306,90,0,0,90
427,1256,2967,495,761,266,552,270,168,30,541,612,73,1040,216,92,71,299,794,219,212,2152,297,87,2,0,0,2
428,603,1419,235,368,127,267,130,79,13,259,296,35,501,102,44,33,145,381,105,98,1040,137,39,0,0,0,0
429,0,0,0,0,0,0,0,0,0,0,0,0,0,0,0,0,0,0,0,0,0,0,0,0,0,0,0
430,719,1636,44,675,242,291,84,102,73,305,251,90,538,181,95,153,124,347,84,206,1003,264,79,0,0,0,0
431,14,32,1,13,5,5,2,2,1,6,5,2,11,3,2,3,2,7,2,4,20,5,1,0,0,0,0
432,222,505,13,209,74,91,25,32,22,94,78,28,167,55,30,47,39,106,25,63,311,82,24,0,0,0,0
433,2324,5853,614,1710,650,736,453,485,240,984,812,288,1746,578,620,461,409,834,327,858,2849,1195,624,36,34,0,2
434,37,117,17,20,14,16,3,4,6,18,11,2,30,7,25,12,0,0,11,20,45,36,5,2,0,0,2
435,2178,4591,560,1618,867,679,311,321,350,1015,664,149,1728,450,607,503,456,612,244,524,2324,1012,487,84,0,0,84
436,1627,4333,841,786,388,464,313,462,141,688,598,200,896,731,312,331,426,558,293,689,1582,1164,605,7,0,0,7
437,2234,6249,871,1363,489,631,437,677,144,915,811,364,1503,731,409,544,414,867,385,1061,2703,1485,615,0,0,0,0
438,1764,4837,1031,733,385,596,343,440,205,616,708,235,1072,692,275,315,347,827,270,708,1839,1209,811,11,0,0,11
439,1142,3170,658,484,225,378,207,332,176,358,343,265,855,287,287,150,194,511,198,511,1150,826,485,0,0,0,0
440,3473,8860,982,2491,776,1158,784,755,305,1799,1115,254,2369,1104,559,443,810,1661,690,1201,4648,1632,689,0,0,0,0
441,2702,6621,647,2055,687,1019,470,526,305,980,1138,279,2193,509,518,368,556,1260,440,735,3616,1208,622,13,0,0,13
442,1089,3317,838,251,156,327,220,386,104,268,421,296,832,257,94,126,181,688,160,511,1145,938,563,13,0,0,13
443,2094,5791,650,1444,396,731,438,529,90,942,904,158,1593,501,226,378,576,914,334,818,2841,1224,574,0,0,0,0
444,2261,6174,1172,1089,492,705,460,604,254,917,764,326,1559,702,217,530,387,1127,367,909,2425,1555,918,1,0,0,1
445,3377,9304,1083,2294,649,1072,738,918,286,1497,1338,256,2196,1181,444,717,774,1442,672,1466,4441,1823,902,18,0,0,18
446,3557,9069,1392,2165,714,1269,822,752,208,1569,1409,371,2550,1007,240,553,942,1822,666,997,5101,1491,814,0,0,0,0
447,1861,4629,912,949,444,641,391,385,226,968,557,110,1309,552,260,295,280,1026,319,572,1917,1076,745,0,0,0,0
448,3298,7803,494,2804,968,1155,607,568,336,1702,865,395,2274,1024,656,569,846,1227,529,921,4294,1192,867,29,0,0,29
449,2714,6972,712,2002,686,679,639,710,312,1125,1075,202,1754,960,370,506,554,1284,566,1222,3238,1227,719,0,0,0,0
450,2491,5570,610,1881,731,951,408,401,290,823,1173,205,1979,512,305,420,690,1076,389,610,2913,1084,574,11,0,0,11
451,2475,7021,1447,1028,471,700,459,845,403,1014,838,220,1596,879,445,257,470,1303,491,1432,2416,1745,937,15,0,0,15
452,1079,3017,899,180,218,304,213,344,166,360,424,129,581,498,82,191,126,680,140,618,719,898,642,0,0,0,0
453,2615,7494,1630,985,477,653,528,957,262,1069,1031,253,1440,1175,273,288,615,1439,464,1655,2397,1963,1015,25,0,0,25
454,1552,4505,1224,328,226,453,328,545,238,512,706,96,913,639,109,141,253,1049,141,957,1042,1435,930,0,0,0,0
455,923,2683,792,131,120,304,154,345,249,251,327,96,653,270,164,105,116,538,106,578,568,907,524,2,0,0,2
456,3031,8460,911,2120,565,819,636,1011,422,1359,916,334,1773,1258,597,692,606,1136,441,1759,3102,2206,952,6,0,0,6
457,1769,5384,1120,649,227,463,385,694,238,527,937,67,848,921,157,242,241,1129,381,1251,1719,1281,752,0,0,0,0
458,1577,4725,957,620,211,418,371,577,243,594,570,170,708,869,222,197,160,998,302,1057,1598,1141,627,0,0,0,0
459,2894,8366,1664,1230,474,817,624,979,344,1141,1184,225,1959,935,375,387,569,1563,519,1623,3091,1983,1150,21,0,0,21
460,1527,4226,553,974,272,404,379,472,168,722,555,82,959,568,116,185,358,868,310,829,1795,905,387,28,0,0,28
461,1714,4925,1136,578,335,494,363,522,105,565,943,101,1100,614,193,304,437,780,265,857,1633,1366,804,17,0,0,17
462,1693,5153,1034,659,238,436,359,660,198,754,574,167,906,787,262,195,363,873,265,1169,1632,1458,629,30,0,0,30
463,1820,4647,1016,804,371,599,414,436,255,763,580,222,1297,523,150,412,418,840,287,673,1892,1078,717,0,0,0,0
464,1918,5005,1006,912,387,689,371,471,184,725,849,160,1346,572,283,276,515,844,351,710,2094,1170,680,20,0,0,20
465,3261,7667,1284,1977,979,1058,574,650,503,1357,1069,332,2473,788,815,705,500,1241,434,996,3178,1838,1221,41,0,0,41
466,1626,4120,1063,563,378,553,294,401,195,557,666,208,1209,417,251,353,284,738,225,622,1423,1231,619,9,0,0,9
467,2234,5198,690,1544,735,725,345,429,244,1170,674,146,1729,505,348,606,365,915,272,675,2234,1399,618,120,0,0,120
468,2260,5737,716,1544,575,728,403,554,456,872,838,94,1573,687,588,488,400,784,346,914,2243,1498,736,43,0,0,43
469,2590,7622,671,1919,552,666,477,895,319,1136,716,419,1388,1202,568,860,663,499,560,1624,3165,1620,653,0,0,0,0
470,2315,6334,1356,959,454,736,480,645,250,1064,776,225,1736,579,341,313,532,1129,374,1000,2389,1714,857,18,0,0,18
471,2398,5682,642,1756,682,876,378,462,289,852,1034,223,1884,514,469,671,667,591,356,721,2535,1265,805,40,0,0,40
472,2191,5520,422,1769,592,676,401,522,161,1194,772,64,1414,777,422,632,518,619,354,935,2676,1140,415,0,0,0,0
473,2601,7539,513,2088,552,755,484,810,330,1222,862,187,1681,920,811,784,376,630,458,1465,3003,1848,765,16,0,0,16
474,1625,4406,698,927,358,491,248,528,135,674,540,276,1197,428,258,422,408,537,257,727,1727,1158,537,14,0,0,14
475,1714,4682,789,925,369,507,324,514,149,843,576,146,1168,546,275,514,261,664,278,886,1680,1231,607,0,0,0,0
476,2595,7447,1554,1041,445,758,523,869,328,1019,1009,239,1568,1027,233,543,611,1208,371,1477,2214,2126,1259,18,0,0,18
477,2167,6551,1281,886,331,527,489,820,286,869,750,262,1311,856,358,380,328,1101,329,1437,2058,1878,849,0,0,0,0
478,2693,7280,603,2090,561,693,663,776,296,1347,625,425,1616,1077,566,559,727,841,512,1470,3260,1466,572,10,0,0,10
479,2907,9003,1455,1452,403,674,702,1128,344,1135,1241,187,1636,1271,410,374,509,1614,418,2186,3074,2392,933,63,0,0,63
480,1117,3472,953,164,75,336,240,466,111,397,507,102,711,406,83,100,145,789,95,777,714,1249,637,0,0,0,0
481,1632,4985,1343,289,181,443,344,664,264,591,635,142,871,761,96,242,341,953,116,1091,1173,1720,885,0,0,0,0
482,1445,4598,1198,247,127,336,377,605,143,466,710,126,737,708,147,118,154,1026,130,1012,1077,1657,722,0,0,0,0
483,2183,6311,1025,1158,401,484,497,801,268,1123,656,136,1382,801,540,286,440,917,278,1524,1992,1779,738,0,0,0,0
484,2932,8171,1571,1361,618,665,665,984,501,1320,938,173,1786,1146,459,455,526,1492,306,1888,2389,2312,1276,0,0,0,0
485,2294,6859,1314,980,334,535,495,930,268,1005,815,206,1180,1114,249,176,292,1577,312,1705,2156,1777,909,15,0,0,15
486,1931,5940,664,1267,251,388,531,761,160,1134,456,181,842,1089,351,194,441,945,336,1532,2281,1247,544,0,0,0,0
487,2012,5353,779,1233,403,606,425,578,214,907,771,120,1245,767,272,186,444,1110,263,1090,2027,1375,598,17,0,0,17
488,2832,7934,1757,1075,544,774,513,1001,557,940,1118,217,1628,1204,503,385,293,1651,265,1710,1994,2383,1582,17,0,0,17
489,2085,6229,1781,304,176,704,468,737,275,791,754,265,1214,871,240,174,322,1349,159,1227,1330,2132,1381,0,0,0,0
490,1424,4237,1086,338,191,371,310,552,240,528,499,157,922,502,186,204,231,803,143,881,1080,1368,765,0,0,0,0
491,1041,3255,684,357,98,280,234,429,59,426,499,57,524,517,62,130,148,701,100,784,914,1058,399,0,0,0,0
492,1855,5787,1356,499,169,430,503,753,148,743,791,173,865,990,158,218,254,1225,210,1351,1542,1902,782,0,0,0,0
493,1979,5832,1791,188,256,622,387,714,431,618,684,246,1255,724,260,300,278,1141,141,1182,1186,2000,1323,15,0,0,15
494,2064,6094,1851,213,229,627,465,743,463,788,587,226,1382,682,241,302,468,1053,136,1313,1190,2182,1273,0,0,0,0
495,2062,5954,1825,237,232,759,392,679,346,778,831,107,1287,775,165,321,270,1306,119,1181,1151,2103,1400,0,0,0,0
496,1008,2821,835,173,167,329,197,315,200,317,362,129,788,220,151,59,145,653,89,543,518,897,774,0,0,0,0
497,2489,6842,1938,551,453,853,433,750,638,681,945,225,1562,927,370,208,198,1713,165,1280,1233,2186,1978,0,0,0,0
498,1506,4146,1251,255,278,447,310,471,214,546,631,115,1031,475,173,186,231,916,152,774,1015,1402,803,0,0,0,0
499,2674,7868,1872,802,411,722,599,942,314,1107,1062,191,1353,1321,272,422,492,1488,410,1722,2338,2308,1090,13,0,0,13
500,1396,4163,1061,335,186,407,283,520,173,419,479,325,808,588,90,255,250,801,205,920,1202,1222,614,0,0,0,0
501,1407,4130,1113,294,209,409,278,511,154,583,602,68,814,593,152,196,209,850,212,805,1248,1207,658,0,0,0,0
502,1716,4627,749,967,370,494,377,475,332,516,627,241,1132,584,452,376,327,561,271,792,1707,1197,660,10,0,0,10
503,2937,6669,810,2127,1071,920,400,546,688,1078,987,184,2223,714,1008,565,543,821,336,966,2445,1522,1400,0,0,0,0
504,2268,4844,1024,1244,778,844,311,335,253,1072,662,281,1551,717,415,532,520,801,288,573,2184,1284,515,8,0,0,8
505,2135,6080,1168,967,415,667,424,629,290,851,822,172,1180,955,351,534,376,874,318,1182,2052,1762,766,24,0,0,24
506,1488,3983,803,685,344,396,286,462,315,543,547,83,1055,433,309,235,303,641,194,803,1166,1169,651,24,0,0,24
507,1973,5103,1631,342,393,713,346,521,320,961,577,115,1206,767,241,260,420,1052,172,1020,1154,1549,1208,0,0,0,0
508,1181,2949,598,583,320,340,195,326,103,454,573,51,697,484,169,133,229,650,130,670,868,889,392,0,0,0,0
509,1377,3068,495,882,459,449,197,272,125,920,320,12,1037,340,228,271,281,597,126,572,1018,973,379,21,0,0,21
510,981,2821,856,125,117,341,170,353,233,393,325,30,643,338,70,76,133,702,76,574,535,952,684,0,0,0,0
511,3006,7085,1901,1105,877,1015,448,666,626,1448,825,107,2242,764,504,364,497,1641,250,1347,1534,2441,1513,14,0,0,14
512,1619,4268,1299,320,316,600,285,418,150,700,681,88,1111,508,154,264,329,872,191,762,1082,1420,813,22,0,0,22
513,1053,3072,907,146,151,392,188,322,194,489,269,101,728,325,158,80,97,718,74,661,582,1055,700,96,0,0,96
514,2809,7890,2155,654,540,805,488,976,595,975,1045,194,1675,1134,310,368,544,1587,241,1803,1608,2398,1840,0,0,0,0
515,2429,7492,1626,803,302,684,460,983,245,1002,897,285,1304,1125,389,581,310,1149,344,1851,2292,2113,892,19,0,0,19
516,1375,4014,1131,244,220,363,265,527,143,414,715,103,751,624,97,222,247,809,193,1024,955,1245,597,0,0,0,0
517,1932,5534,1389,543,325,528,391,688,238,445,1013,236,1033,899,324,203,352,1053,287,1294,1494,1641,818,8,0,0,8
518,2349,6539,1517,832,457,621,442,829,354,952,866,177,1482,867,281,337,376,1355,297,1563,1603,2014,1062,0,0,0,0
519,3250,8757,2127,1123,773,899,582,996,296,1643,1212,99,2188,1062,375,549,743,1583,488,1763,2795,2402,1309,37,0,0,37
520,1423,4495,1096,327,162,365,311,585,113,573,515,222,748,675,226,215,248,734,240,1005,1314,1313,623,27,0,0,27
521,2017,5149,1034,983,565,635,337,480,308,674,821,214,1158,859,514,366,402,735,297,878,1802,1364,808,28,0,0,28
522,2259,6374,1383,876,421,672,433,733,204,643,1112,300,1372,887,447,416,460,936,341,1277,2005,1784,967,63,0,0,63
523,2756,7963,2241,515,468,860,570,858,399,752,1274,331,1479,1277,262,521,574,1399,459,1615,2299,2283,1307,51,0,0,51
524,1947,5439,1681,266,330,632,375,610,299,731,737,180,1222,725,256,255,342,1094,335,1070,1443,1584,1007,16,0,0,16
525,1618,4425,1309,309,299,529,290,500,308,711,504,95,982,636,166,411,368,673,253,850,1153,1314,855,17,0,0,17
526,2443,6670,1927,516,467,792,466,718,232,879,1241,91,1437,1006,283,243,424,1493,430,1290,1908,2005,1037,21,0,0,21
527,2918,7398,2108,810,710,1025,523,660,382,1228,1023,285,2146,772,570,499,317,1532,443,1167,2253,2294,1241,93,0,0,93
528,2645,6459,1260,1385,695,907,432,611,259,1225,881,280,1844,801,373,599,679,994,339,1092,2232,1816,980,27,0,0,27
529,1251,2927,925,326,373,417,168,293,366,519,337,29,893,358,174,205,339,533,156,438,621,850,862,0,0,0,0
530,3352,7291,1229,2123,1128,1238,412,574,381,1741,1009,221,2551,801,596,869,716,1171,369,964,3165,1881,912,2,0,0,2
531,1433,2955,790,643,544,472,201,216,259,732,329,113,1170,263,433,301,269,430,149,303,1097,856,550,45,0,0,45
532,3156,7385,575,2581,1048,1055,507,546,431,1183,1292,250,2474,682,968,874,558,756,392,992,3559,1556,886,95,0,0,95
533,2613,7103,619,1994,618,849,439,707,262,1143,834,374,1936,677,822,790,471,530,396,1229,3145,1582,751,42,0,0,42
534,2032,5106,1202,830,566,669,346,451,356,742,659,275,1660,372,594,290,416,732,257,677,1908,1314,950,37,23,0,14
535,2068,5110,769,1299,668,618,304,478,337,753,726,252,1586,482,513,503,528,524,266,768,2137,1330,609,0,0,0,0
536,1838,5269,397,1441,417,517,303,601,117,679,653,389,1195,643,374,582,359,523,326,1105,2420,1088,330,0,0,0,0
537,3330,7235,695,2635,1115,1251,453,511,224,1986,917,203,2816,514,675,667,832,1156,386,799,4145,1382,523,82,0,0,82
538,1239,3557,413,826,401,390,202,246,110,590,447,92,1020,219,232,393,228,386,180,367,1730,962,318,634,0,0,634
539,399,1302,161,238,120,135,64,80,36,189,144,30,329,70,82,74,88,155,58,137,578,406,123,275,0,0,275
540,2575,5659,781,1794,848,941,397,389,339,1137,839,260,1901,674,565,693,587,730,240,705,2649,1352,713,15,0,0,15
541,2155,5380,1440,715,519,775,389,472,296,1112,565,182,1792,363,259,312,537,1047,260,764,1614,1663,1079,11,0,0,11
542,1010,2515,400,610,278,340,155,237,62,491,395,62,738,272,97,259,262,392,119,371,991,700,334,20,0,0,20
543,1487,5873,563,924,409,486,270,322,193,633,608,53,1254,233,409,317,228,533,248,1455,3214,686,270,2288,2259,0,29
544,2272,5839,686,1586,612,770,369,521,256,994,726,296,1992,280,578,587,555,552,336,822,2855,1253,573,51,51,0,0
545,1383,4138,361,1022,529,418,220,216,195,557,547,84,1140,243,394,263,313,413,166,1039,1895,577,461,1018,954,0,64
546,2100,4814,572,1528,690,748,288,374,107,966,923,104,1629,471,260,592,398,850,214,450,2776,982,392,15,0,0,15
547,2942,8128,980,1962,717,983,481,761,306,977,1344,315,2197,745,700,348,695,1199,434,1211,4187,1645,651,89,0,0,89
548,3383,8916,1278,2105,1044,1049,498,792,490,1582,894,417,2609,774,919,711,844,909,480,1209,3866,2137,1224,68,0,0,68
549,2470,5577,344,2126,1075,653,320,422,569,1220,422,259,2085,385,1189,751,262,268,239,749,2610,1281,698,98,0,0,98
550,1364,4169,532,832,331,388,252,393,94,484,585,201,995,369,365,288,367,344,218,646,1770,1004,531,52,0,0,52
551,1925,6587,554,1371,360,495,362,708,285,757,600,283,1301,624,667,614,378,266,390,1371,2643,1554,629,278,0,0,278
552,1270,4479,470,800,203,298,251,518,143,562,445,120,792,478,452,457,162,199,253,1006,1805,1033,382,0,0,0,0
553,1249,4804,575,674,194,260,255,540,159,515,355,220,811,438,392,288,182,387,276,1006,2032,1071,419,118,0,0,118
554,1179,3808,520,659,310,388,231,250,151,417,507,104,908,271,414,133,224,408,137,427,1767,1014,463,581,254,0,327
555,2776,7312,494,2282,864,791,456,665,191,1335,835,415,2326,450,1018,787,490,481,398,1022,4176,1294,422,160,0,0,160
556,639,5056,22,617,232,181,86,140,89,239,204,107,531,108,406,177,45,11,64,3275,1426,211,80,3526,3514,0,12
557,2028,4082,390,1638,952,600,232,244,334,1192,357,145,1940,88,811,354,405,458,155,296,2483,740,408,145,0,0,145
558,2431,4762,523,1908,1135,824,210,262,349,1166,783,133,2254,177,674,301,438,1018,180,380,2690,1024,488,188,0,0,188
559,1703,4949,1027,676,328,501,296,578,148,762,608,185,1175,528,288,410,322,683,277,885,1831,1348,608,7,0,0,7
560,1585,5258,302,1283,361,415,225,584,184,670,410,321,916,669,546,320,310,409,302,1045,2465,1106,340,236,0,0,236
561,1630,4466,409,1221,471,413,269,477,276,727,442,185,1095,535,634,523,292,181,253,797,1891,1102,423,11,0,0,11
562,1350,4676,510,840,256,283,208,603,189,320,543,298,848,502,459,365,240,286,253,1013,1872,1110,428,37,0,0,37
563,4592,13018,1351,3241,1353,1160,662,1417,808,2103,1116,565,3123,1469,2171,1174,822,425,692,2550,4733,3449,1594,616,0,0,616
564,3039,8582,1052,1987,627,842,602,968,213,1484,1040,302,1901,1138,725,683,782,849,480,1706,3469,2056,871,33,0,0,33
565,2224,5900,1109,1115,540,722,393,569,361,938,712,213,1639,585,639,462,561,562,326,840,2413,1494,827,0,0,0,0
566,3553,9187,2626,927,793,1197,730,833,260,1810,1063,420,2483,1070,746,611,656,1540,693,1209,4009,2224,1052,19,0,0,19
567,2295,7824,1098,1197,383,467,442,1003,234,813,726,522,1378,917,740,738,551,266,385,1611,2557,2127,1144,30,0,0,30
568,2312,8642,1214,1098,371,472,408,1061,453,859,682,318,1231,1081,846,593,403,470,480,1745,3269,2221,927,20,0,0,20
569,1067,4494,566,501,83,201,202,581,93,318,347,309,498,569,318,327,238,184,253,985,1688,1155,413,0,0,0,0
570,1129,4471,357,772,177,219,181,552,159,444,246,280,559,570,481,362,182,104,256,999,1708,1098,410,18,0,0,18
571,864,3906,594,270,66,176,129,493,39,256,261,308,509,355,172,157,246,289,189,789,1422,1018,488,0,0,0,0
572,944,4186,573,371,67,147,185,545,88,199,323,334,489,455,158,284,236,266,211,821,1485,1106,563,0,0,0,0
573,1040,4196,792,248,82,245,187,526,166,289,377,208,606,434,198,253,225,364,180,696,1355,1257,708,47,0,0,47
574,1367,4864,806,561,212,297,257,601,114,536,332,385,721,646,424,526,300,117,245,842,1611,1502,664,81,0,0,81
575,1002,4199,770,232,92,219,210,481,124,311,227,340,654,348,206,252,227,317,187,719,1388,1195,710,45,0,0,45
576,1170,4824,872,298,112,248,222,588,160,356,447,207,792,378,196,428,298,248,217,867,1571,1411,758,51,0,0,51
577,1100,4821,772,328,76,195,214,615,44,280,455,321,657,443,136,358,374,232,207,908,1696,1309,701,36,0,0,36
578,2351,8296,678,1673,362,504,459,1026,191,994,765,401,1574,777,624,752,617,358,468,1708,3448,1884,788,6,0,0,6
579,778,2465,211,567,195,228,129,226,241,194,199,144,595,183,379,221,86,92,99,370,813,661,522,166,0,0,166
580,1124,4495,264,860,124,238,193,569,132,281,399,312,505,619,363,374,302,85,242,1204,1656,1022,371,100,0,0,100
581,1195,5055,423,772,119,224,171,681,117,580,244,254,508,687,522,324,139,210,288,1184,1821,1216,546,16,0,0,16
582,1832,6522,946,886,255,429,367,781,190,598,613,431,1148,684,621,417,444,350,290,1214,2110,1782,1126,38,0,0,38
583,1556,6459,945,611,194,322,244,796,187,334,677,358,950,606,538,414,249,355,296,1135,2191,1705,1132,15,0,0,15
584,922,4315,673,249,68,144,184,526,108,158,268,388,474,448,237,217,207,261,203,811,1520,1189,592,8,0,0,8
585,981,4893,624,357,76,144,155,606,125,253,307,296,584,397,260,307,260,154,267,1021,1846,1228,531,3,0,0,3
586,1138,6005,770,368,76,127,175,760,32,284,234,588,597,541,174,252,341,371,316,1287,2249,1458,695,0,0,0,0
587,386,2103,238,148,40,52,54,240,21,64,94,207,154,232,58,104,107,117,108,473,778,504,240,5,0,0,5
588,1256,6283,696,560,65,193,217,781,126,187,443,500,558,698,189,452,296,319,312,1416,2257,1593,705,40,0,0,40
589,1405,6026,635,770,172,266,236,731,112,420,394,479,795,610,411,412,289,293,332,1190,2184,1538,782,22,0,0,22
590,881,4005,383,498,48,137,153,543,76,222,243,340,427,454,274,310,159,138,235,961,1433,987,389,0,0,0,0
591,2183,8637,692,1491,319,372,397,1095,315,545,681,642,1038,1145,805,575,425,378,502,2089,3093,1924,1029,151,0,0,151
592,1317,4829,574,743,212,300,205,600,134,423,369,391,643,674,414,375,278,250,274,1018,1782,1139,616,20,0,0,20
593,892,3053,290,602,132,220,158,382,68,269,313,242,453,439,219,264,176,233,194,600,1176,744,339,8,0,0,8
594,1420,5514,742,678,185,268,252,715,142,354,575,349,840,580,358,438,347,277,288,1158,2010,1462,596,68,0,0,68
595,2490,7182,588,1902,571,617,396,906,501,869,681,439,1675,815,1039,750,488,213,396,1382,2446,1623,1335,0,0,0,0
596,754,2740,411,343,101,180,135,338,85,234,208,227,541,213,226,158,199,171,103,433,940,777,487,24,0,0,24
597,2358,7015,653,1705,480,677,478,723,510,845,795,208,1653,705,1156,416,183,603,365,1221,2793,1572,1064,71,0,0,71
598,2409,8075,1589,820,322,628,481,978,363,692,990,364,1492,917,344,413,459,1193,516,1248,3264,1970,1077,59,0,0,59
599,1413,5000,1011,402,161,322,308,622,135,375,528,375,838,575,157,270,323,663,247,774,1799,1405,775,17,0,0,17
600,1248,4398,909,339,133,355,248,512,131,252,550,315,802,446,108,267,369,504,209,592,1535,1220,842,27,0,0,27
601,2861,8473,1778,1083,430,854,720,857,288,1132,1200,241,2142,719,345,440,761,1315,526,1040,3659,2246,1002,136,0,0,136
602,690,2389,561,129,91,187,158,254,61,241,217,171,376,314,133,273,154,130,93,391,771,808,326,148,0,0,148
603,314,915,217,97,61,96,76,81,28,109,99,78,171,143,49,40,39,186,43,101,366,302,103,67,0,0,67
604,1167,4271,904,263,170,289,242,466,104,406,368,289,637,530,308,204,330,325,209,740,1694,1210,418,258,0,0,258
605,3923,11413,1561,2362,616,1234,924,1149,285,1932,1134,572,2371,1552,482,642,1092,1707,724,1721,5365,2538,1065,47,0,0,47
606,3976,11481,1950,2026,576,1321,981,1098,250,1426,1775,525,2770,1206,326,472,877,2301,997,1404,6520,1794,766,15,0,0,15
607,2237,6569,1085,1152,324,573,603,737,140,931,878,288,1283,954,135,389,766,947,428,975,3357,1332,477,18,0,0,18
608,2147,5712,829,1318,337,745,547,518,163,901,991,92,1434,713,139,262,667,1079,559,745,3421,775,212,45,0,0,45
609,1561,5249,1268,293,157,392,347,665,267,420,599,275,959,602,301,242,321,697,207,909,1623,1532,978,0,0,0,0
610,670,1855,382,288,166,155,124,225,193,155,265,57,450,220,237,62,90,281,105,329,610,448,363,0,0,0,0
611,1711,6092,1087,624,206,397,360,748,169,542,597,403,940,771,270,327,389,725,322,1143,2064,1607,956,34,0,0,34
612,2377,7186,1228,1149,376,562,564,875,174,753,972,478,1395,982,442,339,608,988,465,1335,2834,1699,853,1,0,0,1
613,1027,3753,648,379,140,210,207,470,115,304,415,193,557,470,257,233,218,319,166,683,1234,1028,642,0,0,0,0
614,1354,4900,1067,287,119,321,265,649,138,385,569,262,741,613,231,210,209,704,239,942,1524,1425,770,4,0,0,4
615,1380,4616,983,397,104,380,337,559,196,376,479,329,925,455,276,279,233,592,158,778,1410,1420,850,20,0,0,20
616,1277,4795,689,588,122,248,279,628,65,422,364,426,707,570,160,360,372,385,280,922,1755,1271,567,0,0,0,0
617,1322,4949,650,672,142,276,284,620,143,410,457,312,803,519,292,286,391,353,261,987,1794,1326,581,3,0,0,3
618,758,2703,600,158,68,206,169,315,98,253,234,173,487,271,95,136,158,369,153,443,856,755,496,7,0,0,7
619,1543,5322,1270,273,162,331,366,684,259,418,543,323,946,597,301,233,247,762,291,997,1628,1541,865,16,0,0,16
620,1092,3833,762,330,129,181,251,531,91,371,465,165,563,529,154,151,213,574,228,775,1271,1033,526,11,0,0,11
621,1230,4367,729,501,176,304,270,480,147,352,413,318,953,277,284,139,391,416,226,733,1472,1249,687,29,0,0,29
622,1537,5457,1139,398,173,380,329,655,198,359,395,585,1011,526,270,208,391,668,278,929,1867,1542,841,22,0,0,22
623,2092,7214,1543,549,220,449,466,957,236,452,847,557,1323,769,211,328,604,949,365,1351,2368,2103,1027,12,0,0,12
624,857,2923,703,154,93,217,172,375,124,273,285,175,579,278,129,108,223,397,166,421,940,820,576,39,0,0,39
625,1629,5527,1019,610,219,428,363,619,150,566,565,348,1060,569,245,329,336,719,295,898,2119,1419,796,32,0,0,32
626,1226,4455,918,308,90,262,273,601,201,231,471,323,775,451,164,206,258,598,162,879,1403,1350,661,8,0,0,8
627,1774,5836,1233,541,236,458,376,704,181,779,607,207,1113,661,222,321,519,712,260,1067,1902,1707,900,57,0,0,57
628,1501,4695,1194,307,220,437,291,553,353,411,428,309,967,534,293,168,285,755,174,802,1324,1428,967,16,0,0,16
629,1691,5291,1302,389,281,552,298,560,206,308,753,424,1023,668,160,276,411,844,273,888,1651,1535,944,71,0,0,71
630,2310,8250,1401,909,308,544,399,1059,255,700,860,495,1546,764,426,586,650,648,438,1503,2841,2193,1275,40,0,0,40
631,1368,4709,898,470,139,377,281,571,161,362,507,338,716,652,190,242,358,578,256,828,1607,1273,745,5,0,0,5
632,1778,5814,1171,607,292,454,342,690,329,553,460,436,1271,507,513,375,426,464,298,890,2220,1470,936,50,0,0,50
633,2533,9497,1304,1229,327,521,431,1254,270,712,748,803,1367,1166,575,741,635,582,531,2023,3352,2372,1219,48,0,0,48
634,1567,6142,775,792,223,308,263,773,220,563,330,454,1116,451,572,438,291,266,344,1350,2275,1531,642,37,0,0,37
635,1073,4265,695,378,134,261,188,490,129,250,313,381,729,344,266,251,295,261,257,843,1563,1070,532,9,0,0,9
636,1374,5970,942,432,142,268,245,719,225,347,284,518,757,617,365,334,327,348,316,1234,2146,1601,673,25,0,0,25
637,1590,5186,1368,222,208,546,276,560,185,408,630,367,1060,530,81,314,411,784,228,774,1566,1561,1057,21,0,0,21
638,1316,6258,861,455,78,206,224,808,138,279,395,504,695,621,303,270,441,302,373,1344,2323,1523,695,24,0,0,24
639,1371,6039,808,563,106,221,237,807,111,374,504,382,699,672,300,446,338,287,368,1315,2244,1480,632,22,0,0,22
640,832,3694,615,217,51,141,145,495,93,242,236,261,495,337,124,277,185,246,158,655,1314,1010,557,0,0,0,0
641,880,3975,637,243,66,139,169,506,86,226,181,387,442,438,156,210,240,274,219,783,1462,1041,470,0,0,0,0
642,1037,3533,815,222,151,280,198,408,110,494,320,113,743,294,95,188,259,495,161,571,1176,991,634,0,0,0,0
643,1068,4396,827,241,94,232,208,534,92,357,322,297,668,400,192,310,290,276,211,804,1404,1295,682,54,0,0,54
644,1080,4662,914,166,66,193,205,616,123,346,303,308,750,330,100,214,306,460,211,683,1561,1308,899,40,0,0,40
645,1232,4806,997,235,116,216,254,646,109,422,391,310,769,463,195,256,287,494,216,960,1511,1394,725,43,0,0,43
646,912,3648,745,167,55,200,161,496,95,277,340,200,561,351,122,186,207,397,152,745,1108,1038,605,12,0,0,12
647,1299,4692,1129,170,97,311,284,607,150,255,634,260,629,670,184,135,255,725,135,950,1336,1368,903,0,0,0,0
648,1738,6757,1511,227,71,288,332,1047,249,487,632,370,898,840,188,224,423,903,245,1647,1781,2283,801,0,0,0,0
649,1160,4538,886,274,92,189,257,622,109,342,390,319,664,496,134,192,308,526,172,952,1412,1351,651,35,11,0,24
650,2023,7876,1220,803,176,361,396,1090,149,496,798,580,1167,856,285,358,643,737,343,1516,2845,2183,989,19,0,0,19
651,1808,7291,1391,417,172,306,341,989,155,468,665,520,1067,741,363,373,534,538,313,1316,2472,2127,1063,72,0,0,72
652,1457,5050,1069,388,248,266,249,694,275,453,529,200,839,618,253,301,261,642,231,912,1574,1286,1047,24,0,0,24
653,3126,11497,2751,375,135,489,682,1820,133,1068,1657,268,1423,1703,88,254,351,2433,379,3040,3053,3842,1183,20,0,0,20
654,3983,8881,3486,497,1259,1535,400,789,1577,1064,908,434,3342,641,1001,756,815,1411,180,1083,1313,2431,3874,8,0,0,8
655,4017,13741,3542,475,303,970,840,1904,348,1294,1794,581,2272,1745,263,382,713,2659,535,3073,3742,4649,1742,32,0,0,32
656,2070,7052,1738,332,190,519,454,907,109,567,1075,319,1269,801,192,286,508,1084,344,1522,2190,2134,862,33,0,0,33
657,2540,8362,1815,725,355,621,552,1012,223,795,908,614,1408,1132,601,530,728,681,450,1503,3103,2388,918,62,0,0,62
658,1376,4269,1085,291,200,374,289,513,237,240,664,235,817,559,239,144,299,694,251,841,1290,1180,707,0,0,0,0
659,1059,3242,831,228,151,324,192,392,79,436,482,62,621,438,177,166,215,501,172,585,1136,924,425,16,0,0,16
660,1108,3556,897,211,152,335,196,425,216,296,484,112,684,424,238,121,314,435,190,665,1181,991,529,17,0,0,17
661,4585,12607,2023,2562,935,1389,1003,1258,455,2097,1563,470,2794,1791,797,1102,1188,1498,1008,2138,5545,2756,1160,60,0,0,60
662,1403,4536,1118,285,153,395,297,558,184,466,562,191,771,632,79,309,296,719,248,942,1423,1272,651,24,0,0,24
663,982,3158,843,139,101,299,201,381,160,293,408,121,569,413,109,157,222,494,196,614,946,918,484,0,0,0,0
664,2699,7778,1309,1390,508,726,592,873,144,1096,1241,218,1775,924,302,527,819,1051,442,1509,2855,2132,840,39,0,0,39
665,2480,7522,1911,569,458,723,495,804,276,809,941,454,1610,870,318,385,663,1114,485,1251,2629,2110,1047,59,0,0,59
666,1906,5990,1145,761,347,521,356,682,245,666,737,258,1244,662,543,579,512,272,309,1073,2157,1570,881,47,0,0,47
667,1959,5768,966,993,379,482,424,674,161,822,769,207,1162,797,324,723,575,337,359,1200,2395,1339,475,6,0,0,6
668,2083,6408,1680,403,364,610,398,711,175,751,798,359,1237,846,235,390,641,817,307,1047,2230,1885,939,30,0,0,30
669,2511,9178,1079,1432,359,482,491,1179,309,815,923,464,1381,1130,934,741,404,432,586,2114,3216,2297,965,44,0,0,44
670,2201,8005,1381,820,272,554,368,1007,255,662,584,700,1426,775,559,394,569,679,420,1681,2689,2130,1085,29,0,0,29
671,2720,7613,509,2211,592,866,505,757,162,1088,1041,429,1826,894,394,956,673,697,499,1161,3707,1598,648,52,0,0,52
672,1495,4635,894,601,229,452,322,492,241,522,605,127,1087,408,253,356,421,465,253,769,1841,1122,650,47,0,0,47
673,1448,4296,1014,434,247,408,293,500,140,457,627,224,1018,430,256,337,353,502,236,761,1567,1159,573,3,0,0,3
674,1821,5659,1479,342,239,531,359,692,271,566,647,337,1061,760,226,358,392,845,291,1038,1817,1599,914,38,0,0,38
675,1707,5349,1319,388,248,511,367,581,214,437,639,417,1124,583,183,283,428,813,277,933,1742,1512,885,47,0,0,47
676,3105,8477,1667,1438,660,1017,599,829,298,1238,1066,503,2041,1064,414,798,864,1029,447,1425,3050,2281,1274,65,0,0,65
677,1654,4443,646,1008,447,465,266,476,269,521,628,236,1180,474,358,420,349,527,246,752,1724,1020,701,16,0,0,16
678,987,3008,777,210,189,284,158,356,194,245,381,167,665,322,134,140,149,564,151,504,875,831,647,33,0,0,33
679,1671,4792,908,763,309,501,364,497,208,645,691,127,1174,497,338,321,412,600,248,904,1653,1305,682,45,0,0,45
680,2224,6721,1723,501,308,689,484,743,300,656,1039,229,1388,836,304,346,469,1105,370,1207,2090,1903,1151,27,0,0,27
681,1271,3558,873,398,226,429,217,399,237,369,474,191,832,439,139,359,295,478,209,609,1041,986,713,44,0,0,44
682,1808,5322,1489,319,292,550,367,599,238,782,613,175,1209,599,228,243,481,856,318,992,1612,1556,844,20,0,0,20
683,1334,3926,1114,220,195,420,290,429,196,580,450,108,858,476,212,255,240,627,212,782,1149,1137,646,53,0,0,53
684,2412,7089,1700,712,398,653,485,876,316,817,1017,262,1399,1013,601,399,460,952,431,1554,2237,1981,886,13,0,0,13
685,1688,4945,1009,679,301,419,395,573,159,631,708,190,954,734,303,413,357,615,295,1097,1690,1295,568,9,0,0,9
686,2057,5430,1068,989,516,584,392,565,314,790,799,154,1392,665,473,489,563,532,336,1009,1939,1360,786,0,0,0,0
687,1512,3986,679,833,377,453,290,392,210,493,625,184,1059,453,257,379,299,577,227,760,1357,1085,557,2,0,0,2
688,2882,8398,1604,1278,550,717,521,1094,415,1223,989,255,1569,1313,647,519,550,1166,477,1896,2567,2263,1195,49,0,0,49
689,1441,4370,1326,115,172,440,280,549,178,404,604,255,807,634,106,178,150,1007,182,1012,982,1342,852,0,0,0,0
690,2046,5943,1772,274,281,653,422,690,408,502,835,301,1231,815,227,184,319,1316,266,1252,1342,1786,1297,23,0,0,23
691,1091,3250,1009,82,139,358,213,381,200,317,460,114,784,307,111,93,143,744,87,767,615,1121,660,0,0,0,0
692,1141,3490,947,194,148,313,238,442,160,427,452,102,673,468,108,157,126,750,125,870,771,1112,612,0,0,0,0
693,1426,4352,1217,209,184,358,301,583,152,472,663,139,752,674,113,169,180,964,163,1032,980,1423,754,2,0,0,2
694,1767,5455,1557,210,160,532,371,704,175,708,692,192,941,826,194,125,247,1201,139,1308,1125,1904,979,13,0,0,13
695,2746,8545,2476,270,227,834,593,1092,436,1124,1003,183,1727,1019,285,238,480,1743,268,1912,1841,2908,1616,0,0,0,0
696,2115,5484,1525,590,470,711,366,568,314,917,703,181,1556,559,335,383,503,894,198,932,1468,1816,1070,35,0,0,35
697,514,1831,312,202,94,121,90,209,49,294,132,39,318,196,111,179,70,154,92,366,553,490,330,31,0,0,31
698,2870,9129,2515,355,336,874,532,1128,332,1209,910,419,1659,1211,196,459,507,1708,491,2025,2391,2816,1406,13,0,0,13
699,1743,5082,1463,280,240,593,375,535,242,478,702,321,1189,554,145,247,456,895,231,978,1339,1573,961,0,0,0,0
700,4577,13233,2974,1603,985,1227,825,1540,554,1850,1676,497,2625,1952,874,1053,997,1653,768,2794,4224,3634,1813,25,0,0,25
701,2521,6977,1975,546,474,853,431,763,502,1098,755,166,1559,962,407,605,549,960,364,1312,1881,1997,1423,18,0,0,18
702,3495,11180,1808,1687,605,949,624,1317,329,1513,1225,428,2048,1447,662,1083,713,1037,773,2488,3883,2709,1327,354,0,0,354
703,1577,4878,1317,260,177,545,285,570,193,574,497,313,968,609,115,189,357,916,224,902,1289,1553,910,20,0,0,20
704,1681,4885,1411,270,238,651,228,564,246,687,469,279,1125,556,87,291,309,994,204,822,1212,1567,1080,0,0,0,0
705,4581,14544,3236,1345,771,1212,852,1746,650,1523,1770,638,2508,2073,914,986,1055,1626,941,3103,4654,3673,2173,63,0,0,63
706,1108,3601,604,504,226,321,160,401,166,488,264,190,814,294,235,246,255,372,168,726,1117,1043,547,56,0,0,56
707,2674,10343,768,1906,388,496,448,1342,177,1040,793,664,1318,1356,767,893,601,413,781,2676,3859,2134,893,236,0,0,236
708,2649,8337,1439,1210,554,666,456,973,489,967,725,468,1613,1036,766,633,658,592,483,1874,2630,2030,1320,3,0,0,3
709,2143,7687,1075,1068,255,446,413,1029,214,890,711,328,1095,1048,649,464,582,448,537,1988,2762,1771,629,28,0,0,28
710,2273,7795,1246,1027,304,530,422,1017,214,751,940,368,1143,1130,377,680,657,559,432,1870,2667,2026,800,23,0,0,23
711,3004,9958,2627,377,294,874,566,1270,335,1409,818,442,1714,1290,252,425,1173,1154,513,2360,2761,3019,1305,2,0,0,2
712,1435,4900,1032,403,231,473,252,479,260,528,456,191,1018,417,239,277,300,619,220,855,1446,1406,973,184,0,0,184
713,1558,5238,1148,410,222,529,233,574,238,551,617,152,1012,546,281,353,381,543,224,945,1460,1580,1029,47,0,0,47
714,335,940,197,138,61,126,51,97,34,124,119,58,224,111,32,121,71,111,47,150,252,291,200,38,0,0,38
715,2852,8588,2119,733,422,811,589,1030,244,1009,1278,321,1360,1492,300,428,605,1519,492,1831,2755,2560,950,7,0,0,7
716,1876,5021,1270,606,416,647,295,518,269,626,813,168,1311,565,415,274,372,815,237,906,1436,1500,942,40,0,0,40
717,2372,6727,1615,757,496,756,442,678,277,728,1090,277,1479,893,462,334,570,1006,423,1264,2245,1838,957,148,0,0,148
718,2810,8004,2002,808,505,929,540,836,207,995,1121,487,1711,1099,219,559,774,1258,410,1581,2512,2359,1142,127,0,0,127
719,2751,7399,1954,797,612,817,524,798,322,1185,987,257,1814,937,616,729,773,633,488,1317,2627,2149,818,14,0,0,14
720,2129,5917,1784,345,358,708,470,593,179,833,938,179,1545,584,258,273,634,964,454,921,2304,1642,596,6,0,0,6
721,2346,6159,1473,873,518,809,432,587,300,860,890,296,1598,748,512,644,480,710,344,976,2102,1811,926,90,0,0,90
722,2874,8570,1476,1398,605,825,537,907,323,743,1234,574,1834,1040,596,830,709,739,567,1688,3361,2041,913,42,0,0,42
723,1941,5091,1369,572,385,737,307,512,121,789,898,133,1195,746,149,375,381,1036,217,948,1353,1715,858,66,0,0,66
724,2774,6593,1610,1164,920,892,395,567,403,1073,859,439,1943,831,404,607,639,1124,315,1019,1955,1634,1670,159,0,0,159
725,1375,4024,1319,56,120,549,246,460,149,480,491,255,887,488,91,107,257,920,117,846,761,1445,855,30,0,0,30
726,3019,8674,2358,661,443,969,562,1045,318,1101,1190,410,2042,977,456,527,732,1304,488,1799,2493,2455,1439,10,0,0,10
727,1120,3327,878,242,202,283,229,406,122,337,534,127,730,390,117,161,309,533,192,752,1087,857,439,17,0,0,17
728,2452,6887,1969,483,408,856,480,708,295,662,1196,299,1657,795,339,698,544,871,358,1232,2190,2084,1023,37,0,0,37
729,9008,29557,7033,1975,951,1637,2037,4383,382,3241,4432,953,3726,5282,636,669,1534,6169,2250,7871,10650,6691,2095,0,0,0,0
730,4522,12403,1733,2789,938,1317,943,1324,220,1861,2047,394,2315,2207,570,714,1100,2138,757,1990,6429,2736,491,246,0,213,33
731,2790,6569,834,1956,802,941,500,547,267,1562,862,99,1954,836,520,873,731,666,420,1146,3011,1442,550,0,0,0,0
732,1954,5720,1225,729,324,566,391,673,169,732,938,115,1246,708,183,562,569,640,357,1158,2148,1435,622,37,0,0,37
733,2793,7757,1549,1244,560,882,544,807,255,1184,1120,234,1791,1002,414,634,553,1192,505,1431,3112,1822,887,47,0,0,47
734,3163,9165,2649,514,495,940,628,1100,352,1024,1335,452,1980,1183,221,513,659,1770,544,1800,2707,2758,1356,15,0,0,15
735,1308,3559,1095,213,226,410,251,421,160,586,496,66,846,462,125,166,211,806,130,626,871,1229,703,0,0,0,0
736,3229,9168,2328,901,515,1008,662,1044,315,1173,1407,334,2022,1207,291,565,793,1580,366,1966,2612,2795,1429,115,0,0,115
737,1570,4991,1338,232,176,395,312,687,110,413,917,130,812,758,205,229,246,890,271,1256,1395,1366,703,21,0,0,21
738,2103,6132,1798,305,271,687,433,712,228,641,1094,140,1188,915,199,264,370,1270,190,1403,1466,2022,1051,13,0,0,13
739,2538,6415,799,1739,828,744,385,581,344,952,1026,216,1825,713,782,528,359,869,295,1242,2262,1789,827,362,0,0,362
740,1407,3983,1110,297,253,401,260,493,173,632,487,115,706,701,103,212,361,731,181,927,1032,1166,677,7,0,0,7
741,1707,5007,1297,410,217,552,343,595,234,564,688,221,1037,670,170,236,487,814,172,1179,1248,1586,822,23,0,0,23
742,5650,15098,2240,3410,1284,1569,1150,1647,605,2503,2024,518,3333,2317,805,969,1355,2521,958,3176,5824,3045,2095,74,0,0,74
743,3465,9781,2474,991,654,906,668,1237,495,1152,1575,243,2052,1413,573,440,624,1828,373,2328,2493,3091,1496,32,0,0,32
744,1943,5216,1041,902,420,612,355,556,227,720,838,158,1271,672,452,267,354,870,263,1104,1506,1411,932,10,0,0,10
745,2196,5546,1539,657,513,723,398,562,306,937,814,139,1489,707,365,371,457,1003,227,1136,1452,1701,1030,0,0,0,0
746,2711,8387,2379,332,249,887,498,1077,215,1192,1021,283,1624,1087,186,334,385,1806,245,1911,1837,3046,1348,52,0,0,52
747,1180,3615,1125,55,84,427,253,416,181,333,570,96,757,423,143,111,125,801,80,594,823,1289,829,0,0,0,0
748,1222,4207,1037,185,93,239,264,626,146,366,615,95,542,680,129,89,221,783,151,1064,1176,1258,558,14,0,0,14
749,2162,6820,1297,865,265,412,522,963,235,928,881,118,989,1173,226,428,499,1009,425,1709,2400,1616,670,0,0,0,0
750,705,2261,480,225,74,133,178,320,60,236,362,47,238,467,125,57,155,368,139,649,787,477,209,19,0,0,19
751,13,44,10,3,1,2,4,6,1,4,7,1,4,9,1,1,3,8,3,13,16,10,2,0,0,0,0
752,558,1693,278,280,89,143,146,180,44,321,178,15,283,275,55,76,121,306,176,272,870,294,81,169,0,0,169
753,1499,5029,1330,169,110,346,337,706,202,574,606,117,834,665,105,150,291,953,131,1198,1291,1532,877,12,0,0,12
754,1232,4054,1109,123,65,370,278,519,189,452,334,257,881,351,101,84,236,811,78,730,978,1436,832,77,0,0,77
755,3405,10943,2562,843,287,760,802,1556,372,1159,1502,372,1992,1413,394,434,575,2002,352,2582,2943,3551,1515,1,0,0,1
756,2197,7404,1790,407,187,473,459,1078,169,596,1199,233,1075,1122,192,213,402,1390,253,1773,1939,2417,1022,24,0,0,24
757,811,2939,600,211,81,177,158,395,55,344,335,77,400,411,163,125,240,283,154,613,982,809,381,31,0,0,31
758,1957,6767,1435,522,183,455,423,896,183,814,649,311,1024,933,415,420,331,791,361,1471,2179,1919,837,20,0,0,20
759,2394,7795,1607,787,290,627,581,896,154,920,1033,287,1140,1254,176,314,797,1107,563,1379,2983,1886,984,27,0,0,27
760,1978,6445,1295,683,237,573,439,729,228,705,705,340,1232,746,341,428,515,694,378,1087,2480,1706,794,22,0,0,22
761,3845,11664,1484,2361,712,951,809,1373,475,1361,1655,354,2013,1832,795,690,911,1449,664,2416,4444,2897,1243,194,0,0,194
762,1262,3763,424,838,240,373,282,367,84,472,455,251,856,406,53,244,411,554,277,484,1778,834,390,19,0,0,19
763,2989,8155,656,2333,655,745,707,882,468,1401,857,263,1903,1086,572,774,832,811,741,1296,3872,1361,885,36,0,0,36
764,2249,7534,1294,955,258,604,492,895,197,848,639,565,1505,744,266,782,498,703,463,1265,2784,1909,1113,37,0,0,37
765,957,3011,709,248,138,250,233,336,86,266,431,174,521,436,91,159,277,430,177,487,1068,777,502,34,0,0,34
766,1071,3196,795,276,158,277,270,366,146,386,458,81,647,424,111,104,317,539,202,589,1050,874,481,22,0,0,22
767,3710,11051,2930,780,513,1106,828,1263,335,1038,1717,620,2322,1388,335,604,807,1964,822,1624,4498,2694,1413,14,0,0,14
768,3438,11014,2253,1185,427,961,714,1336,311,902,1683,542,2141,1297,395,527,745,1771,814,1796,4619,2551,1234,75,0,0,75
769,4315,13693,2625,1690,462,812,1116,1925,344,1503,2178,290,1714,2601,205,378,949,2783,1047,3253,5396,3068,929,70,0,0,70
770,1966,6568,1428,538,260,488,414,804,125,689,739,413,1383,583,268,387,483,828,351,1093,2344,1858,922,11,0,0,11
771,2612,7838,2045,567,423,835,502,852,430,867,954,361,1877,735,555,372,716,969,502,1140,2511,2069,1616,21,0,0,21
772,1492,5344,826,666,216,354,281,641,179,351,613,349,817,675,265,472,479,276,338,911,2196,1319,580,139,0,0,139
773,1992,6557,884,1108,306,476,417,793,220,655,786,331,1150,842,265,431,594,702,409,1242,2628,1603,675,33,0,0,33
774,3153,9945,1443,1710,660,831,668,994,361,1511,1172,109,2186,967,735,840,640,938,629,1733,4021,2463,1099,885,0,0,885
775,3025,9342,1788,1237,400,834,648,1143,429,1338,933,325,1943,1082,657,543,648,1177,595,1815,3293,2450,1189,37,0,0,37
776,2421,7392,1422,999,372,608,531,910,330,1045,871,175,1469,952,452,399,597,973,474,1529,2791,1701,897,42,0,0,42
777,2437,6205,206,2231,616,675,585,561,350,1227,825,35,1486,951,409,568,750,710,580,907,3141,872,705,0,0,0,0
778,5648,14714,2063,3585,1021,1906,1366,1355,633,2661,1994,360,3845,1803,943,927,1503,2275,1281,2061,7482,2606,1284,26,0,0,26
779,1684,5352,1372,312,182,389,364,749,149,439,901,195,971,713,116,188,320,1060,136,1271,1364,1704,877,0,0,0,0
780,1061,3298,960,101,84,312,244,421,198,313,430,120,690,371,178,98,212,573,81,623,819,1165,610,19,0,0,19
781,1611,4514,1203,408,335,512,285,479,362,552,527,170,1195,416,404,225,300,682,198,734,1251,1298,1033,11,0,0,11
782,2570,7332,1625,945,470,790,510,800,279,1136,1008,147,1476,1094,259,625,672,1014,394,1395,2559,1958,1026,51,0,0,51
783,1071,2972,513,558,154,364,231,322,99,434,479,59,738,333,143,153,300,475,169,555,1180,674,394,0,0,0,0
784,1875,5801,1279,596,255,494,392,734,304,498,879,194,1071,804,245,246,295,1089,312,1150,1946,1450,943,11,0,0,11
785,2287,7365,1249,1038,338,583,520,846,268,718,1038,263,1303,984,543,514,456,774,457,1492,2771,1754,891,93,0,0,93
786,1443,4697,1106,337,177,408,280,578,192,620,424,207,980,463,195,190,354,704,252,889,1530,1325,701,21,0,0,21
787,2393,7447,1504,889,306,594,546,947,317,974,853,249,1157,1236,347,236,632,1178,477,1501,2649,1807,1013,18,0,0,18
788,1842,6001,1439,403,239,422,392,789,216,597,703,326,1006,836,271,243,280,1048,250,1259,1846,1609,1037,18,0,0,18
789,1418,4803,1089,329,149,309,315,645,198,362,666,192,675,743,198,238,316,666,266,961,1634,1204,738,8,0,0,8
790,1947,6577,1617,330,178,468,415,886,246,698,763,240,1302,645,234,262,440,1011,291,1093,2080,1874,1239,34,0,0,34
791,1046,4041,677,369,69,215,226,536,137,281,343,285,690,356,110,420,208,308,205,784,1394,1113,545,21,0,0,21
792,886,3237,719,167,93,195,164,434,101,340,297,148,501,385,113,162,234,377,165,507,1063,809,693,61,0,0,61
793,1411,4981,908,503,137,335,313,626,239,244,603,325,933,478,226,355,328,502,273,907,1693,1261,847,20,0,0,20
794,878,3087,771,107,47,222,188,421,79,205,445,149,520,358,78,143,194,463,143,494,1056,966,428,0,0,0,0
795,902,3203,414,488,103,175,185,439,72,250,284,296,545,357,97,273,295,237,163,654,1152,846,388,21,0,0,21
796,1977,7141,1571,406,197,504,438,838,318,552,703,404,1238,739,297,450,582,648,386,1061,2332,1981,1381,82,0,0,82
797,2239,7311,1601,638,300,602,455,882,298,939,682,320,1394,845,494,528,358,859,358,1294,2493,2070,1096,35,0,0,35
798,1691,4537,1249,442,338,608,300,445,346,666,495,184,1296,395,438,416,282,555,168,577,1406,1223,1163,17,0,0,17
799,1739,5386,1261,478,193,458,427,661,297,580,697,165,1067,672,146,298,372,923,294,1020,1721,1462,889,14,0,0,14
800,1873,5840,982,891,381,571,311,610,424,639,437,373,1406,467,542,417,431,483,314,799,2074,1369,1284,186,0,0,186
801,4041,11824,1947,2094,689,1327,784,1241,342,1660,1616,423,2789,1252,481,666,1078,1816,640,1727,5192,2864,1401,120,0,0,120
802,1502,5905,788,714,144,297,296,765,149,528,451,374,826,676,231,449,492,330,338,1254,2227,1440,646,22,0,0,22
803,1102,2628,426,676,376,342,131,253,432,342,249,79,837,265,279,257,254,312,147,346,813,491,831,0,0,0,0
804,1158,3657,779,379,196,304,201,457,171,387,373,227,759,399,151,403,290,314,191,630,1289,989,558,32,0,0,32
805,2145,7756,1569,576,268,497,397,983,213,499,832,601,1230,915,235,448,633,829,425,1453,2786,2101,991,13,0,0,13
806,3209,10318,2469,740,562,867,623,1157,578,1012,1042,577,2414,795,721,931,744,813,460,1436,3253,2999,2170,169,0,0,169
807,1261,4835,1012,249,153,268,230,610,204,307,469,281,695,566,313,342,351,255,233,948,1660,1300,694,13,0,0,13
808,928,3933,693,235,85,183,179,481,84,208,337,299,469,459,125,256,303,244,218,711,1391,1048,565,26,0,0,26
809,747,2503,617,130,80,169,125,373,120,173,300,154,519,228,117,294,235,101,135,353,855,692,468,18,0,0,18
810,3660,12275,2523,1137,580,856,673,1551,462,1183,1082,933,2569,1091,917,997,608,1138,701,2015,4491,3231,1837,52,0,0,52
811,2930,8662,1755,1175,579,901,565,885,445,943,1050,492,1977,953,672,864,690,704,543,1165,3320,2123,1511,76,0,0,76
812,1266,3789,915,351,283,335,188,460,227,447,430,162,919,347,308,297,347,314,142,619,1308,1106,614,47,0,0,47
813,962,3415,516,446,124,213,178,447,123,411,209,219,659,303,434,195,181,152,192,686,1225,878,434,41,0,0,41
814,951,3570,772,179,125,202,191,433,181,273,238,259,616,335,200,325,231,195,185,686,1268,927,504,17,0,0,17
815,1215,4805,314,901,100,192,237,686,210,558,284,163,630,585,456,309,279,171,300,1278,1832,1008,387,23,0,0,23
816,953,3326,543,410,163,192,180,418,168,271,278,236,598,355,201,281,287,184,171,588,1133,842,592,23,0,0,23
817,2194,8542,265,1929,212,407,386,1189,230,737,636,591,1058,1136,657,879,457,201,633,2254,3531,1623,501,80,0,0,80
818,1405,4865,988,417,185,326,263,631,205,294,334,572,969,436,205,353,340,507,269,857,1801,1261,677,0,0,0,0
819,717,2469,303,414,112,182,115,308,127,290,174,126,423,294,247,197,152,121,148,438,1049,604,230,18,0,0,18
820,5164,15050,3043,2121,876,1673,967,1648,629,1608,2308,619,3406,1758,738,966,1210,2250,838,2628,5616,4123,1845,68,0,0,68
821,1455,5091,1073,382,312,518,249,376,204,460,615,176,1058,397,201,309,468,477,164,1216,1909,1063,739,1131,1104,0,27
822,1391,4047,1158,233,242,523,251,375,250,571,384,186,1006,385,59,266,512,554,180,525,1217,1174,951,208,178,0,30
823,2882,7762,1585,1297,708,913,520,741,375,1062,1121,324,2208,674,760,481,830,811,479,1185,2984,1940,1174,65,0,0,65
824,1946,5728,610,1336,409,630,323,584,165,888,689,204,1256,690,535,697,426,288,369,963,2902,1086,408,171,152,0,19
825,1912,6812,685,1227,281,412,397,822,297,581,700,334,1231,681,632,589,385,306,429,1498,2740,1489,656,32,0,0,32
826,1864,5497,509,1355,426,485,340,613,239,661,738,226,1038,826,545,569,538,212,369,1082,2307,1215,524,39,0,0,39
827,1384,4388,649,735,251,351,315,467,137,578,246,423,850,534,232,468,342,342,270,802,1796,1034,486,8,0,0,8
828,3136,9846,1314,1822,536,886,619,1095,352,1305,1170,309,1994,1142,594,946,685,911,648,1812,4316,2139,931,32,0,0,32
829,1137,3783,655,482,201,283,202,451,158,511,314,154,663,474,342,270,310,215,225,727,1486,909,436,20,0,0,20
830,1961,7224,813,1148,278,372,325,986,212,723,618,408,1049,912,730,395,501,335,454,1662,2726,1700,682,0,0,0,0
831,1299,4150,193,1106,314,263,228,494,196,475,336,292,841,458,444,455,250,150,249,934,1456,999,512,92,0,0,92
832,1820,5872,1065,755,329,462,344,685,299,480,496,545,1157,663,531,457,299,533,305,1007,1982,1634,944,0,0,0,0
833,1571,5138,1266,305,236,426,301,608,190,395,719,267,1033,538,343,401,447,380,286,869,1774,1411,798,21,0,0,21
834,1700,5526,1337,363,275,466,342,617,256,418,561,465,1118,582,301,447,511,441,260,952,1785,1606,923,28,0,0,28
835,1765,5836,1255,510,292,470,338,665,189,633,604,339,1036,729,441,487,495,342,267,1108,1968,1585,908,21,0,0,21
836,1503,4990,975,528,252,397,222,632,230,535,612,126,1104,399,271,558,384,290,303,980,1783,1314,610,24,0,0,24
837,3381,11072,973,2408,690,842,563,1286,479,1209,1282,411,2110,1271,949,1392,703,337,686,2267,4236,2649,1234,171,0,0,171
838,1488,4176,467,1021,437,369,257,425,242,615,406,225,1074,414,564,422,296,206,224,727,1523,1055,647,51,0,0,51
839,1985,4902,585,1400,731,528,277,449,395,645,732,213,1442,543,662,573,397,353,283,797,1993,1118,711,124,0,0,124
840,2621,6034,1421,1200,877,807,429,508,522,1136,798,165,2005,616,550,866,714,491,315,732,2139,1607,1241,33,0,0,33
841,1750,5000,722,1028,399,497,301,553,132,761,691,166,1302,448,486,535,444,285,297,851,1921,1219,712,0,0,0,0
842,1368,3563,453,915,326,445,217,380,118,440,666,144,1007,361,357,448,405,158,229,572,1488,883,391,20,0,0,20
843,1467,4527,1130,337,249,428,306,484,230,561,482,194,1009,458,193,357,513,404,254,676,1568,1256,773,34,0,0,34
844,3295,9569,2865,430,472,1080,653,1090,468,1069,1205,553,2255,1040,430,375,692,1798,432,1760,2502,2985,1890,24,3,0,21
845,2539,7549,2217,322,371,822,500,846,378,657,1165,339,1345,1194,302,457,557,1223,380,1416,2027,2139,1587,3,0,0,3
846,2236,6294,1439,797,496,639,408,693,395,755,642,444,1531,705,708,567,480,481,313,1247,2088,1711,935,14,0,0,14
847,1222,3103,385,837,342,357,230,293,192,473,432,125,837,385,302,444,260,216,163,563,1141,794,442,0,0,0,0
848,1887,5157,407,1480,425,542,354,566,210,727,782,168,1081,806,555,453,494,385,353,1038,1989,1200,577,49,0,0,49
849,1417,4283,1101,316,224,421,265,507,180,511,610,116,819,598,385,289,316,427,227,895,1295,1167,699,17,0,0,17
850,1351,4009,1170,181,197,437,270,447,168,362,575,246,805,546,140,175,385,651,217,746,1134,1108,804,0,0,0,0
851,754,2221,684,70,91,261,149,253,78,218,403,55,509,245,44,88,191,431,123,433,598,597,470,0,0,0,0
852,2184,6485,1760,424,383,650,408,743,286,588,1056,254,1474,710,424,506,407,847,320,1232,1928,1777,1228,17,0,0,17
853,2206,6189,1232,974,464,783,417,542,304,732,874,296,1596,610,638,604,550,414,347,1016,2378,1593,855,18,0,0,18
854,2368,6981,423,1945,491,658,425,794,310,924,1070,64,1226,1142,1028,715,492,133,491,1575,2830,1554,531,24,0,0,24
855,1827,5549,581,1246,416,468,350,593,248,821,465,293,1206,621,993,314,226,294,360,1181,2088,1294,626,66,0,0,66
856,2524,7863,1125,1399,530,604,500,890,211,869,1032,412,1661,863,772,650,683,419,439,1366,3004,2093,961,50,0,0,50
857,1115,3692,450,665,213,259,192,451,111,454,367,183,665,450,359,348,231,177,237,726,1453,928,348,27,0,0,27
858,2164,6418,1231,933,423,561,419,761,462,818,612,272,1513,651,658,695,481,330,258,1133,2103,1848,1076,34,0,0,34
859,1401,4559,1046,355,238,361,243,559,298,392,362,349,1102,299,595,235,272,299,199,766,1400,1356,838,10,0,0,10
860,2323,6635,1855,468,503,704,401,715,337,655,1069,262,1739,584,452,631,502,738,295,955,1887,2099,1399,23,0,0,23
861,2291,7692,1727,564,308,620,448,915,251,598,820,622,1567,724,477,732,715,367,343,1263,2423,2241,1422,31,0,0,31
862,2876,7716,1142,1734,813,767,583,713,439,1094,658,685,2127,749,1088,896,473,419,504,1263,2846,1854,1249,21,0,0,21
863,1331,4038,778,553,232,384,236,479,102,527,405,297,850,481,282,337,339,373,231,644,1388,1106,669,26,0,0,26
864,3431,8171,860,2571,1201,1061,476,693,550,1493,990,398,2636,795,1309,1142,586,394,414,1391,3282,2091,993,18,0,0,18
865,1474,4272,1099,375,332,421,276,445,205,588,460,221,1040,434,416,426,360,272,212,623,1415,1277,745,23,0,0,23
866,1483,4038,1148,335,341,517,239,386,338,474,399,272,1129,354,346,272,412,453,197,557,1196,1178,910,26,0,0,26
867,1104,2832,783,321,267,368,170,299,143,481,292,188,771,333,292,316,147,349,149,467,854,819,543,1,0,0,1
868,1397,3960,1016,381,326,449,250,372,108,520,515,254,985,412,218,193,298,688,212,649,1282,1178,639,201,0,0,201
869,1665,4106,745,920,548,497,255,365,281,726,489,169,1258,407,544,397,336,388,199,622,1364,1038,883,58,0,0,58
870,1662,4852,1033,629,346,455,330,531,181,526,710,245,1247,415,405,207,390,660,249,855,1722,1377,649,41,0,0,41
871,3179,7489,912,2267,1122,921,451,685,371,1419,1098,291,2441,738,945,919,800,515,359,1028,2781,1905,1416,78,0,0,78
872,2987,9974,1592,1395,517,740,578,1152,207,962,957,861,2008,979,843,698,757,689,507,1775,3618,2718,1356,22,0,0,22
873,1945,6480,878,1067,341,483,387,734,249,575,710,411,1068,877,577,571,488,309,357,1204,2286,1769,864,25,0,0,25
874,0,0,0,0,0,0,0,0,0,0,0,0,0,0,0,0,0,0,0,0,0,0,0,0,0,0,0
875,1119,5079,589,530,167,240,173,539,93,441,336,249,534,585,415,374,193,137,284,1052,1791,1424,528,762,0,0,762
876,628,2401,365,263,76,135,114,303,74,227,159,168,419,209,214,233,112,69,175,593,918,521,194,0,0,0,0
877,957,3821,508,449,122,178,149,508,124,390,278,165,581,376,301,425,180,51,266,908,1482,866,299,66,0,0,66
878,1604,5796,700,904,281,326,258,739,309,551,396,348,789,815,737,597,182,88,417,1384,2095,1331,569,93,0,0,93
879,1277,3980,757,520,288,345,219,425,111,529,308,329,861,416,433,302,369,173,221,799,1500,981,479,13,0,0,13
880,1180,4527,456,724,164,208,217,591,128,402,396,254,535,645,584,321,216,59,269,1209,1820,902,327,14,0,0,14
881,1143,3516,511,632,231,302,216,394,128,462,403,150,740,403,394,401,205,143,237,742,1330,794,413,30,0,0,30
882,1208,3385,660,548,347,310,225,326,161,504,469,74,718,490,389,331,293,195,221,623,1254,821,466,6,0,0,6
883,1242,3271,1067,175,233,479,219,311,272,300,586,84,980,262,248,232,241,521,161,503,924,954,729,11,0,0,11
884,1424,3581,1250,174,329,526,245,324,198,445,719,62,1013,411,201,280,360,583,178,497,941,1027,938,22,0,0,22
885,2819,6762,2263,556,696,1123,446,554,415,1024,1278,102,2032,787,380,535,593,1311,311,906,2056,1955,1534,0,0,0,0
886,1778,4823,1165,613,480,556,308,434,234,743,618,183,1461,317,481,349,433,515,297,814,1789,1249,674,33,0,0,33
887,1253,3325,796,457,356,379,201,317,163,603,325,162,828,425,294,338,278,343,188,564,1136,839,598,64,0,0,64
888,1681,5620,535,1146,322,401,320,638,349,673,478,181,1019,662,1027,436,158,60,376,1410,2131,1236,467,41,0,0,41
889,1221,3972,465,756,242,310,216,453,135,465,442,179,842,379,488,398,181,154,251,879,1602,874,366,16,0,0,16
890,1729,6096,699,1030,308,382,310,729,262,652,478,337,1084,645,772,454,306,197,406,1495,2334,1314,547,20,0,0,20
891,1505,5705,547,958,255,291,256,703,281,616,436,172,1112,393,792,384,122,207,386,1449,2214,1232,424,15,0,0,15
892,1256,5173,532,724,142,207,253,654,169,447,342,298,788,468,581,349,225,101,321,1386,2046,1112,308,104,0,0,104
893,998,4114,316,682,155,165,154,524,101,521,238,138,450,548,506,310,122,60,273,1102,1569,895,275,179,0,0,179
894,1153,4286,323,830,277,199,172,505,220,476,264,193,682,471,634,287,162,70,282,1037,1664,915,388,246,0,0,246
895,2248,7599,517,1731,546,513,368,821,346,986,520,396,1225,1023,1293,642,269,44,487,1941,2907,1498,766,223,0,0,223
896,793,3938,230,563,155,192,115,331,78,371,151,193,472,321,308,226,201,58,190,843,1739,908,258,1064,0,0,1064
897,1251,4551,364,887,270,249,232,500,260,408,315,268,739,512,614,361,227,49,315,1083,1873,915,365,75,0,0,75
898,1346,4420,321,1025,355,262,245,484,242,633,422,49,770,576,735,384,148,79,309,1077,1760,887,387,42,0,0,42
899,2504,7957,1024,1480,566,578,406,954,531,1240,302,431,1711,793,1358,617,276,253,480,1778,3141,1737,821,37,0,0,37
900,1847,6222,762,1085,425,444,293,685,221,658,587,381,1212,635,765,492,479,111,381,1386,2362,1442,651,161,0,0,161
901,1760,4496,832,928,515,553,278,414,271,723,593,173,1252,508,637,445,237,441,268,858,1700,1100,570,0,0,0,0
902,802,2469,522,280,184,296,128,194,106,294,372,30,561,241,244,149,174,235,147,423,1032,539,328,315,280,0,35
903,1813,4543,1379,434,475,612,346,380,253,714,742,104,1235,578,301,582,364,566,278,626,1498,1314,827,9,0,0,9
904,2220,6515,1078,1142,585,621,363,651,141,994,709,376,1400,820,709,643,487,381,373,1328,2534,1514,766,54,0,0,54
905,2508,8173,1044,1464,557,620,418,913,326,920,1028,234,1521,987,1168,612,339,389,482,1644,3187,1887,973,22,0,0,22
906,2163,6124,858,1305,575,629,378,581,231,742,985,205,1354,809,605,630,564,364,353,1119,2386,1519,747,28,0,0,28
907,1199,3142,854,345,244,420,257,278,93,612,458,36,714,485,176,310,284,429,192,489,1083,847,531,20,0,0,20
908,1456,3665,794,662,357,462,305,332,180,453,786,37,1168,288,266,304,461,425,198,625,1246,993,603,16,0,0,16
909,1528,3868,1038,490,362,500,307,359,180,547,746,55,1072,456,184,402,374,568,193,574,1284,1120,697,37,0,0,37
910,2320,5665,1569,751,729,777,381,433,252,770,960,338,1745,575,371,533,512,904,346,723,1876,1612,1108,241,0,0,241
911,1006,2523,847,159,230,400,167,209,198,324,358,126,804,202,121,199,166,520,101,335,661,743,683,106,106,0,0
912,1864,4614,1683,181,363,747,357,397,367,658,735,104,1314,550,197,231,333,1103,239,646,1112,1469,1148,1,1,0,0
913,2541,6334,2142,399,543,931,497,570,382,870,1117,172,1824,717,237,300,455,1549,389,954,1758,1921,1312,30,0,0,30
914,2420,5810,1992,428,630,911,417,462,369,1069,844,138,1814,606,458,307,387,1268,322,880,1656,1776,1176,0,0,0,0
915,1524,3770,1162,362,389,514,268,353,252,482,714,76,1023,501,159,228,247,890,222,614,1039,1039,856,7,2,0,5
916,1640,4146,1238,402,399,578,310,353,259,595,685,101,1130,510,125,246,340,929,222,707,1149,1207,861,118,106,0,12
917,2269,5917,1577,692,508,671,361,729,333,819,1011,106,1437,832,334,334,340,1261,243,1298,1497,1721,1158,1,0,0,1
918,2071,6191,1880,191,257,645,346,823,257,731,944,139,1201,870,58,178,239,1596,272,1544,1119,1853,1403,9,0,0,9
919,724,1869,625,99,157,264,107,196,79,277,313,55,469,255,32,77,152,463,89,352,398,563,467,0,0,0,0
920,812,2035,705,107,139,321,151,201,114,267,343,88,599,213,72,94,120,526,104,316,517,649,449,0,0,0,0
921,1261,2805,596,665,442,378,199,242,258,554,386,63,976,285,348,292,207,414,158,432,978,716,521,0,0,0,0
922,2032,4458,1097,935,739,654,293,346,220,608,1130,74,1535,497,453,275,530,774,254,613,1389,1257,945,0,0,0,0
923,2737,7518,1017,1720,736,785,481,735,416,1216,895,210,2075,662,1105,795,394,443,432,1329,2973,1869,915,68,0,0,68
924,1988,6293,623,1365,419,523,352,694,157,723,756,352,1176,812,811,488,451,238,372,1296,2489,1404,732,47,0,0,47
925,1960,6833,474,1486,418,402,323,817,192,679,749,340,1160,800,874,660,278,148,466,1525,2773,1355,714,43,0,0,43
926,1906,5943,508,1398,622,531,287,466,308,759,647,192,1457,449,799,566,188,353,250,934,2537,1603,619,842,0,0,842
927,1390,4664,180,1210,288,292,211,599,232,512,313,333,890,500,706,429,137,118,260,1175,1879,879,471,0,0,0,0
928,1476,4931,323,1153,373,315,244,544,156,631,424,265,840,636,748,500,134,94,328,1030,2115,1038,420,40,0,0,40
929,1286,4021,471,815,326,330,200,430,147,481,412,246,769,517,586,312,188,200,183,854,1538,929,517,38,0,0,38
930,722,1937,361,361,205,213,122,182,116,340,170,96,424,298,300,187,107,128,80,253,632,413,559,57,0,0,57
931,1379,3429,394,985,470,388,198,323,95,691,484,109,1145,234,357,598,273,151,166,538,1442,849,434,9,0,0,9
932,1378,4433,514,864,270,344,277,487,157,645,359,217,855,523,571,447,205,155,267,873,1740,1021,532,0,0,0,0
933,2217,7725,566,1651,393,545,482,797,268,840,586,523,1308,909,1025,587,374,231,402,1593,3039,1778,913,221,0,0,221
934,3383,8139,390,2993,1175,1034,468,706,489,1425,1152,317,2763,620,1461,911,574,437,384,1119,3866,1766,1004,25,0,0,25
935,1616,3893,361,1255,542,522,230,322,230,726,549,111,1353,263,607,409,295,305,172,475,1866,915,465,85,0,0,85
936,1450,3262,352,1098,559,410,200,281,121,786,353,190,1230,220,561,386,212,291,154,421,1499,767,421,0,0,0,0
937,1551,3474,965,586,497,510,254,290,159,528,803,61,1087,464,301,189,376,685,240,474,1111,963,686,8,0,0,8
938,1615,4440,1471,144,266,574,318,457,179,489,840,107,1012,603,140,132,224,1119,294,827,1089,1214,1016,10,0,0,10
939,1970,3872,693,1277,785,750,216,219,144,1066,724,36,1597,373,337,324,476,833,187,352,1750,969,614,12,0,0,12
940,2446,4353,775,1671,1194,836,218,198,411,1109,904,22,2110,336,570,614,528,734,166,299,2226,982,680,21,0,0,21
941,2902,5156,529,2373,1438,1008,248,208,412,1376,1076,38,2426,476,583,1053,682,584,217,332,2892,1100,615,35,0,0,35
942,2863,4749,433,2430,1524,980,215,144,433,1318,1075,37,2524,339,646,915,728,574,159,214,2640,893,843,68,0,0,68
943,2610,5153,691,1919,1145,871,295,299,246,1301,948,115,2203,407,671,585,726,628,228,420,2545,1193,767,11,0,0,11
944,2584,4625,181,2403,1285,867,236,196,333,1254,837,160,2379,205,925,579,411,669,161,300,2335,968,861,50,0,0,50
945,3765,6228,396,3369,2218,1124,236,187,775,2241,716,33,3545,220,1684,889,555,637,190,323,2992,1216,1507,293,0,0,293
946,2519,5220,496,2023,1041,979,260,239,334,1012,909,264,2170,349,842,294,656,727,166,335,2708,1256,755,325,0,0,325
947,1886,5363,240,1646,693,581,233,379,311,718,555,302,1471,415,899,417,246,324,181,692,2423,1263,804,896,0,109,787
948,1740,4560,700,1040,515,513,315,397,128,764,745,103,1026,714,496,346,468,430,240,719,1681,1320,600,124,0,106,18
949,1475,3952,1041,434,298,442,295,440,198,439,694,144,872,603,127,195,322,831,209,763,983,1167,830,0,0,0,0
950,2035,4991,1034,1001,598,610,331,496,254,705,887,189,1363,672,312,387,525,811,237,930,1480,1515,829,0,0,0,0
951,2706,6735,1571,1135,740,860,476,630,560,964,1015,167,1884,822,766,580,525,835,316,1221,2008,1949,1241,0,0,0,0
952,2513,7168,1936,577,501,702,497,813,268,690,1118,437,1537,976,196,451,562,1304,418,1409,2043,2103,1195,46,0,0,46
953,2628,7176,2287,341,446,892,486,804,473,687,1128,340,1701,927,342,225,510,1551,352,1227,1654,2123,1820,18,0,0,18
954,1943,4425,588,1355,647,650,299,347,222,894,734,93,1331,612,568,531,415,429,222,607,1578,1151,867,0,0,0,0
955,1368,3050,209,1159,509,392,215,252,167,740,446,15,923,445,364,456,375,173,152,452,1272,842,332,0,0,0,0
956,2118,4827,789,1329,740,662,313,403,325,770,866,157,1470,648,480,559,424,655,265,685,1691,1342,844,47,0,0,47
957,1475,3406,492,983,471,479,238,287,189,614,644,28,1141,334,259,275,422,519,162,543,1193,942,566,14,0,0,14
958,1548,3288,791,757,576,520,231,221,174,784,528,62,1267,281,273,382,372,521,158,380,1156,850,744,10,0,0,10
959,2104,4942,842,1262,664,693,329,418,224,1006,739,135,1529,575,663,348,282,811,256,738,1735,1448,765,2,0,0,2
960,2161,5669,1011,1150,661,677,336,487,277,803,957,124,1414,747,556,458,394,753,273,863,1850,1521,1162,311,0,0,311
961,1275,3895,722,553,180,344,249,502,221,387,575,92,697,578,373,131,168,603,356,826,1504,721,488,43,0,0,43
962,1792,4780,370,1422,427,599,311,455,238,733,707,114,1345,447,523,631,392,246,263,839,2070,1040,568,1,0,0,1
963,2399,5137,847,1552,901,824,294,380,267,1007,989,136,1958,441,591,520,535,753,224,648,2009,1378,878,0,0,0,0
964,243,721,3,240,57,63,54,69,42,73,111,17,133,110,141,69,7,26,36,207,228,200,50,8,0,0,8
965,263,994,122,141,64,91,34,74,36,78,107,42,220,43,73,47,63,80,34,94,392,390,84,237,0,0,237
966,37,210,22,15,7,7,7,16,3,29,5,0,37,0,0,4,22,11,23,28,76,57,26,115,0,0,115
967,455,887,320,135,190,144,63,58,31,262,162,0,438,17,48,62,139,206,32,39,458,241,117,123,0,0,123
968,1286,2303,422,864,615,492,85,94,466,478,315,27,1193,93,706,243,202,135,44,126,706,476,951,96,0,0,96
969,1190,2277,265,925,535,426,122,107,204,633,330,23,1084,106,430,149,284,327,70,136,1131,503,437,151,0,0,151
970,2476,4713,182,2294,1418,697,198,163,500,1319,572,85,1970,506,1230,332,446,468,132,387,2394,1080,720,536,289,0,247
971,786,1247,3,783,489,250,23,24,254,362,168,2,748,38,393,111,140,142,24,56,661,227,279,39,9,0,30
972,4447,7840,521,3926,2226,1609,366,246,698,2204,1381,164,3881,566,1509,895,968,1075,285,452,4605,1383,1115,124,0,0,124
973,1428,2596,391,1037,676,528,118,106,169,796,436,27,1182,246,391,382,318,337,113,180,1401,552,350,9,0,0,9
974,3028,5146,768,2260,1616,962,260,190,556,1291,1141,40,2712,316,806,646,660,916,205,277,2367,995,1302,24,0,0,24
975,1291,2763,445,846,469,507,158,157,105,566,539,81,1099,192,275,316,204,496,133,229,1492,622,287,158,0,0,158
976,2412,4994,480,1932,1029,813,301,269,234,1271,732,175,1922,490,576,822,457,557,229,459,3008,933,365,191,0,0,191
977,2994,7150,951,2043,973,1069,468,484,253,1173,1181,387,2414,580,678,494,687,1135,331,833,3897,1424,665,202,0,0,202
978,1640,5146,345,1295,495,516,276,353,163,559,533,385,1310,330,508,516,327,289,234,692,2677,1127,416,684,0,0,684
979,2349,5698,231,2118,1165,789,233,162,199,1380,668,102,2091,258,689,591,620,449,204,366,3107,1329,692,1433,0,0,1433
980,519,1331,121,398,172,133,88,126,71,221,152,75,424,95,146,86,128,159,64,201,688,273,105,14,0,0,14
981,368,690,58,310,167,108,45,48,94,185,55,34,315,53,233,66,22,47,20,62,240,152,216,23,0,0,23
982,759,2045,111,648,253,199,131,176,195,325,213,26,546,213,441,200,82,36,139,506,827,414,159,7,0,0,7
983,1126,2492,210,916,467,348,136,175,312,553,157,104,921,205,781,126,116,103,106,263,1187,480,456,30,0,0,30
984,176,486,18,158,67,45,27,37,27,92,45,12,105,71,112,30,10,24,26,109,182,117,52,53,0,0,53
985,715,2111,90,625,239,191,112,173,114,371,182,48,424,291,418,121,60,116,136,470,835,466,204,217,0,0,217
986,718,2363,201,517,190,235,128,165,102,214,283,119,595,123,207,211,165,135,108,339,1185,488,243,413,0,0,413
987,788,2016,176,612,232,265,142,149,94,372,253,69,549,239,252,276,103,157,75,250,1122,414,155,22,0,0,22
988,1767,6146,787,980,594,648,273,252,25,944,664,134,1446,321,225,322,602,618,213,449,2964,2111,409,2136,0,0,2136
989,975,3031,218,757,285,311,178,201,95,456,303,121,675,300,317,217,136,305,136,476,1552,692,175,445,0,0,445
990,1163,2767,361,802,479,305,181,198,201,484,279,199,961,202,507,228,227,201,118,290,1448,638,273,109,0,0,109
991,6520,11991,1977,4543,2986,2248,707,579,691,3640,1914,275,5930,590,1542,1574,1399,2005,528,820,6872,2353,1418,258,0,0,258
992,1100,2517,424,676,361,377,170,192,81,384,448,187,767,333,167,380,194,359,130,305,1259,596,227,12,0,0,12
993,1844,4299,682,1162,653,651,247,293,167,825,711,141,1489,355,559,413,360,512,214,469,2173,882,561,124,0,0,124
994,931,2256,355,576,291,306,139,195,120,373,363,75,660,271,270,213,243,205,113,386,990,495,272,28,0,0,28
995,1559,4147,410,1149,483,536,253,287,174,797,422,166,1194,365,587,300,310,362,158,548,2193,840,408,402,43,0,359
996,1999,4687,817,1182,593,705,375,326,160,857,709,273,1572,427,482,537,478,502,244,472,2409,1003,559,37,2,0,35
997,668,1657,273,395,164,232,128,144,43,240,334,51,495,173,104,99,195,270,116,185,835,341,180,17,0,0,17
998,2411,5168,1017,1394,924,844,303,340,402,911,923,175,1871,540,421,497,405,1088,285,596,2076,1288,923,133,28,0,105
999,1002,2374,574,428,276,398,115,213,116,452,367,67,767,235,110,137,190,565,121,316,879,539,519,67,0,0,67
1000,1830,4121,794,1036,566,683,254,327,249,593,850,138,1348,482,337,249,418,826,226,503,1919,888,585,25,0,0,25
1001,1638,3703,674,964,544,582,235,277,194,712,534,198,1346,292,512,367,337,422,216,384,1839,804,460,4,0,0,4
1002,879,2005,297,582,312,297,151,119,123,291,344,121,701,178,274,167,159,279,77,235,985,411,297,69,1,0,68
1003,729,1559,301,428,250,260,106,113,89,296,286,58,604,125,196,83,101,349,63,166,695,347,288,1,0,0,1
1004,1357,3193,995,362,361,508,222,266,217,665,432,43,1037,320,198,176,246,737,142,414,883,805,949,0,0,0,0
1005,1266,2976,1089,177,305,522,222,217,234,606,332,94,915,351,167,98,248,753,105,346,705,936,884,0,0,0,0
1006,1454,4308,489,965,552,439,210,253,288,555,484,127,1138,316,417,315,165,557,112,1297,1659,538,702,1050,1039,0,11
1007,1125,4953,133,992,490,304,157,174,345,441,192,147,1070,55,588,205,160,172,60,801,3748,186,158,2389,2381,0,8
1008,1880,11442,21,1859,884,512,286,198,478,1117,123,162,1880,0,1343,381,116,40,80,5295,5702,222,143,7572,7494,0,78
1009,2433,5601,323,2110,936,759,374,364,418,843,827,345,2212,221,1112,663,259,399,135,546,4012,505,403,168,115,0,53
1010,1306,2937,496,810,483,423,183,217,133,603,436,134,1080,226,257,237,289,523,110,304,1475,543,505,20,2,0,18
1011,1522,3425,433,1089,629,492,211,190,208,681,516,117,1188,334,507,358,257,400,138,308,1637,715,627,242,46,0,196
1012,2135,5146,792,1343,692,680,329,434,343,583,799,410,1638,497,651,422,393,669,218,755,2329,1179,665,55,0,0,55
1013,1609,3804,862,747,536,482,236,355,302,574,655,78,1171,438,593,314,222,480,201,617,1396,1009,581,0,0,0,0
1014,1310,4214,329,981,536,466,156,152,90,600,569,51,1135,175,178,291,427,414,165,462,2048,1158,381,1554,0,0,1554
1015,1178,2930,358,820,390,349,195,244,191,513,382,92,882,296,495,238,167,278,146,474,1260,687,363,61,0,0,61
1016,1970,4364,781,1189,773,565,301,331,504,976,422,68,1422,548,935,349,363,323,195,592,1734,1042,801,144,124,0,20
1017,2070,4642,833,1237,754,764,271,281,223,953,602,292,1718,352,669,497,272,632,164,499,2146,1037,796,181,37,0,144
1018,2319,5354,57,2262,1066,589,320,344,406,1341,439,133,2090,229,1208,599,351,161,166,638,3449,742,359,548,139,0,409
1019,202,1295,14,188,87,53,23,39,47,97,40,18,181,21,117,57,12,16,13,162,1028,69,23,904,867,0,37
1020,1853,5670,295,1558,850,575,240,188,241,1029,437,146,1728,125,900,400,275,278,86,1301,3393,494,396,2022,1944,0,78
1021,1869,3806,267,1602,795,636,244,194,367,807,524,171,1767,102,697,470,242,460,95,327,2459,491,434,60,0,0,60
1022,1750,3752,556,1194,640,621,260,229,388,826,406,130,1466,284,461,506,360,423,146,442,1713,785,666,36,0,0,36
1023,1614,3452,688,926,633,527,208,246,196,788,560,70,1164,450,371,453,279,511,166,446,1498,780,562,43,0,0,43
1024,1137,2772,477,660,357,363,197,220,119,474,499,45,847,290,271,242,264,360,127,430,1103,710,402,0,0,0,0
1025,1733,3997,1080,653,516,629,264,324,196,644,713,180,1190,543,349,300,341,743,191,610,1272,1081,843,15,0,0,15
1026,788,1895,535,253,207,254,156,171,114,347,257,70,620,168,114,116,217,341,64,298,538,523,472,0,0,0,0
1027,1706,3698,613,1093,602,619,245,240,360,766,466,114,1427,279,548,309,409,440,110,433,1655,764,736,39,0,0,39
1028,1604,3893,1196,408,454,632,242,276,318,640,572,74,1271,333,196,181,299,928,149,518,1052,1020,1154,98,8,0,90
1029,1537,3723,1252,285,366,613,255,303,247,588,647,55,1158,379,185,189,315,848,133,537,876,1055,1122,47,28,0,19
1030,848,2050,763,85,157,375,142,174,137,333,320,58,657,191,78,100,132,538,75,273,410,621,671,20,0,0,20
1031,1474,3721,1327,147,264,611,277,322,269,485,650,70,1085,389,71,251,237,915,129,567,749,1030,1246,0,0,0,0
1032,663,1708,545,118,162,209,115,177,162,123,306,72,526,137,83,114,119,347,66,268,441,446,487,0,0,0,0
1033,1735,4158,1404,331,445,639,300,351,381,664,573,117,1356,379,467,277,280,711,149,706,843,1219,1241,0,0,0,0
1034,1330,3459,989,341,276,435,222,397,151,609,516,54,810,520,284,243,189,614,150,706,870,979,754,13,0,0,13
1035,869,2335,646,223,137,287,153,292,157,229,461,22,518,351,113,156,158,442,85,515,530,722,483,0,0,0,0
1036,1276,3291,515,761,291,387,256,342,159,386,537,194,805,471,210,290,323,453,185,664,1130,856,456,13,0,0,13
1037,955,2486,461,494,221,253,197,284,102,425,347,81,585,370,172,244,197,342,127,508,815,665,371,13,0,0,13
1038,1083,3818,9,1074,231,476,170,206,183,472,416,12,709,374,481,267,197,138,248,1189,2019,138,224,1350,1244,0,106
1039,2069,5107,1067,1002,584,555,410,520,250,924,821,74,1276,793,317,624,483,645,275,990,1726,1347,769,19,0,0,19
1040,749,1845,79,670,219,231,126,173,61,323,280,85,515,234,248,234,217,50,107,226,960,367,185,10,0,0,10
1041,1045,2493,413,632,297,348,183,217,163,437,311,134,835,210,287,260,243,255,150,333,1082,580,348,2,0,0,2
1042,740,1770,622,118,177,261,152,150,150,298,260,32,574,166,107,124,131,378,94,247,442,519,468,50,40,0,10
1043,1192,2939,961,231,291,436,193,272,311,431,405,45,844,348,131,181,272,608,112,462,709,818,838,13,3,0,10
1044,1032,2487,870,162,249,370,162,251,271,191,489,81,749,283,81,203,185,563,117,379,558,709,724,0,0,0,0
1045,1155,2934,991,164,258,443,202,252,346,393,361,55,908,247,189,240,175,551,122,382,731,822,877,0,0,0,0
1046,936,2434,792,144,195,319,183,239,224,373,304,35,719,217,157,134,223,422,123,388,573,762,588,0,0,0,0
1047,1259,3066,568,691,344,416,237,262,255,454,419,131,827,432,353,305,245,356,189,456,1154,733,534,8,0,0,8
1048,1183,2887,563,620,315,372,249,247,176,495,476,36,758,425,244,320,305,314,147,422,1047,779,492,12,0,0,12
1049,2118,5229,1143,975,609,716,364,429,267,755,929,167,1413,705,719,434,466,499,273,678,1967,1359,952,35,0,0,35
1050,2805,8509,972,1833,678,737,504,886,512,1243,704,346,1622,1183,1380,764,414,247,552,1786,3349,1827,995,265,0,0,265
1051,1441,3562,436,1005,442,434,247,318,388,382,489,182,1138,303,653,346,266,176,162,493,1493,805,609,13,0,0,13
1052,592,1488,485,107,109,232,96,155,170,177,208,37,372,220,129,92,142,229,66,225,361,438,398,0,0,0,0
1053,1653,4126,1384,269,358,577,302,416,286,656,669,42,1208,445,248,308,315,782,193,626,1161,1205,941,1,0,0,1
1054,1173,3047,857,316,276,409,207,281,143,341,604,85,797,376,149,205,353,466,156,417,987,872,615,47,0,0,47
1055,2035,6140,1092,943,458,562,316,699,208,863,549,415,1427,608,302,890,530,313,319,1049,2309,1577,886,53,0,0,53
1056,1801,5115,922,879,498,490,274,539,433,639,630,99,1184,617,737,409,500,155,262,933,1861,1319,740,3,0,0,3
1057,1286,4984,438,848,151,194,240,701,268,318,344,356,529,757,521,368,305,92,338,1330,2025,1001,290,10,0,0,10
1058,2221,7426,926,1295,505,539,388,789,594,792,557,278,1337,884,913,581,446,281,456,1607,2826,1692,845,290,0,0,290
1059,3277,7602,2022,1255,1178,1102,470,527,582,1771,865,59,2731,546,1030,727,784,736,409,996,3045,2034,1118,296,0,0,296
1060,2003,7350,896,1107,344,393,348,918,201,772,584,446,789,1214,823,696,384,100,517,1816,2839,1536,642,32,0,0,32
1061,2471,7912,883,1588,612,531,426,902,807,852,555,257,1364,1107,1472,600,303,96,552,1924,2980,1622,834,32,0,0,32
1062,1971,3986,1107,864,761,732,230,248,438,739,653,141,1650,321,360,420,493,698,150,402,1091,1195,1148,10,0,0,10
1063,1942,7109,680,1262,322,352,371,897,319,650,591,382,1032,910,830,632,325,155,463,1769,2798,1498,581,41,0,0,41
1064,1228,4789,657,571,178,184,222,644,142,365,522,199,626,602,331,432,332,133,260,1170,1825,1050,484,0,0,0,0
1065,2398,8198,1430,968,419,601,399,979,152,967,925,354,1586,812,526,1027,611,234,448,1631,3021,2150,948,54,0,0,54
1066,2391,6599,817,1574,695,558,365,773,478,1154,508,251,1499,892,948,991,374,78,331,1209,2330,1551,1178,47,0,0,47
1067,2547,9848,1045,1502,237,483,477,1350,355,1008,902,282,1191,1356,902,945,541,159,674,2414,3853,2144,763,9,0,0,9
1068,1487,6233,663,824,213,266,264,744,162,488,501,336,635,852,462,503,357,165,416,1508,2460,1399,450,394,0,0,394
1069,4189,11499,1651,2538,1127,1244,682,1136,707,1659,1575,248,2924,1265,1144,1492,851,702,614,1912,4700,2920,1353,0,0,0,0
1070,1303,4601,754,549,208,233,244,618,146,523,382,252,705,598,432,388,314,169,243,945,1705,1167,541,0,0,0,0
1071,1849,6683,899,950,259,370,346,874,349,557,562,381,875,974,711,611,394,133,392,1583,2483,1524,701,0,0,0,0
1072,1773,6052,892,881,268,420,346,739,255,742,443,333,1073,700,592,464,430,287,347,1232,2242,1569,662,0,0,0,0
1073,2096,6010,987,1109,592,562,335,607,377,941,488,290,1368,728,750,694,502,150,367,1068,2265,1476,834,24,0,0,24
1074,2744,7797,1752,992,628,837,526,753,417,1078,853,396,1983,761,484,1058,749,453,435,1208,2732,2130,1292,66,0,0,66
1075,1110,2959,615,495,301,296,186,327,152,480,416,62,748,362,322,448,185,155,155,492,1086,759,467,34,0,0,34
1076,1256,3096,1002,254,321,427,240,268,223,453,429,151,1027,229,292,302,371,291,152,429,874,892,749,10,0,0,10
1077,1976,5372,1255,721,468,612,316,580,299,727,766,184,1298,678,453,497,594,432,254,837,1772,1564,945,3,0,0,3
1078,1666,4699,978,688,380,523,304,459,258,533,546,329,1049,617,332,450,539,345,222,762,1592,1276,847,15,0,0,15
1079,3335,9489,2813,522,573,1210,645,907,887,1215,632,601,2447,888,797,650,922,966,386,1383,2651,2671,2398,1,0,0,1
1080,1905,5914,1272,633,391,522,331,661,398,463,798,246,1101,804,440,512,595,358,308,1045,2016,1619,926,11,0,0,11
1081,1483,4947,1140,343,310,384,225,564,235,430,386,432,994,489,266,436,453,328,233,926,1553,1324,911,19,0,0,19
1082,1969,5666,1222,747,409,581,364,615,316,862,593,198,1333,636,521,474,627,347,251,976,1942,1519,978,34,0,0,34
1083,6019,16864,4274,1745,1290,1736,1140,1853,886,2397,2006,730,4122,1897,1482,1384,1392,1761,860,2804,5742,4835,2623,17,0,0,17
1084,2227,6065,1902,325,476,823,345,583,466,662,831,268,1673,554,256,672,575,724,251,876,1708,1685,1545,27,0,0,27
1085,1492,4665,1195,297,249,477,267,499,379,342,414,357,1069,423,308,316,433,435,206,627,1369,1317,1146,9,0,0,9
1086,2432,7279,1890,542,437,737,420,838,337,825,866,404,1623,809,422,589,629,792,332,1231,2271,1924,1521,18,0,0,18
1087,2236,6023,1860,376,430,783,384,639,460,659,692,425,1617,619,459,371,531,875,265,862,1697,1847,1352,4,1,0,3
1088,1266,4137,1009,257,184,397,211,474,207,548,243,268,823,443,240,310,340,376,195,696,1287,1128,831,14,0,0,14
1089,2148,6249,1093,1055,549,569,438,592,436,823,768,121,1401,747,943,524,451,230,355,1321,2141,1555,877,167,0,0,167
1090,1558,3280,814,744,581,545,217,215,430,542,457,129,1289,269,415,474,336,333,130,379,1080,998,693,0,0,0,0
1091,1528,3439,801,727,528,512,219,269,313,762,338,115,1155,373,447,395,273,413,176,500,1147,963,653,0,0,0,0
1092,522,1056,86,436,254,141,59,68,200,249,73,0,422,100,269,171,60,22,26,96,524,288,122,105,0,0,105
1093,1053,2128,409,644,446,306,143,158,255,471,316,11,773,280,469,211,227,146,96,273,745,671,343,11,0,0,11
1094,3365,8542,2036,1329,896,1028,607,834,406,1226,1547,186,2031,1334,574,852,1088,851,468,1498,2988,2362,1226,11,0,0,11
1095,1242,3714,863,379,234,339,265,404,171,491,456,124,924,318,199,441,348,254,208,762,1256,982,506,18,0,0,18
1096,3876,10087,2847,1029,881,1264,701,1030,642,1382,1528,324,2569,1307,531,1058,941,1346,595,1821,3371,2911,1389,30,0,0,30
1097,1238,3508,1009,229,241,386,239,372,204,348,408,278,831,407,171,535,233,299,171,553,1208,1093,483,25,0,0,25
1098,3760,13191,2625,1135,431,893,774,1662,387,1235,1247,891,2024,1736,452,744,1317,1247,805,2512,4950,3553,1371,0,0,0,0
1099,3093,8498,2243,850,555,1095,598,845,652,1092,913,436,2186,907,575,817,902,799,399,1446,2607,2483,1563,30,0,0,30
1100,3159,8208,2663,496,685,1096,539,839,746,1130,1047,236,2117,1042,449,631,832,1247,366,1484,1967,2634,1757,16,0,0,16
1101,1480,4146,1361,119,223,548,226,483,367,427,540,146,985,495,201,264,418,597,202,810,948,1269,917,0,0,0,0
1102,391,975,341,50,71,137,86,97,97,113,142,39,260,131,72,83,91,145,42,164,192,347,230,0,0,0,0
1103,2881,8124,2428,453,459,974,559,889,606,783,1036,456,1961,920,573,526,735,1047,380,1519,2224,2483,1518,9,0,0,9
1104,1308,3797,1090,218,182,459,242,425,218,498,468,124,816,492,193,139,364,612,172,777,1013,1046,789,0,0,0,0
1105,448,1201,352,96,87,161,83,117,75,171,160,42,280,168,71,85,201,91,56,176,390,354,225,0,0,0,0
1106,3369,8210,1720,1649,1010,1040,564,755,852,1341,1034,142,2665,704,1033,599,999,738,440,1302,2759,2144,1565,151,0,0,151
1107,1527,3895,852,675,403,478,297,349,334,525,472,196,1167,360,419,374,415,319,242,568,1364,977,744,14,0,0,14
1108,2236,6099,1719,517,490,764,415,567,404,750,851,231,1538,698,253,700,558,725,311,982,1803,1761,1242,40,0,0,40
1109,2874,7877,2145,729,558,996,557,763,411,884,1289,290,1833,1041,483,734,811,846,441,1294,2573,2140,1429,22,0,0,22
1110,2785,7400,1656,1129,684,924,462,715,602,1037,874,272,2154,631,944,525,610,706,396,1233,2582,1975,1214,37,0,0,37
1111,2097,5901,1522,575,433,725,397,542,393,554,810,340,1441,656,389,478,780,450,391,896,2139,1606,869,16,0,0,16
1112,2281,6579,1478,803,490,740,424,627,450,543,967,321,1599,682,580,562,515,624,363,986,2403,1812,1015,92,0,0,92
1113,1396,2362,68,1328,779,403,102,112,509,507,336,44,1307,89,715,351,290,40,84,131,982,524,641,29,0,0,29
1114,2645,7633,485,2160,610,691,496,848,326,1266,854,199,1519,1126,989,915,591,150,583,1666,3401,1514,469,0,0,0,0
1115,1612,4925,253,1359,328,405,289,590,193,567,566,286,1051,561,520,572,307,213,349,1147,2138,953,338,0,0,0,0
1116,1267,3547,870,397,259,449,223,336,181,392,509,185,822,445,233,254,306,474,210,524,1259,1009,545,38,0,0,38
1117,1245,3320,913,332,225,499,187,334,255,343,407,240,895,350,212,332,217,484,154,492,990,980,704,17,0,0,17
1118,3142,7586,1945,1197,881,1062,526,673,466,1452,906,318,2226,916,1130,803,633,576,414,1110,2521,2068,1473,18,0,0,18
1119,3210,8852,1925,1285,670,1037,606,897,548,1380,711,571,2119,1091,691,1139,660,720,534,1536,3099,2311,1372,15,0,0,15
1120,2967,10072,1072,1895,527,702,506,1232,489,1200,798,480,1943,1024,1077,870,695,325,719,2295,4187,2019,852,33,0,0,33
1121,5698,11605,1461,4237,2296,1874,721,807,815,3083,1504,296,4676,1022,1438,1466,1277,1517,682,1303,5045,2594,1981,43,0,0,43
1122,2946,7858,1979,967,905,856,451,734,580,972,1047,347,2117,829,793,1060,650,443,423,1280,2761,2033,1361,163,0,0,163
1123,2343,5724,1107,1236,693,769,398,483,466,808,824,245,1520,823,565,584,737,457,269,949,2247,1491,768,39,0,0,39
1124,2574,6489,1926,648,668,859,504,543,387,914,991,282,1618,956,314,560,797,903,340,1009,1906,1812,1422,0,0,0,0
1125,1944,4980,1563,381,420,745,273,506,483,555,701,205,1343,601,272,372,427,873,255,872,1346,1383,1124,0,0,0,0
1126,2848,7089,2479,369,644,1069,516,619,586,1222,905,135,2154,694,552,593,728,975,326,1054,1811,2180,1718,10,0,0,10
1127,2611,6681,1865,746,586,887,469,669,533,943,779,356,1714,897,614,348,501,1148,346,1143,1898,1906,1388,17,0,0,17
1128,1759,4717,1401,358,369,555,343,492,230,627,817,85,1087,672,213,413,576,557,360,833,1474,1269,781,57,0,0,57
1129,2214,5694,1585,629,555,718,367,574,516,651,784,263,1566,648,374,374,761,705,352,928,1650,1550,1214,99,0,0,99
1130,1385,3577,1165,220,291,470,260,364,377,468,403,137,901,484,288,239,351,507,226,588,888,1016,859,6,0,0,6
1131,2272,6238,1988,284,347,852,390,683,433,681,808,350,1348,924,194,224,302,1552,263,1221,1296,1923,1535,1,0,0,1
1132,1684,4934,1510,174,226,604,263,591,357,463,736,128,936,748,165,159,175,1185,213,1195,935,1480,1111,22,0,0,22
1133,3116,7886,2441,675,707,1098,626,685,791,1095,1010,220,2210,906,681,466,573,1396,439,1292,2132,2264,1759,53,0,0,53
1134,2523,6411,1374,1149,653,836,475,559,350,1058,935,180,1731,792,628,510,425,960,442,1071,2272,1566,1060,33,0,0,33
1135,2963,6421,1727,1236,1019,1034,413,497,523,1166,1055,219,2335,628,593,534,874,962,370,896,2348,1609,1198,10,0,0,10
1136,2647,5474,1080,1567,962,947,370,368,356,1089,1056,146,2205,442,380,456,936,875,294,638,2638,1229,675,12,0,0,12
1137,1456,3855,1234,222,291,555,286,324,284,579,458,135,1033,423,166,200,293,797,212,577,1020,1035,1011,87,0,0,87
1138,2329,6283,1773,556,407,855,457,610,578,882,748,121,1669,660,407,418,456,1048,339,1096,1701,1832,1315,2,0,0,2
1139,1240,3548,1141,99,154,464,234,388,292,414,466,68,739,501,92,152,181,815,156,706,715,1133,838,3,0,0,3
1140,1072,3125,998,74,161,385,189,337,215,380,375,102,753,319,60,144,211,657,140,638,568,917,862,76,0,0,76
1141,2203,6126,1889,314,365,793,396,649,448,726,931,98,1613,590,254,351,426,1172,324,1182,1384,1810,1426,7,0,0,7
1142,1551,4143,1288,263,260,574,277,440,328,523,551,149,1071,480,145,331,380,695,191,764,957,1269,962,0,0,0,0
1143,2029,4601,1309,720,659,716,267,387,363,738,820,108,1362,667,473,218,470,868,216,724,1201,1185,1275,0,0,0,0
1144,2178,5182,1170,1008,632,763,338,445,409,780,713,276,1571,607,279,384,554,961,262,855,1668,1433,964,10,0,0,10
1145,4220,7849,944,3276,1861,1511,432,416,677,2171,1156,216,3619,601,870,955,1112,1283,364,754,3997,1644,1090,61,0,0,61
1146,1966,3690,143,1823,928,614,191,233,140,1280,509,37,1696,270,433,756,551,226,154,439,1999,731,367,11,0,0,11
1147,2317,5920,1764,553,631,719,387,580,769,640,716,192,1565,752,416,352,462,1087,264,1113,1185,1662,1696,0,0,0,0
1148,6364,8862,5983,381,4017,2089,142,116,5267,909,188,0,6354,10,2440,1974,1203,747,33,85,118,863,7763,6,0,0,6
1149,2156,5485,1498,658,550,739,328,539,393,1014,611,138,1526,630,342,484,454,876,268,965,1540,1610,1102,138,0,0,138
1150,2163,5313,1224,939,583,692,339,549,571,906,555,131,1467,696,595,338,435,795,266,1125,1360,1463,1099,1,0,0,1
1151,2089,6081,1943,146,270,686,366,767,360,566,1156,7,1216,873,185,225,372,1307,281,1412,1250,1852,1286,0,0,0,0
1152,2609,6331,1415,1194,648,921,378,662,332,1033,1146,98,1793,816,216,500,420,1473,313,1222,1879,1748,1169,0,0,0,0
1153,1509,4340,1400,109,198,521,252,538,272,554,654,29,886,623,73,195,246,995,233,987,883,1248,989,0,0,0,0
1154,2756,7339,2348,408,557,964,415,820,829,925,903,99,2035,721,419,119,373,1845,308,1554,1307,2108,2062,4,0,0,4
1155,764,2050,666,98,128,268,127,241,122,333,299,10,390,374,92,96,118,458,102,414,442,627,465,0,0,0,0
1156,1508,4460,1334,174,188,479,293,548,291,351,677,189,820,688,143,172,283,910,281,986,1082,1278,833,0,0,0,0
1157,1038,2621,829,209,243,328,165,302,299,298,308,133,727,311,194,141,217,486,122,540,544,769,646,0,0,0,0
1158,2383,6370,1705,678,457,769,439,718,412,1005,783,183,1606,777,520,370,386,1107,289,1390,1577,1872,1242,0,0,0,0
1159,901,3425,813,88,124,318,143,316,242,299,304,56,593,308,88,111,150,552,121,1061,914,740,589,933,917,0,16
1160,1884,5863,1702,182,273,635,324,652,406,572,829,77,1069,815,154,223,297,1210,209,1404,1376,1708,1166,548,537,0,11
1161,4576,11958,3466,1110,1047,1582,703,1244,843,1743,1517,473,3009,1567,811,643,701,2421,496,2478,2670,3861,2453,10,0,0,10
1162,478,1169,350,128,114,166,90,108,159,132,147,40,322,156,80,149,80,169,51,220,248,370,280,0,0,0,0
1163,1347,3641,1209,138,217,527,215,388,385,411,438,113,920,427,112,224,252,759,173,712,754,1072,930,0,0,0,0
1164,2012,5887,1867,145,249,746,350,667,357,664,775,216,1461,551,144,73,180,1615,207,1253,1058,1921,1448,51,0,0,51
1165,2735,7859,2543,192,352,1011,463,909,861,723,945,206,1840,895,409,305,362,1659,316,1723,1536,2485,1799,43,0,0,43
1166,4055,11558,3643,412,573,1392,760,1330,827,1382,1565,281,2467,1588,258,397,841,2559,453,2680,2320,3761,2344,23,0,0,23
1167,4216,11439,3717,499,724,1535,652,1305,926,1666,1367,257,2572,1644,652,546,738,2280,457,2513,2233,3554,2682,16,0,0,16
1168,3516,8472,2499,1017,994,1074,622,826,575,1624,1141,176,2383,1133,532,623,724,1637,369,1685,2379,2738,1301,0,0,0,0
1169,2255,6630,1842,413,356,682,420,797,355,869,859,172,1301,954,175,268,677,1135,301,1605,1644,1975,1105,29,0,0,29
1170,3234,8362,1856,1378,722,996,622,894,343,1549,1075,267,1940,1294,264,620,994,1356,507,1655,2932,2324,944,0,0,0,0
1171,3088,9515,2505,583,330,929,601,1228,520,798,1523,247,1642,1446,382,354,517,1835,355,2286,2281,3112,1481,16,0,0,16
1172,2179,6407,1606,573,357,659,380,783,313,617,992,257,1161,1018,271,356,440,1112,353,1428,1976,1800,850,13,0,0,13
1173,1471,4549,1263,208,181,410,324,556,138,514,635,184,748,723,179,159,353,780,197,1126,1207,1358,661,13,0,0,13
1174,1925,5236,1491,434,396,586,360,583,515,446,693,271,1289,636,323,241,295,1066,182,1096,1191,1623,1144,11,0,0,11
1175,5679,16644,3180,2499,939,1425,1219,2096,663,2594,2042,380,2875,2804,801,992,1189,2697,953,4154,5488,4391,1658,0,0,0,0
1176,15522,50092,11977,3545,1663,3581,3240,7038,1767,5926,6490,1339,7586,7936,1695,1766,2762,9299,1966,14102,12501,15866,5657,143,0,0,143
1177,6696,18163,5585,1111,1166,2714,1040,1776,1523,2407,2037,729,4458,2238,1033,1345,1695,2623,837,3445,4448,5392,4041,0,0,0,0
1178,15203,46829,11851,3352,2532,4265,2579,5827,2884,5373,4546,2400,8915,6288,2356,3854,3867,5126,2406,10831,13324,12748,7520,151,0,0,151
1179,8462,27904,5860,2602,1110,2161,1535,3656,1118,3466,2581,1297,3976,4486,1680,2018,2286,2478,1771,6902,9142,6885,3204,69,0,0,69
1180,5296,18628,4115,1181,565,1254,1018,2459,746,1961,2024,565,2905,2391,1193,1109,1652,1342,1261,4585,6651,4384,1747,15,0,0,15
1181,2083,5650,1628,455,520,646,318,599,449,891,587,156,1472,611,468,614,505,496,322,1064,1772,1571,921,24,0,0,24
1182,3862,11394,2495,1367,865,986,706,1305,611,1136,1153,962,2258,1604,1129,881,979,873,705,2431,3856,2904,1498,52,0,0,52
1183,1208,3767,931,277,197,329,242,440,249,647,188,124,791,417,327,401,298,182,229,749,1240,969,580,16,0,0,16
1184,1602,5417,1249,353,173,468,296,665,219,547,664,172,1007,595,304,390,446,462,236,1036,1819,1634,692,18,0,0,18
1185,5781,19662,4650,1131,652,1572,1092,2465,683,1709,2552,837,3293,2488,873,1200,1994,1714,1110,4259,6440,5561,2292,46,0,0,46
1186,5648,19218,4014,1634,785,1395,1110,2358,803,2253,1554,1038,3596,2052,1379,1506,1413,1350,998,3966,6237,5395,2622,22,0,0,22
1187,2604,8011,1751,853,510,773,461,860,706,1143,402,353,1590,1014,544,1036,649,375,463,1606,2573,2076,1293,0,0,0,0
1188,3038,9383,1553,1485,647,790,523,1078,851,1046,649,492,1925,1113,1240,917,527,354,648,2076,3281,2153,1225,31,0,0,31
1189,2481,7184,704,1777,572,616,466,827,447,1218,598,218,1485,996,1236,712,270,263,517,1556,2681,1657,773,59,0,0,59
1190,1597,4461,263,1334,376,446,299,476,327,716,396,158,801,796,873,478,187,59,363,1121,1732,934,311,8,0,0,8
1191,1853,6016,851,1002,319,460,353,721,374,581,601,297,1159,694,753,618,316,166,456,1459,2111,1333,657,0,0,0,0
1192,1371,4636,989,382,202,395,243,531,249,404,554,164,938,433,222,551,382,216,255,939,1594,1178,670,15,0,0,15
1193,2705,7655,1158,1547,625,748,531,801,384,1033,1031,257,1756,949,842,1135,383,345,516,1571,2806,1794,968,30,0,0,30
1194,1678,4612,997,681,471,455,277,475,467,504,389,318,1178,500,694,356,407,221,215,855,1386,1191,965,0,0,0,0
1195,5292,18689,4192,1100,608,1441,954,2289,631,1893,1655,1113,3540,1752,1209,1117,1231,1735,897,3951,5777,5404,2660,125,0,0,125
1196,2845,9167,1808,1037,466,808,518,1053,352,920,952,621,1747,1098,358,670,1040,777,501,1705,3218,2386,1357,23,0,0,23
1197,1150,3886,490,660,175,263,245,467,108,517,323,202,575,575,528,259,179,184,285,1016,1374,795,416,10,0,0,10
1198,1538,4594,682,856,326,475,283,454,261,699,381,197,971,567,408,525,383,222,269,864,1630,1208,623,216,0,0,216
1199,3342,9468,1325,2017,894,825,550,1073,563,1070,1568,141,2230,1112,1134,1194,795,219,645,2008,3296,2028,1491,22,0,0,22
1200,2904,9278,1863,1041,461,887,519,1037,366,1205,907,426,1767,1137,519,950,938,497,539,1788,3191,2456,1304,43,0,0,43
1201,1269,4738,926,343,123,300,267,579,185,407,413,264,679,590,234,431,429,175,313,1036,1714,1112,563,7,0,0,7
1202,1001,3624,443,558,121,203,206,471,158,309,317,217,525,476,420,306,248,27,242,911,1333,774,364,9,0,0,9
1203,1630,5805,790,840,250,340,290,750,279,530,530,291,925,705,642,423,249,316,388,1385,2157,1300,575,23,0,0,23
1204,958,3007,398,560,219,218,145,376,307,269,236,146,624,334,513,191,189,65,191,651,1085,689,391,0,0,0,0
1205,1400,3789,818,582,403,405,201,391,387,489,421,103,1025,375,491,491,258,160,203,680,1254,1047,605,1,0,0,1
1206,1839,6254,858,981,318,403,337,781,419,601,469,350,1176,663,779,427,346,287,451,1466,2308,1474,555,8,0,0,8
1207,1827,6574,1321,506,244,430,296,857,146,723,473,485,1120,707,305,793,501,228,385,1509,2309,1614,757,0,0,0,0
1208,2558,8466,1159,1399,509,605,438,1006,383,1033,627,515,1522,1036,942,764,470,382,580,2101,3151,1875,759,18,0,0,18
1209,1721,6050,707,1014,268,382,340,731,185,639,590,307,892,829,529,740,323,129,403,1474,2326,1309,538,23,0,0,23
1210,1857,7342,1205,652,191,372,321,973,214,654,749,240,860,997,733,565,348,211,431,1861,2764,1666,620,3,0,0,3
1211,1689,4106,1031,658,445,556,284,404,374,660,595,60,1235,454,452,435,375,427,231,731,1266,1188,690,6,0,0,6
1212,2165,4486,1318,847,839,809,225,292,563,1016,481,105,1839,326,773,455,588,349,146,606,1069,1328,1337,0,0,0,0
1213,1128,2745,796,332,274,405,185,264,191,490,406,41,869,259,202,151,314,461,87,462,743,805,648,17,0,0,17
1214,1514,3806,1054,460,350,541,242,381,349,547,453,165,1072,442,425,256,327,506,190,713,1060,1021,822,15,0,0,15
1215,1966,4927,1249,717,499,650,322,495,403,873,534,156,1276,690,421,508,409,628,213,903,1413,1392,1006,1,0,0,1
1216,1297,3167,1036,261,328,457,183,329,211,564,390,132,990,307,196,298,427,376,135,504,838,934,756,0,0,0,0
1217,1843,5719,1669,174,155,653,349,686,257,567,829,190,1008,835,225,336,461,821,260,1175,1491,1827,966,0,0,0,0
1218,2168,5919,1207,961,475,699,434,560,396,653,847,272,1345,823,542,626,541,459,313,894,2070,1479,1163,11,0,0,11
1219,1189,3347,876,313,237,441,193,318,252,569,296,72,894,295,288,337,244,320,139,523,976,965,744,36,0,0,36
1220,3073,8084,2324,749,749,1050,539,735,624,1061,1056,332,2399,674,674,722,858,819,323,1073,2415,2502,1771,0,0,0,0
1221,1577,4971,964,613,320,444,308,505,237,594,441,305,922,655,500,489,344,244,291,1015,1782,1205,678,0,0,0,0
1222,1299,3851,521,778,403,417,189,290,231,643,318,107,1052,247,311,423,394,171,173,779,1625,781,493,647,644,0,3
1223,1170,3581,658,512,304,240,215,411,124,734,277,35,749,421,588,341,202,39,225,744,1237,928,447,21,0,0,21
1224,1556,3009,145,1411,832,374,148,202,634,713,178,31,1273,283,1143,280,93,40,186,454,966,704,699,110,0,0,110
1225,1202,2780,341,861,436,341,197,228,182,796,200,24,814,388,630,296,145,131,170,457,1023,744,386,0,0,0,0
1226,1190,3590,512,678,285,312,201,392,333,315,330,212,934,256,436,480,206,68,239,712,1382,845,412,8,0,0,8
1227,1276,3468,711,565,322,401,203,350,184,635,345,112,848,428,384,503,347,42,212,605,1224,907,520,5,0,0,5
1228,777,2278,486,291,174,243,115,245,107,257,333,80,476,301,193,218,196,170,125,402,732,651,368,36,0,0,36
1229,1530,4356,803,727,324,458,259,489,242,535,561,192,955,575,494,521,325,190,284,875,1491,1000,706,9,0,0,9
1230,2510,7246,1541,969,608,746,432,724,652,808,612,438,1943,567,752,631,663,464,337,1253,2156,1926,1574,38,0,0,38
1231,1198,3596,710,488,262,359,185,392,211,509,323,155,843,355,316,588,203,91,203,661,1243,909,580,27,0,0,27
1232,1212,3743,530,682,278,334,222,378,217,511,272,212,878,334,483,423,178,128,207,756,1329,970,481,93,0,0,93
1233,1273,3258,899,374,311,451,194,317,232,502,492,47,898,375,258,484,317,214,174,502,990,942,650,0,0,0,0
1234,1521,4146,470,1051,457,415,225,424,346,764,255,156,1033,488,791,405,186,139,265,833,1603,1002,443,29,0,0,29
1235,1166,2800,298,868,412,356,141,257,277,705,169,15,816,350,650,325,125,66,169,502,1008,772,349,10,0,0,10
1236,1558,3880,530,1028,492,487,219,360,273,782,441,62,1184,374,628,550,321,59,259,698,1430,980,513,29,0,0,29
1237,1041,2899,609,432,238,295,183,325,135,320,437,149,667,374,330,350,268,93,172,576,1055,770,326,0,0,0,0
1238,353,1205,232,121,38,134,77,104,63,175,86,29,286,67,23,108,129,93,63,182,509,295,156,182,181,0,1
1239,1029,3630,741,288,106,242,256,425,83,241,572,133,763,266,60,368,337,264,145,564,1186,1000,735,26,0,0,26
1240,1434,5462,973,461,209,312,249,664,210,686,277,261,940,494,287,617,362,168,345,1085,1837,1377,818,122,0,0,122
1241,1286,3210,427,859,507,354,129,296,343,594,320,29,951,335,859,236,103,88,147,566,937,813,747,186,0,0,186
1242,2276,6182,1325,951,548,748,400,580,454,859,721,242,1719,557,604,738,466,468,335,1072,1973,1665,1137,13,0,0,13
1243,1828,5158,898,930,487,480,352,509,575,557,519,177,1264,564,698,579,349,202,289,931,1693,1267,978,72,0,0,72
1244,1733,6310,1157,576,269,421,341,702,322,499,639,273,1059,674,435,667,416,215,355,1313,2084,1593,965,70,0,0,70
1245,1689,6075,1193,496,245,386,354,704,327,635,538,189,928,761,522,511,372,284,334,1229,2094,1509,909,14,0,0,14
1246,3632,11219,2655,977,537,1188,696,1211,635,1398,1219,380,2409,1223,616,823,1160,1033,463,1716,3461,3339,2240,52,0,0,52
1247,4253,13965,3639,614,464,1161,819,1809,441,1213,1979,620,2601,1652,567,954,1166,1566,837,2882,4603,3921,1722,51,0,0,51
1248,3642,10523,3069,573,676,1130,620,1216,584,987,1781,290,1990,1652,410,747,1096,1389,533,2164,2878,3059,1889,0,0,0,0
1249,2198,6258,1349,849,432,695,346,725,311,593,979,315,1450,748,351,576,772,499,354,1186,2178,1623,917,15,0,0,15
1250,1779,5574,841,938,347,468,346,618,290,877,511,101,950,829,614,713,309,143,373,1159,2071,1397,574,48,0,0,48
1251,2415,7229,1598,817,431,683,474,827,531,1196,530,158,1676,739,1015,670,365,365,408,1378,2397,1977,1069,22,0,0,22
1252,862,3857,17,845,22,221,204,415,0,474,383,5,265,597,165,472,176,49,507,946,2262,132,10,943,0,943,0
1253,1320,4301,1067,253,168,369,236,547,94,390,517,319,714,606,222,354,460,284,245,872,1520,1133,531,0,0,0,0
1254,1918,6312,1481,437,237,536,421,724,186,661,755,316,1266,652,252,735,596,335,344,1253,2144,1592,979,9,0,0,9
1255,1801,5477,914,887,375,503,286,637,304,654,601,242,1169,632,566,510,473,252,338,1051,2073,1304,711,0,0,0,0
1256,1738,5188,1199,539,369,434,359,576,408,608,442,280,1352,386,695,476,417,150,285,1018,1719,1273,893,0,0,0,0
1257,2292,7072,1217,1075,472,625,413,782,457,795,637,403,1430,862,622,1000,552,118,432,1524,2515,1664,937,0,0,0,0
1258,1330,4310,564,766,232,353,241,504,158,620,449,103,774,556,422,595,218,95,281,1077,1551,974,427,0,0,0,0
1259,1815,5578,719,1096,415,454,295,651,420,617,498,280,1080,735,813,590,291,121,413,1303,2099,1105,658,19,0,0,19
1260,1162,3865,409,753,170,266,260,466,171,702,248,41,566,596,536,469,119,38,318,965,1492,772,318,3,0,0,3
1261,1347,4385,947,400,201,364,297,485,315,347,508,177,895,452,375,454,315,203,260,903,1639,1059,524,22,0,0,22
1262,688,1897,138,550,193,186,93,216,95,328,209,56,464,224,233,325,95,35,130,396,744,426,201,39,0,0,39
1263,997,2948,371,626,280,196,176,345,215,351,351,80,601,396,462,365,140,30,170,604,1009,714,451,23,0,0,23
1264,1991,6156,679,1312,377,557,370,687,239,973,562,217,1067,924,825,625,373,168,496,1418,2357,1319,566,0,0,0,0
1265,1256,3631,508,748,277,390,216,373,88,542,367,259,708,548,314,387,389,166,261,768,1305,825,472,36,22,0,14
1266,1491,4964,801,690,258,380,269,584,312,532,355,292,805,686,489,577,341,84,284,1148,1837,1146,549,4,0,0,4
1267,1313,3624,980,333,296,419,193,405,315,432,320,246,993,320,259,376,417,261,180,644,1050,937,813,0,0,0,0
1268,4365,11451,3042,1323,954,1613,681,1117,993,1327,1594,451,3165,1200,753,1054,1097,1461,466,1804,3149,3570,2462,20,0,0,20
1269,4025,10839,2312,1713,1079,1231,680,1035,1219,1424,827,555,3136,889,1156,1238,879,752,562,1811,3356,2742,2368,49,0,0,49
1270,6238,20532,4795,1443,785,1794,1267,2392,996,1876,2024,1342,3641,2597,950,1439,2027,1822,1183,4309,7069,5341,2630,11,0,0,11
1271,5535,17005,4385,1150,744,1683,1066,2042,624,2117,2192,602,3200,2335,735,1401,1732,1667,1048,3735,5684,4550,1988,16,0,0,16
1272,4,23,3,1,0,1,2,1,4,0,0,0,0,4,4,0,0,0,0,0,12,8,3,0,0,0,0
1273,1630,4477,985,645,371,489,330,440,330,793,341,166,1218,412,603,528,260,239,224,844,1499,1245,665,19,0,0,19
1274,2443,6170,1114,1329,716,779,403,545,556,687,873,327,1753,690,764,934,508,237,389,1096,2254,1460,971,0,0,0,0
1275,1330,3525,644,686,327,401,259,343,238,589,386,117,978,352,353,508,303,166,217,669,1466,772,401,0,0,0,0
1276,1329,3934,668,661,241,455,228,405,140,543,475,171,844,485,219,521,441,148,230,833,1561,866,444,0,0,0,0
1277,2101,6183,1516,585,369,641,436,655,385,644,894,178,1304,797,300,640,733,428,402,1252,2027,1601,901,10,0,0,10
1278,1511,4506,1266,245,196,495,313,507,290,258,580,383,916,595,173,405,462,471,358,866,1644,1106,532,0,0,0,0
1279,3363,9468,2181,1182,670,1169,538,986,554,1203,1302,304,2201,1162,570,976,959,858,578,1671,3496,2374,1349,26,0,0,26
1280,4970,10902,3258,1712,1886,1666,526,892,1456,1899,858,757,4090,880,1289,1306,1266,1109,416,1502,2551,2816,3617,0,0,0,0
1281,2559,6674,962,1597,633,838,440,648,297,942,1117,203,1706,853,519,1082,655,303,461,1253,2983,1324,653,0,0,0,0
1282,4869,14694,3214,1655,706,1503,976,1684,684,1771,1935,479,3029,1840,1143,1100,1231,1395,894,3394,4599,4031,1776,77,0,0,77
1283,1618,4239,960,658,391,498,293,436,291,767,455,105,1026,592,561,505,386,166,245,917,1441,1007,629,0,0,0,0
1284,2141,5453,1308,833,547,725,341,528,597,576,612,356,1639,502,523,553,556,509,266,1026,1829,1383,949,24,0,0,24
1285,1898,4959,1663,235,351,731,316,500,419,837,445,197,1275,623,284,442,497,675,237,884,1230,1384,1224,0,0,0,0
1286,1750,4751,1431,319,283,720,329,418,497,497,624,132,1411,339,267,537,384,562,152,718,1126,1539,1216,6,0,0,6
1287,340,969,169,171,66,118,50,106,89,115,91,45,252,88,83,121,43,93,47,160,282,294,186,1,0,0,1
1288,3910,11629,2803,1107,562,1189,795,1364,518,1406,1115,871,2137,1773,875,1383,1162,490,636,2419,3746,3120,1708,4,0,0,4
1289,2961,8852,1728,1233,631,751,505,1074,364,1184,1054,359,1751,1210,862,939,573,587,605,1934,3076,2098,1139,0,0,0,0
1290,5438,11496,4277,1161,1690,2452,537,759,2704,1884,595,255,4998,440,1843,1894,1121,580,428,1208,2252,2754,4854,6,0,0,6
1291,3572,12384,2619,953,511,794,640,1627,403,1038,1325,806,1932,1640,659,920,900,1093,531,2919,3882,3397,1655,14,0,0,14
1292,3011,10664,2319,692,358,760,522,1371,362,768,1226,655,1733,1278,629,714,860,808,507,2285,3333,2989,1550,69,0,0,69
1293,2204,5599,1127,1077,599,776,345,484,381,897,590,336,1380,824,615,540,530,519,276,956,1844,1322,1201,25,0,0,25
1294,24,68,3,21,12,3,4,5,3,21,0,0,18,6,24,0,0,0,5,16,13,34,0,22,0,0,22
1295,2962,8392,1685,1277,669,964,497,832,449,1219,955,339,1983,979,831,852,732,547,440,1662,2944,2186,1160,105,0,0,105
1296,1588,3608,987,601,437,689,228,234,416,730,408,34,1308,280,343,336,319,590,152,498,1039,1043,876,16,0,0,16
1297,3441,9073,1374,2067,997,1034,550,860,379,1279,1373,410,2284,1157,1008,1055,853,525,486,1724,3300,2091,1472,28,0,0,28
1298,685,2609,190,495,237,216,105,127,51,252,329,53,549,136,114,211,195,165,64,302,1096,921,226,998,0,0,998
1299,1087,2302,295,792,483,330,113,161,247,561,224,55,862,225,443,340,195,109,98,287,962,550,405,57,0,0,57
1300,836,2331,401,435,244,234,116,242,138,375,250,73,544,292,315,253,148,120,130,435,847,607,312,52,0,0,52
1301,1286,3284,589,697,385,408,188,305,158,579,491,58,873,413,343,487,214,242,157,619,1126,905,477,20,0,0,20
1302,2463,7646,1329,1134,462,663,403,935,360,840,947,316,1467,996,491,798,594,580,486,1698,2665,1820,977,23,0,0,23
1303,1225,3103,1084,141,247,491,187,300,323,416,324,162,854,371,170,220,434,401,130,499,643,943,888,0,0,0,0
1304,2763,7420,1452,1311,782,828,397,756,608,960,726,469,1996,767,1019,749,600,395,391,1394,2351,1855,1429,0,0,0,0
1305,1741,5163,823,918,356,502,297,586,168,567,800,206,976,765,419,626,474,222,260,1115,1893,1353,542,9,0,0,9
1306,5012,13044,3540,1472,1311,1682,777,1242,1288,1525,1582,617,3722,1290,1387,1216,1049,1360,552,2216,3595,3581,3100,25,0,0,25
1307,2786,7123,1912,874,718,1020,393,655,645,842,1021,278,2055,731,644,525,804,813,310,1170,1935,2054,1654,44,34,0,10
1308,1561,3953,1293,268,295,676,212,378,413,559,391,198,1261,300,254,395,434,478,175,596,849,1241,1092,34,0,0,34
1309,156,296,129,27,64,60,17,15,56,44,50,6,123,33,72,29,29,26,7,27,38,76,148,0,0,0,0
1310,1072,2427,685,387,464,418,74,116,376,486,183,27,958,114,416,290,172,194,36,108,263,411,1609,467,0,0,467
1311,2633,6381,2167,466,575,1174,382,502,774,770,889,200,2255,378,444,451,665,1073,192,816,1283,1953,2137,106,0,0,106
1312,759,1864,571,188,202,280,125,152,129,376,218,36,591,168,258,213,197,91,85,299,538,595,347,39,4,0,35
1313,1692,4875,950,742,450,663,236,343,227,796,609,60,1246,446,415,337,537,403,150,851,1599,1173,1102,679,565,0,114
1314,2356,5475,1293,1063,766,782,258,550,478,1260,527,91,1764,592,586,427,448,895,187,993,1341,1486,1468,45,21,0,24
1315,808,1962,509,299,197,363,80,168,187,293,249,79,628,180,209,151,171,277,60,256,461,532,653,20,0,0,20
1316,277,656,184,93,73,121,26,57,36,100,98,43,232,45,46,59,74,98,16,74,155,201,210,42,0,0,42
1317,2243,5552,1246,997,678,727,253,585,364,1123,504,252,1765,478,679,601,496,467,258,976,1520,1443,1355,37,0,0,37
1318,2092,4821,1467,625,611,827,277,377,471,1098,431,92,1850,242,338,316,482,956,161,607,1138,1354,1561,54,0,0,54
1319,3529,9635,1868,1661,905,1155,490,979,642,1252,851,784,2326,1203,891,902,913,823,535,1994,3049,2484,1573,44,0,0,44
1320,2612,5569,1515,1097,934,939,327,412,658,1057,758,139,2238,374,659,786,472,695,211,713,1251,1592,1802,47,0,0,47
1321,2631,6855,1587,1044,700,960,377,594,744,1179,498,210,2239,392,769,795,580,487,305,1202,1950,1943,1455,16,0,0,16
1322,35,66,30,5,12,19,2,2,15,14,4,2,33,2,6,4,3,22,1,5,7,17,36,0,0,0,0
1323,3886,8274,2364,1522,1422,1400,430,634,1505,1320,949,112,3182,704,1133,1009,782,962,250,1145,1756,2222,2901,3,0,0,3
1324,1887,3765,1490,397,695,820,174,198,574,771,375,167,1709,178,627,413,327,520,88,375,529,969,1804,4,0,0,4
1325,3636,9365,2189,1447,803,1345,587,901,749,1122,1301,464,2503,1133,517,998,917,1204,423,1699,2841,2577,1825,12,0,0,12
1326,2027,5327,1674,353,362,742,373,550,393,765,738,131,1489,538,432,474,309,812,220,1031,1207,1626,1243,24,0,0,24
1327,2044,4814,1142,902,589,731,326,398,442,842,600,160,1519,525,573,520,430,521,209,778,1303,1389,1135,0,0,0,0
1328,1759,5003,1114,645,359,664,307,429,323,600,633,203,1113,646,374,435,328,622,226,834,1586,1304,1053,286,0,286,0
1329,1415,3454,914,501,357,551,194,313,249,695,367,104,994,421,464,258,271,422,112,502,865,1073,902,0,0,0,0
1330,1460,3502,1015,445,369,525,249,317,344,596,291,229,1082,378,304,340,369,447,160,574,961,1016,791,21,0,0,21
1331,2056,5248,937,1119,592,635,328,501,301,804,816,135,1348,708,536,564,624,332,274,1054,1862,1267,791,9,0,0,9
1332,2157,4878,880,1277,794,718,289,356,526,574,931,126,1609,548,522,607,489,539,188,690,1636,1389,975,155,0,0,155
1333,1550,4535,1026,524,292,453,293,512,244,705,426,175,1124,426,251,693,398,208,231,941,1511,1146,706,33,0,0,33
1334,1581,4470,1258,323,274,542,301,464,307,501,452,321,1040,541,255,437,447,442,226,765,1299,1263,917,0,0,0,0
1335,2944,7403,1613,1331,930,861,441,712,960,902,766,316,2228,716,1031,727,654,532,401,1119,2306,1835,1742,21,0,0,21
1336,5505,14499,4097,1408,1307,1795,908,1495,1419,1756,1801,529,3960,1545,1167,1420,1240,1678,650,2821,3833,4344,2851,4,0,0,4
1337,3252,8191,1743,1509,930,1081,473,768,868,1326,578,480,2587,665,1115,992,473,672,410,1341,2790,2239,1411,24,0,0,24
1338,1532,3754,879,653,450,504,240,338,253,665,457,157,1128,404,570,420,284,258,182,624,1326,1019,603,7,0,0,7
1339,2120,5418,1238,882,529,694,321,576,335,1092,574,119,1618,502,559,593,677,291,257,909,2017,1359,876,3,0,0,3
1340,2530,6965,1482,1048,480,850,501,699,238,653,1399,240,1756,774,500,721,637,672,372,1198,2900,1744,751,11,0,0,11
1341,2430,6644,1707,723,507,817,481,625,512,946,832,140,1801,629,553,560,633,684,327,1087,2405,1699,1126,101,100,0,1
1342,1521,7052,786,735,333,503,294,391,214,480,625,202,1188,333,440,520,356,205,218,1441,3725,1117,551,2870,2855,0,15
1343,1620,4593,839,781,373,457,289,501,281,827,385,127,1015,605,578,602,289,151,263,801,1851,1153,525,40,0,0,40
1344,2315,5689,646,1669,793,649,338,535,540,758,737,280,1682,633,840,852,477,146,360,1046,2294,1235,754,9,0,0,9
1345,1651,3902,932,719,499,519,286,347,337,573,551,190,1165,486,423,604,436,188,236,557,1420,909,780,0,0,0,0
1346,2112,4998,1185,927,643,771,264,434,446,390,1044,232,1572,540,511,535,549,517,190,725,1626,1176,1281,5,0,0,5
1347,1938,5365,1427,511,345,676,388,529,305,797,525,311,1353,585,340,496,602,500,266,914,1792,1482,911,31,0,0,31
1348,3782,10702,1419,2363,1055,938,625,1164,728,1319,1453,282,2551,1231,1746,1304,517,215,688,2411,4108,2344,1151,40,0,0,40
1349,2632,8454,1359,1273,506,712,471,943,365,1003,909,355,1462,1170,661,1113,574,284,546,1938,3140,2023,807,105,0,0,105
1350,3066,7115,1686,1380,1000,1064,424,578,590,1163,1137,176,2197,869,796,745,855,670,325,1094,2097,1921,1678,43,0,0,43
1351,1382,3725,1079,303,296,518,248,320,226,530,463,163,956,426,139,323,376,544,154,629,1019,952,971,123,0,0,123
1352,1260,3140,1184,76,182,625,209,244,338,341,461,120,984,276,239,182,294,545,86,477,526,925,1126,21,0,0,21
1353,3818,6384,2942,876,1693,1784,158,183,2524,923,254,117,3682,136,1072,1077,823,846,43,218,390,1087,4646,0,0,0,0
1354,2996,7905,2513,483,572,1163,442,819,660,1326,792,218,2182,814,457,662,702,1175,281,1497,1708,2427,1992,37,0,0,37
1355,1526,3578,1061,465,430,548,268,280,428,611,330,157,1108,418,547,396,376,207,115,576,1009,959,919,21,0,0,21
1356,3069,7322,1668,1401,1021,941,463,644,934,952,1025,158,2298,771,968,776,588,737,357,1338,2205,1683,1739,60,0,0,60
1357,1748,4484,857,891,443,592,277,436,289,653,595,211,1168,580,510,356,461,421,227,867,1569,1102,719,32,0,0,32
1358,3237,7638,1422,1815,1011,1149,431,646,993,947,1032,265,2526,711,1008,941,904,384,355,1270,2314,1829,1870,54,0,0,54
1359,2197,5220,1453,744,598,851,368,380,277,949,876,95,1524,673,236,722,635,604,267,782,1626,1483,1062,25,0,0,25
1360,1401,2976,479,922,568,423,205,205,370,503,460,68,1037,364,592,399,262,148,118,429,1149,760,520,36,0,0,36
1361,1099,2167,133,966,549,333,97,120,155,620,212,112,865,234,441,452,132,74,118,332,1000,483,234,28,0,0,28
1362,1894,3730,702,1192,823,634,204,233,522,916,373,83,1614,280,795,416,424,259,118,494,1200,908,1010,8,0,0,8
1363,916,2194,380,536,266,301,148,201,145,323,316,132,717,199,241,320,226,129,86,264,909,678,257,5,0,0,5
1364,1758,3929,645,1113,564,623,277,294,224,708,696,130,1297,461,606,509,459,184,201,607,1550,1004,567,21,0,0,21
1365,1804,4219,1426,378,496,686,285,337,584,732,370,118,1456,348,297,476,452,579,161,613,944,1191,1310,41,0,0,41
1366,3127,7472,2129,998,809,1316,420,582,1181,816,946,184,2468,659,597,629,718,1183,211,1018,1510,2124,2609,266,0,0,266
1367,2057,5249,1463,594,554,717,319,467,751,553,672,81,1597,460,660,652,342,403,230,882,1457,1459,1221,58,0,0,58
1368,1950,4994,957,993,530,655,292,473,296,901,611,142,1308,642,481,523,516,430,234,1017,1599,1356,788,41,0,0,41
1369,1666,4654,1268,398,326,548,320,472,343,544,589,190,1252,414,559,449,446,212,235,778,1575,1342,724,51,0,0,51
1370,3819,10428,2515,1304,849,1246,670,1054,681,1362,1264,512,2727,1092,980,675,1049,1115,581,1838,3482,2770,1757,38,0,0,38
1371,2009,5443,1267,742,448,640,368,553,278,613,684,434,1336,673,311,542,718,438,267,988,1905,1421,862,20,0,0,20
1372,1598,5405,751,847,278,384,288,648,296,501,552,249,956,642,445,479,511,163,338,1242,1973,1213,639,49,0,0,49
1373,2756,7132,650,2106,880,724,433,719,456,1019,1113,168,1705,1051,989,1094,552,121,464,1467,2860,1511,830,57,0,0,57
1374,2887,7598,807,2080,805,884,486,712,564,959,838,526,2248,639,1054,775,649,409,451,1531,3227,1516,873,22,0,0,22
1375,2926,7550,1875,1051,849,935,421,721,438,1147,1019,322,2017,909,684,1072,733,437,386,1252,2389,1852,1671,79,0,0,79
1376,2090,6764,1064,1026,465,590,345,690,283,754,628,425,1341,749,719,776,458,137,391,1373,2505,1728,767,181,0,0,181
1377,2076,5999,996,1080,481,626,398,571,323,880,691,182,1327,749,780,664,484,148,347,1192,2361,1402,697,22,0,0,22
1378,2809,9206,1081,1728,574,648,433,1154,525,869,959,456,1673,1136,1139,957,526,187,552,2220,3450,2105,879,72,0,0,72
1379,1456,5675,679,777,167,299,263,727,134,320,506,496,583,873,399,473,442,142,338,1419,2120,1250,548,41,0,0,41
1380,2468,8851,1361,1107,352,599,434,1083,472,634,1041,321,1440,1028,778,808,633,249,548,2118,3142,2256,787,130,0,0,130
1381,3788,12578,2195,1593,718,1034,655,1381,641,1174,1351,622,2262,1526,995,1382,805,606,701,2504,4680,3325,1368,385,0,0,385
1382,2453,6787,1926,527,543,878,413,619,505,853,826,269,1774,679,568,584,664,637,286,1159,1972,1849,1521,21,0,0,21
1383,2443,6179,1782,661,535,1045,395,468,633,827,720,263,2081,362,635,332,534,942,201,828,1446,1754,1950,14,0,0,14
1384,2683,6281,1536,1147,776,908,447,552,599,819,922,343,1855,828,614,780,828,461,202,1078,1607,1760,1634,16,0,0,16
1385,2052,4923,1334,718,599,741,327,385,569,728,539,216,1630,422,655,450,480,467,173,720,1099,1385,1546,0,0,0,0
1386,1729,4076,1119,610,541,604,224,360,538,653,403,135,1367,362,545,448,381,355,157,624,1029,1154,1112,40,0,0,40
1387,1918,4921,1372,546,422,803,295,398,501,672,555,190,1348,570,478,484,570,386,182,643,1226,1431,1439,0,0,0,0
1388,459,1169,341,118,107,189,69,94,150,185,76,48,348,111,70,110,131,148,41,158,297,304,369,0,0,0,0
1389,1908,4289,1357,551,542,840,252,274,590,767,397,154,1594,314,340,491,457,620,141,462,954,1252,1480,14,0,0,14
1390,1600,3256,1050,550,626,606,195,173,604,567,360,69,1391,209,634,463,252,251,109,297,775,1151,924,39,0,0,39
1391,1765,3969,1019,746,621,681,195,268,665,484,466,150,1505,260,593,512,341,319,129,547,1104,1269,920,126,0,0,126
1392,1868,4295,1361,507,580,708,261,319,559,482,743,84,1255,613,483,581,435,369,161,589,1045,1260,1240,0,0,0,0
1393,1516,3441,1131,385,466,602,226,222,387,472,518,139,1222,294,415,389,351,361,133,407,902,1037,962,0,0,0,0
1394,2990,9526,2270,720,395,912,580,1103,362,746,1467,415,1513,1477,449,582,924,1035,473,2090,2907,2731,1325,69,0,0,69
1395,3322,9072,2303,1019,806,1038,516,962,823,1150,812,537,2199,1123,927,733,997,665,413,1749,2684,2413,1813,46,0,0,46
1396,3685,10167,3022,663,728,1246,624,1087,807,1055,1349,474,2523,1162,756,864,972,1093,443,1938,2565,3141,2080,90,0,0,90
1397,2198,5258,1435,763,628,811,250,509,686,733,612,167,1772,426,575,669,508,446,208,802,1349,1475,1424,0,0,0,0
1398,1577,3710,1005,572,375,672,218,312,358,600,542,77,1188,389,443,403,308,423,159,526,920,1074,1031,0,0,0,0
1399,1667,4506,745,922,431,541,211,484,304,654,604,105,1194,473,476,479,332,380,243,834,1564,1127,738,26,0,0,26
1400,953,2279,696,257,236,413,130,174,276,325,274,78,744,209,174,190,219,370,70,259,473,663,814,40,0,0,40
1401,1335,3518,886,449,299,589,180,267,354,343,505,133,1121,214,275,270,341,449,111,470,890,1104,943,34,0,0,34
1402,4032,10634,2568,1464,989,1347,591,1105,810,1484,1367,371,2980,1052,1217,1028,1045,742,527,1878,3244,2735,2250,25,0,0,25
1403,1881,3865,1442,439,636,858,186,201,765,683,424,9,1629,252,610,645,315,311,108,305,741,1112,1599,44,0,0,44
1404,1054,2675,900,154,233,447,174,200,323,320,338,73,881,173,212,172,171,499,79,383,534,819,860,55,0,0,55
1405,1085,2909,857,228,212,397,180,296,177,433,336,139,702,383,178,213,200,494,124,492,771,904,618,35,0,0,35
1406,675,1555,566,109,154,301,99,121,128,183,327,37,539,136,96,88,159,332,59,178,279,561,478,0,0,0,0
1407,2642,6807,1683,959,795,715,472,660,720,950,753,219,1825,817,731,717,504,690,346,1388,1820,1923,1330,126,0,0,126
1408,2293,5546,1577,716,613,892,296,492,471,825,786,211,1803,490,342,836,508,607,227,905,1411,1512,1491,0,0,0,0
1409,3090,7871,2164,926,828,1023,489,750,587,1156,1105,242,2293,797,438,795,678,1179,360,1349,2046,2303,1813,21,0,0,21
1410,2063,5293,1094,969,564,650,371,478,503,637,690,233,1323,740,692,436,459,476,281,1017,1798,1429,768,29,0,0,29
1411,2583,6527,1493,1090,791,802,395,595,981,624,688,290,1963,620,893,495,512,683,324,1088,1806,1761,1548,82,0,0,82
1412,4115,11080,2361,1754,962,1367,700,1086,1057,1462,1333,263,2989,1126,1151,1131,733,1100,563,2118,3163,3062,2174,127,0,0,127
1413,934,2278,803,131,211,388,145,190,326,246,323,39,772,162,237,206,226,265,65,378,447,708,680,15,0,0,15
1414,2724,7338,2358,366,455,1086,457,726,666,960,835,263,1905,819,527,493,464,1240,287,1333,1569,2195,1954,41,0,0,41
1415,1613,3789,955,658,515,594,216,288,341,701,486,85,1338,275,416,285,374,538,140,520,887,1091,1151,27,0,0,27
1416,634,1325,365,269,239,242,72,81,241,253,117,23,593,41,238,163,127,106,40,163,272,352,498,3,0,0,3
1417,143,357,86,57,36,54,26,27,25,65,47,6,93,50,36,13,25,69,15,62,95,107,78,8,2,0,6
1418,1643,3899,1172,471,467,622,266,288,401,623,384,235,1399,244,357,325,410,551,122,574,820,1241,1142,19,0,0,19
1419,1314,3108,853,461,354,433,226,301,297,562,369,86,995,319,372,258,283,401,116,591,709,975,717,3,0,0,3
1420,2750,7450,2219,531,504,922,506,818,511,1171,842,226,1679,1071,250,633,600,1267,299,1739,1391,2435,1586,32,10,0,22
1421,3165,7559,1746,1419,1132,908,425,700,1144,1053,672,296,2536,629,1007,814,605,739,356,1273,1948,1905,2077,189,24,0,165
1422,2288,5906,1983,305,513,779,413,583,515,810,783,180,1578,710,356,602,554,776,269,1098,1304,1801,1434,43,0,0,43
1423,2392,6263,1957,435,528,832,418,614,563,726,927,176,1685,707,350,274,427,1341,255,1248,1289,1892,1579,65,0,0,65
1424,1899,4090,812,1087,803,634,225,237,299,712,511,377,1610,289,454,394,540,511,177,554,1475,952,932,17,0,0,17
1425,2407,5906,1606,801,738,834,366,469,685,735,709,278,1831,576,618,469,488,832,237,819,1600,1730,1520,56,0,0,56
1426,2155,5310,1965,190,427,961,323,444,541,578,941,95,1647,508,248,231,432,1244,198,848,929,1573,1762,0,0,0,0
1427,2840,8139,1339,1501,802,879,413,746,764,1147,681,248,2055,785,769,726,384,961,430,1684,2608,1935,1482,604,479,0,125
1428,2640,10441,643,1997,417,470,339,1414,261,781,720,878,1302,1338,826,791,544,479,660,2292,4458,2206,825,68,0,0,68
1429,1846,4587,930,916,505,637,302,402,281,750,711,104,1334,512,414,467,369,596,301,668,1567,1265,786,31,0,0,31
1430,2731,6089,824,1907,1087,805,372,467,514,1339,763,115,2397,334,853,767,476,635,290,791,2243,1755,1010,194,0,0,194
1431,3702,8603,1757,1945,1225,1226,507,744,734,1377,1424,167,2794,908,874,817,811,1200,428,1355,2641,2379,1800,48,4,0,44
1432,2061,4775,1203,858,655,706,255,445,370,672,930,89,1362,699,361,321,389,990,179,861,1118,1535,1082,43,0,0,43
1433,1303,3134,876,427,372,401,240,290,199,511,475,118,890,413,234,257,175,637,155,641,662,1083,593,14,0,0,14
1434,2245,5272,1521,724,614,817,389,425,519,630,978,118,1678,567,544,377,558,766,194,851,1193,1802,1232,14,0,0,14
1435,792,2308,692,100,127,237,121,307,147,348,253,44,433,359,80,75,128,509,116,589,416,674,513,50,0,0,50
1436,1818,4732,1295,523,430,608,282,498,371,868,551,28,1202,616,365,257,256,940,186,1099,936,1455,1056,18,0,0,18
1437,3158,7085,1705,1453,1072,1064,396,626,763,1339,841,215,2400,758,703,626,486,1343,299,1256,1530,2054,1946,0,0,0,0
1438,2057,4977,1150,907,558,638,331,530,350,817,823,67,1540,517,177,455,274,1151,182,664,1615,1736,780,15,0,0,15
1439,0,0,0,0,0,0,0,0,0,0,0,0,0,0,0,0,0,0,0,0,0,0,0,0,0,0,0
1440,2925,6570,1745,1180,982,984,393,566,710,1194,802,219,1953,972,653,420,472,1380,235,1225,1382,2121,1607,13,0,0,13
1441,2492,6084,1542,950,689,776,416,611,687,960,790,55,1498,994,334,495,393,1270,306,1262,1501,1880,1135,4,0,0,4
1442,2319,5924,1660,659,583,691,397,648,438,978,759,144,1447,872,249,294,361,1415,257,1419,1110,1945,1193,11,0,0,11
1443,2027,4446,1146,881,831,583,239,374,633,838,468,88,1507,520,302,353,470,902,163,800,882,1322,1279,114,0,0,114
1444,1903,4198,873,1030,743,634,214,312,491,739,592,81,1414,489,378,513,291,721,178,731,1032,1217,1040,108,102,0,6
1445,2487,6240,1538,949,648,763,403,673,366,1045,920,156,1710,777,332,234,461,1460,239,1451,1289,1949,1312,2,0,0,2
1446,2459,5800,1574,885,663,936,314,546,594,1277,532,56,1749,710,285,306,520,1348,232,1046,1124,1698,1700,0,0,0,0
1447,896,2120,641,255,245,321,105,225,267,353,246,30,598,298,119,108,110,559,65,435,297,612,711,0,0,0,0
1448,4370,7894,2275,2095,1904,1725,410,331,1126,2121,1037,86,3961,409,768,757,1087,1758,265,541,2152,2685,2251,157,0,0,157
1449,1137,2720,273,864,341,386,196,214,163,649,307,18,718,419,489,195,160,293,138,533,992,692,365,19,0,0,19
1450,2726,6841,1981,745,651,959,466,650,415,1118,1021,172,1577,1149,223,417,423,1663,339,1370,1589,2183,1360,22,0,0,22
1451,1917,4851,1540,377,480,626,292,519,429,655,729,104,1141,776,292,224,261,1140,209,1053,936,1621,1032,0,0,0,0
1452,1913,4536,1289,624,573,637,259,444,330,863,606,114,1340,573,237,285,284,1107,189,862,988,1526,971,13,0,0,13
1453,272,677,166,106,68,103,50,51,47,125,89,11,177,95,68,25,47,132,28,117,180,205,147,15,4,0,11
1454,986,2116,584,402,378,354,130,124,289,436,161,100,874,112,375,182,125,304,57,246,453,550,810,27,0,0,27
