"TAZ","TOTHH","TOTPOP","hh_own","hh_rent","hh_size_1","hh_size_2","hh_size_3","hh_size_4_plus","hh_wrks_0","hh_wrks_1","hh_wrks_2","hh_wrks_3_plus","hh_kids_no","hh_kids_yes","HHINCQ1","HHINCQ2","HHINCQ3","HHINCQ4","AGE0004","AGE0519","AGE2044","AGE4564","AGE65P","gq_tot_pop","gq_type_univ","gq_type_mil","gq_type_othnon"
1,39,95,0,39,8,22,4,5,22,4,10,3,31,8,20,9,4,6,0,12,15,58,10,11,2,0,9
2,124,298,0,124,24,73,12,15,70,14,31,9,99,25,64,28,12,20,0,36,49,180,33,33,5,0,28
3,336,563,0,336,188,124,24,0,83,204,38,11,306,30,148,43,70,75,8,108,265,142,40,39,6,0,33
4,173,300,32,141,108,43,14,8,51,92,23,7,155,18,61,28,46,38,12,10,150,83,45,24,3,0,21
5,480,800,100,380,334,97,31,18,170,211,77,22,419,61,187,77,103,113,28,21,359,238,154,81,12,0,69
6,2166,3513,133,2033,1594,459,28,85,268,1490,390,18,2071,95,665,564,305,632,14,466,2103,657,273,375,375,0,0
7,3209,4515,56,3153,2403,617,103,86,1421,1347,410,31,3083,126,1936,677,419,177,105,203,2188,1308,711,988,39,0,949
8,4505,9609,93,4412,2758,696,454,597,2294,1427,533,251,3824,681,3042,840,558,65,427,1207,3093,2662,2220,2934,0,0,2934
9,6210,10451,144,6066,4265,962,548,435,2008,3013,980,209,5623,587,3171,1440,871,728,345,787,4893,3171,1255,1280,172,0,1108
10,3837,7152,831,3006,2055,1100,362,320,1152,1666,814,205,3301,536,1133,814,767,1123,421,453,3850,1527,901,1123,327,0,796
11,2206,4008,225,1981,1524,430,50,202,572,1017,535,82,1923,283,1163,340,387,316,76,251,2157,1114,410,726,0,0,726
12,552,992,216,336,176,341,35,0,211,151,190,0,515,37,70,17,66,399,36,0,533,230,193,21,0,0,21
13,67,80,62,5,54,10,3,0,16,37,14,0,64,3,25,1,2,39,4,0,9,55,12,2,0,0,2
14,501,621,452,49,396,79,24,2,116,272,112,1,479,22,182,15,19,285,29,2,90,408,92,13,0,0,13
15,231,553,43,188,95,70,30,36,8,88,118,17,211,20,29,68,65,69,43,29,335,120,26,28,0,0,28
16,4915,8906,1519,3396,1957,2464,340,154,522,1850,2415,128,4711,204,501,348,796,3270,132,187,6565,1396,626,151,0,0,151
17,3806,6773,1413,2393,1748,1782,257,19,748,1969,1013,76,3581,225,666,461,732,1947,230,112,4006,1577,848,281,92,0,189
18,879,2015,248,631,459,312,23,85,81,559,198,41,812,67,80,212,205,382,83,76,1233,455,168,188,0,0,188
19,734,1759,166,568,284,282,136,32,118,269,288,59,638,96,193,63,71,407,83,40,1086,349,201,273,0,0,273
20,2203,4448,623,1580,1067,704,227,205,426,1101,577,99,1955,248,685,279,418,821,129,376,2425,1249,269,441,11,0,430
21,3244,5139,801,2443,1985,990,131,138,1425,1279,476,64,3101,143,1822,229,495,698,52,164,1893,925,2105,219,10,0,209
22,1129,1864,86,1043,651,330,68,80,304,655,152,18,1024,105,99,154,236,640,134,80,969,278,403,35,0,0,35
23,663,1244,321,342,309,265,29,60,195,359,98,11,595,68,188,96,88,291,0,121,289,346,488,23,0,0,23
24,552,1117,76,476,271,90,172,19,372,110,67,3,465,87,450,46,0,56,6,230,141,386,354,11,0,0,11
25,1327,3137,108,1219,359,489,348,131,462,599,197,69,968,359,958,202,122,45,103,371,950,766,947,14,0,0,14
26,738,1695,11,727,309,166,164,99,215,344,146,33,647,91,446,137,117,38,18,134,638,495,410,9,0,0,9
27,1383,2862,113,1270,742,314,91,236,546,576,170,91,1233,150,799,243,151,190,80,236,991,674,881,39,0,0,39
28,1651,2865,366,1285,801,650,74,126,459,666,494,32,1511,140,317,292,350,692,81,153,1405,657,569,13,0,0,13
29,2906,5037,367,2539,1627,964,155,160,657,1479,759,11,2715,191,864,778,609,655,131,234,2643,1077,952,97,79,0,18
30,4183,7461,286,3897,2646,1070,298,169,1586,1974,554,69,3775,408,2267,995,439,482,302,409,3489,2081,1180,339,0,0,339
31,2449,4014,257,2192,1430,798,143,78,614,1214,578,43,2393,56,900,754,401,394,104,11,2577,992,330,134,14,0,120
32,2857,4720,234,2623,1504,1073,252,28,612,1352,755,138,2725,132,696,762,733,666,94,73,2523,1121,909,47,0,0,47
33,2658,4525,796,1862,1334,888,386,50,755,863,954,86,2435,223,890,440,490,838,139,106,2319,1188,773,23,0,0,23
34,2408,4509,354,2054,1119,819,253,217,522,900,666,320,2295,113,515,279,553,1061,69,143,2863,659,775,0,0,0,0
35,2401,4613,444,1957,878,1141,295,87,580,764,845,212,2301,100,769,357,278,997,95,96,2564,805,1053,0,0,0,0
36,2658,5076,239,2419,1211,789,525,133,1111,1063,362,122,2324,334,1761,496,165,236,126,302,1499,1547,1602,93,0,0,93
37,1734,3072,163,1571,995,407,185,147,431,888,304,111,1571,163,818,343,260,313,56,225,1325,849,617,48,0,0,48
38,2264,4445,763,1501,1039,768,132,325,581,1012,611,60,1873,391,490,334,272,1168,426,301,1816,1361,541,14,0,0,14
39,2099,3947,452,1647,840,794,375,90,464,910,593,132,1862,237,417,333,442,907,133,186,1615,1125,888,1,0,0,1
40,2392,4332,773,1619,1116,987,205,84,448,1061,834,49,2214,178,331,250,628,1183,96,221,2160,1069,786,25,0,0,25
41,2132,4007,386,1746,1038,722,222,150,797,903,378,54,1783,349,1003,323,341,465,176,484,1726,793,828,88,0,0,88
42,626,3136,0,626,138,149,111,228,107,162,127,230,494,132,209,130,92,195,96,573,1960,455,52,637,0,68,569
43,2729,4932,741,1988,1315,1060,161,193,475,1313,889,52,2354,375,341,308,681,1399,158,515,2796,915,548,14,0,0,14
44,3246,6138,617,2629,1495,1133,393,225,446,1335,1249,216,2848,398,345,467,579,1855,394,271,3842,1011,620,34,34,0,0
45,2132,4201,537,1595,992,673,240,227,240,1154,542,196,1794,338,296,155,486,1195,398,217,2577,643,366,12,0,0,12
46,3912,7000,1025,2887,1996,1246,380,290,790,1920,989,213,3481,431,498,506,659,2249,342,514,3934,1248,962,112,84,0,28
47,1641,2471,429,1212,1099,410,49,83,288,993,358,2,1523,118,251,275,343,772,80,125,1327,547,392,18,0,0,18
48,1919,3477,511,1408,944,719,119,137,347,1017,537,18,1674,245,273,145,526,975,104,338,1464,956,615,12,0,0,12
49,2213,3931,898,1315,1129,808,180,96,593,1077,497,46,2032,181,273,275,456,1209,102,314,1259,1192,1064,18,9,0,9
50,2138,4618,723,1415,900,676,331,231,323,961,764,90,1698,440,194,229,257,1458,406,481,2226,841,664,40,0,0,40
51,2145,4021,601,1544,756,1173,117,99,331,926,848,40,1934,211,251,275,336,1283,82,265,2237,1061,376,0,0,0,0
52,1331,3952,0,1331,199,352,362,418,170,415,557,189,845,486,67,215,184,865,478,599,2002,724,149,0,0,0,0
53,28,38,0,28,17,11,0,0,0,21,7,0,28,0,11,0,14,3,0,0,31,7,0,214,0,0,214
54,2843,7126,1393,1450,1037,788,492,526,989,700,863,291,2175,668,738,594,497,1014,332,1018,2709,1547,1520,90,0,0,90
55,1462,3294,738,724,468,666,89,239,419,560,412,71,1211,251,346,356,261,499,58,337,1247,951,701,0,0,0,0
56,32,242,25,7,14,14,2,2,12,6,12,2,25,7,3,7,5,17,2,3,25,51,161,0,0,0,0
57,878,2348,656,222,191,319,144,224,201,262,342,73,588,290,86,74,151,567,137,432,519,682,578,0,0,0,0
58,2523,5229,740,1783,985,977,270,291,752,902,707,162,1996,527,748,555,563,657,237,523,1726,1532,1211,54,0,0,54
59,3198,8277,1539,1659,999,801,616,782,722,1067,1013,396,2422,776,644,592,648,1314,509,938,2937,2334,1559,21,0,0,21
60,1607,3654,679,928,526,563,247,271,439,543,526,99,1227,380,311,465,296,535,170,411,1228,1030,815,6,0,0,6
61,2048,4848,827,1221,689,573,389,397,488,756,709,95,1543,505,549,417,405,677,302,619,1967,1144,816,0,0,0,0
62,2980,6968,1063,1917,992,1028,492,468,718,1060,1103,99,2303,677,564,581,779,1056,315,753,2804,1687,1409,13,0,0,13
63,2234,5121,1004,1230,694,745,388,407,423,673,1038,100,1607,627,295,313,616,1010,358,616,1837,1408,902,16,0,0,16
64,2752,6462,964,1788,746,962,594,450,544,1019,1057,132,2085,667,587,523,411,1231,528,594,2847,1233,1260,14,0,0,14
65,2387,5464,949,1438,787,836,478,286,478,862,913,134,1894,493,280,550,342,1215,224,604,2049,1441,1146,71,0,0,71
66,1682,4228,604,1078,580,448,249,405,373,464,574,271,1279,403,332,338,368,644,134,504,1926,1074,590,0,0,0,0
67,1936,4838,568,1368,530,612,336,458,403,617,714,202,1438,498,268,354,383,931,296,526,2349,1041,626,100,89,0,11
68,1381,2988,347,1034,569,452,172,188,474,500,278,129,1217,164,457,275,201,448,41,381,1237,594,735,31,0,0,31
69,2527,8270,979,1548,699,881,505,442,374,779,1005,369,2014,513,285,405,594,1243,392,1709,4204,1267,698,2257,2134,0,123
70,2994,6186,943,2051,1262,934,380,418,577,1103,1039,275,2460,534,496,421,618,1459,253,586,3236,1468,643,6,0,0,6
71,1954,4284,841,1113,580,739,298,337,545,883,438,88,1456,498,490,207,307,950,249,643,1263,1089,1040,19,0,0,19
72,1026,2293,368,658,467,261,240,58,216,404,287,119,866,160,135,210,168,513,120,110,1288,414,361,27,0,0,27
73,2071,3824,628,1443,1265,371,326,109,738,714,410,209,1838,233,632,360,394,685,208,167,1865,738,846,0,0,0,0
74,2249,3708,162,2087,1387,660,173,29,1249,608,311,81,2179,70,965,219,419,646,73,44,1583,426,1582,54,0,0,54
75,1720,2799,534,1186,984,571,140,25,564,753,361,42,1649,71,342,336,278,764,8,58,1430,547,756,16,0,0,16
76,1713,2460,369,1344,1141,496,62,14,500,925,279,9,1713,0,520,273,519,401,0,0,1088,634,738,372,0,0,372
77,2129,5245,586,1543,738,757,404,230,547,843,561,178,1743,386,751,268,392,718,106,879,2064,1207,989,236,0,0,236
78,2734,4973,236,2498,1614,653,159,308,1678,665,242,149,2492,242,1711,482,324,217,54,544,1457,1203,1715,40,0,0,40
79,1862,3250,371,1491,924,650,221,67,215,963,568,116,1804,58,292,398,231,941,59,64,2104,750,273,67,1,0,66
80,1885,3942,369,1516,829,629,214,213,399,729,638,119,1655,230,499,315,359,712,213,208,2172,992,357,58,0,0,58
81,3920,7705,745,3175,1813,1364,373,370,491,1785,1340,304,3584,336,797,817,621,1685,259,596,4744,1610,496,224,0,0,224
82,1660,3061,533,1127,855,507,135,163,364,767,435,94,1471,189,423,306,172,759,64,277,1680,798,242,30,0,0,30
83,2144,4138,1105,1039,716,1110,141,177,374,794,921,55,1875,269,265,161,280,1438,51,397,1767,1289,634,20,0,0,20
84,2336,5277,487,1849,674,1029,320,313,225,586,1236,289,2049,287,239,244,358,1495,157,342,3364,1080,334,64,0,0,64
85,1704,4162,226,1478,572,609,226,297,172,686,641,205,1436,268,197,198,349,960,289,150,2708,732,283,28,0,0,28
86,3017,6663,644,2373,1160,1167,327,363,607,1189,1055,166,2641,376,622,585,621,1189,256,421,3706,1426,854,105,0,0,105
87,2260,5317,716,1544,669,1131,247,213,396,871,829,164,1940,320,380,310,474,1096,94,478,3135,1057,553,144,24,0,120
88,2510,5300,478,2032,898,996,389,227,283,1047,913,267,2293,217,404,360,517,1229,56,437,3339,863,605,91,19,0,72
89,3397,8020,1173,2224,1050,1309,537,501,540,1211,1446,200,2710,687,361,605,666,1765,729,757,3890,1734,910,138,0,0,138
90,2035,4792,444,1591,738,686,348,263,290,882,711,152,1781,254,246,458,757,574,370,127,2919,863,513,166,109,0,57
91,2096,4726,896,1200,856,752,280,208,530,885,609,72,1694,402,397,237,281,1181,170,563,2371,959,663,487,473,0,14
92,1026,3787,754,272,277,311,176,262,292,250,391,93,756,270,204,134,161,527,35,542,841,1137,1232,19,0,0,19
93,3985,7519,1567,2418,1727,1581,367,310,810,1666,1239,270,3642,343,655,741,857,1732,163,417,3243,2563,1133,6,0,0,6
94,1340,2970,526,814,402,579,172,187,255,483,534,68,1069,271,209,166,188,777,141,351,1176,948,354,14,0,0,14
95,1423,2984,797,626,525,560,173,165,302,541,538,42,1172,251,190,195,294,744,197,304,1353,693,437,10,0,0,10
96,1112,2561,511,601,229,557,149,177,146,469,470,27,842,270,80,202,232,598,122,306,1010,748,375,16,0,0,16
97,1714,3500,668,1046,586,718,249,161,352,658,623,81,1413,301,256,208,245,1005,243,214,1563,911,569,0,0,0,0
98,1998,3959,928,1070,859,652,272,215,327,848,716,107,1636,362,226,291,314,1167,172,394,1792,1018,583,0,0,0,0
99,1849,3820,713,1136,803,675,162,209,496,741,474,138,1610,239,390,287,365,807,61,382,1981,723,673,116,0,0,116
100,1690,4098,296,1394,606,543,339,202,250,674,624,142,1350,340,410,424,192,664,225,281,2146,956,490,83,27,0,56
101,2673,6266,474,2199,1097,874,292,410,660,792,898,323,2283,390,677,617,545,834,217,525,3192,1609,723,49,0,0,49
102,2524,5387,706,1818,894,1047,291,292,327,918,1144,135,2211,313,390,320,523,1291,197,361,2865,1398,566,129,0,0,129
103,2796,5608,1291,1505,1082,1235,233,246,771,872,900,253,2608,188,580,465,392,1359,76,240,2052,2336,904,32,0,0,32
104,2142,3474,876,1266,1272,641,147,82,360,1161,549,72,1981,161,365,279,403,1095,82,142,1749,1163,338,23,0,0,23
105,3087,6033,734,2353,1490,922,392,283,637,1059,1156,235,2733,354,747,500,500,1340,62,611,3367,1296,697,120,0,0,120
106,3246,7234,641,2605,1343,1173,467,263,737,1070,1075,364,3025,221,894,541,718,1093,106,364,3438,2332,994,728,0,0,728
107,938,2080,196,742,297,416,131,94,82,458,337,61,774,164,200,159,197,382,71,181,1097,596,135,733,0,0,733
108,897,1693,172,725,378,388,64,67,251,222,394,30,795,102,324,104,65,404,34,202,959,272,226,220,168,0,52
109,3422,7568,1452,1970,1304,1272,454,392,365,1413,1218,426,2858,564,731,384,276,2031,356,969,4175,1400,668,356,142,0,214
110,2642,6819,841,1801,491,1412,260,479,277,854,1470,41,2090,552,504,227,468,1443,821,468,4498,674,358,869,848,0,21
111,2042,3849,424,1618,775,955,172,140,56,906,1050,30,1773,269,101,174,449,1318,173,244,2827,561,44,575,551,0,24
112,1063,2152,432,631,387,406,191,79,147,443,353,120,902,161,191,130,133,609,83,155,1313,407,194,8,0,0,8
113,2604,5272,1282,1322,998,1004,353,249,685,1040,770,109,2107,497,566,285,493,1260,351,409,2420,1342,750,22,0,0,22
114,1694,3764,953,741,502,715,247,230,269,572,749,104,1333,361,209,230,216,1039,251,345,1928,842,398,62,0,0,62
115,744,2369,307,437,184,319,100,141,71,341,237,95,600,144,112,225,87,320,77,211,1119,484,478,131,0,0,131
116,1819,4950,849,970,587,505,427,300,280,658,646,235,1373,446,326,331,316,846,282,502,2360,1074,732,186,0,0,186
117,1468,4430,639,829,399,448,240,381,134,590,514,230,1029,439,230,205,377,656,267,798,2125,740,500,28,0,0,28
118,1427,4386,370,1057,305,474,176,472,207,414,599,207,957,470,455,303,296,373,211,728,2355,727,365,22,0,0,22
119,714,2096,312,402,123,304,114,173,125,185,285,119,562,152,149,82,115,368,103,185,1058,480,270,17,0,0,17
120,1087,2850,409,678,264,442,173,208,185,290,478,134,904,183,246,225,50,566,116,223,1560,607,344,35,0,0,35
121,1355,3408,825,530,252,576,280,247,214,538,545,58,956,399,154,377,294,530,283,345,1386,879,515,60,0,0,60
122,2365,5457,1596,769,711,771,540,343,629,706,860,170,1780,585,585,430,295,1055,477,499,1540,2261,680,26,0,0,26
123,1615,4302,840,775,432,605,267,311,190,625,621,179,1273,342,195,291,411,718,214,375,2091,1016,606,23,0,0,23
124,1346,3819,634,712,242,481,267,356,144,454,685,63,851,495,227,321,188,610,375,644,1366,1099,335,34,0,0,34
125,1103,3294,753,350,212,464,124,303,175,361,446,121,844,259,222,154,242,485,107,393,1058,1098,638,6,0,0,6
126,1291,4303,756,535,170,389,399,333,217,400,482,192,725,566,284,198,203,606,267,803,1515,1239,479,0,0,0,0
127,1776,4121,1057,719,462,752,306,256,344,499,731,202,1436,340,147,227,315,1087,260,407,1817,1033,604,7,0,0,7
128,2501,5802,1125,1376,893,803,351,454,264,1003,1090,144,1941,560,229,371,550,1351,332,703,2720,1460,587,24,0,0,24
129,2055,4414,1116,939,769,727,265,294,345,933,696,81,1649,406,167,205,456,1227,286,433,1829,1178,688,0,0,0,0
130,1801,4602,1256,545,512,640,304,345,468,684,600,49,1270,531,441,287,306,767,300,872,1213,1373,844,0,0,0,0
131,2633,6795,2231,402,546,1014,508,565,827,692,1014,100,1853,780,387,533,486,1227,347,1060,1798,1889,1701,0,0,0,0
132,1512,4140,1089,423,265,477,356,414,432,386,461,233,1119,393,308,249,293,662,175,513,1229,1242,981,0,0,0,0
133,2398,6286,1564,834,486,831,586,495,467,613,1004,314,1877,521,350,298,519,1231,200,718,2232,1834,1302,13,0,0,13
134,2333,8338,1823,510,361,639,368,965,393,821,591,528,1539,794,329,432,616,956,408,1306,2885,2242,1497,46,0,0,46
135,1780,6416,1037,743,287,313,392,788,251,582,568,379,1236,544,385,411,467,517,146,1067,2817,1538,848,0,0,0,0
136,988,3683,788,200,169,257,233,329,183,248,361,196,772,216,199,185,199,405,98,472,1292,901,920,11,0,0,11
137,1528,4968,1014,514,231,349,505,443,189,379,697,263,1047,481,347,371,337,473,303,656,1775,1410,824,20,0,0,20
138,2765,9484,1790,975,435,811,465,1054,473,816,964,512,2072,693,567,738,713,747,264,1370,2740,3199,1911,32,0,0,32
139,1288,5719,777,511,156,237,277,618,347,241,277,423,816,472,318,457,311,202,253,1067,1964,1596,839,37,0,0,37
140,1234,4157,968,266,305,278,208,443,320,268,363,283,913,321,336,297,233,368,213,483,1538,1173,750,0,0,0,0
141,783,3063,351,432,81,220,118,364,142,294,198,149,510,273,162,225,179,217,112,416,1340,853,342,57,0,0,57
142,156,315,24,132,87,26,29,14,61,42,47,6,114,42,56,33,25,42,39,11,170,54,41,564,0,0,564
143,324,943,127,197,77,141,37,69,74,70,103,77,182,142,121,87,75,41,0,129,168,296,350,29,0,0,29
144,1421,4232,457,964,564,260,153,444,432,630,259,100,955,466,836,253,165,167,577,878,1382,917,478,23,0,0,23
145,1271,3793,42,1229,370,325,153,423,452,577,144,98,693,578,941,290,38,2,366,1241,1219,664,303,20,0,0,20
146,525,1172,325,200,194,152,105,74,82,248,182,13,341,184,94,104,147,180,87,217,530,279,59,0,0,0,0
147,1204,4222,842,362,221,307,158,518,266,239,402,297,795,409,295,276,280,353,75,708,1511,1300,628,184,0,0,184
148,1140,4039,714,426,225,351,69,495,306,471,128,235,607,533,508,138,256,238,239,1011,1482,600,707,22,0,0,22
149,1671,4890,1100,571,322,519,436,394,330,523,571,247,1157,514,439,418,270,544,380,542,2023,1360,585,110,0,0,110
150,1307,3950,659,648,295,377,205,430,395,359,346,207,894,413,505,288,330,184,148,632,1217,1240,713,106,0,0,106
151,646,2129,313,333,215,149,61,221,223,105,231,87,487,159,283,86,121,156,91,217,835,695,291,18,0,0,18
152,1409,4053,1115,294,292,427,297,393,312,413,441,243,1083,326,253,261,330,565,192,453,1341,1280,787,37,0,0,37
153,1189,4547,860,329,167,256,294,472,208,300,376,305,854,335,241,338,258,352,65,657,1664,1407,754,0,0,0,0
154,1129,3581,785,344,257,239,323,310,252,343,385,149,927,202,310,300,272,247,88,318,845,1414,916,11,0,0,11
155,1049,3842,812,237,133,278,224,414,203,352,262,232,624,425,230,349,218,252,244,642,1266,1034,656,12,0,0,12
156,690,2507,368,322,92,160,146,292,101,213,185,191,457,233,203,210,153,124,105,355,923,716,408,0,0,0,0
157,790,2756,231,559,139,261,128,262,261,315,105,109,464,326,473,144,88,85,143,670,911,838,194,0,0,0,0
158,365,1017,78,287,150,111,17,87,170,95,53,47,259,106,249,52,16,48,67,250,293,188,219,1,0,0,1
159,1554,5004,1133,421,367,389,287,511,468,363,503,220,1173,381,399,492,375,288,236,710,1521,1676,861,26,0,0,26
160,1417,4920,970,447,198,422,187,610,150,539,508,220,924,493,157,605,322,333,238,911,1433,1536,802,0,0,0,0
161,1137,3839,674,463,96,392,302,347,162,259,457,259,820,317,188,370,221,358,166,468,1541,958,706,6,0,0,6
162,1424,5345,879,545,153,515,228,528,357,408,491,168,1002,422,372,487,342,223,74,749,1539,1532,1451,17,0,0,17
163,1298,4559,1058,240,303,216,245,534,262,324,366,346,827,471,211,464,225,398,256,568,1494,1455,786,4,0,0,4
164,2019,7567,1250,769,242,500,371,906,305,543,619,552,1406,613,377,459,530,653,250,873,2484,2473,1487,32,0,0,32
165,1978,6746,1326,652,322,504,318,834,292,572,737,377,1339,639,457,509,441,571,183,964,2130,2218,1251,0,0,0,0
166,2658,9145,1511,1147,580,683,413,982,390,897,869,502,2003,655,727,601,555,775,298,1120,3522,2638,1567,35,0,0,35
167,1858,7116,1452,406,241,353,384,880,241,465,650,502,1099,759,398,431,452,577,415,1073,2580,1909,1139,60,0,0,60
168,3259,8404,2434,825,1047,799,748,665,635,1250,863,511,2626,633,650,827,903,879,123,910,3203,2288,1880,36,0,0,36
169,2327,6590,2229,98,511,558,536,722,459,850,768,250,1545,782,335,534,308,1150,158,1272,1562,1968,1630,18,11,0,7
170,2010,5907,1472,538,507,539,358,606,540,590,680,200,1425,585,269,325,357,1059,207,827,2097,1536,1240,41,0,0,41
171,931,2463,795,136,173,363,168,227,156,342,369,64,707,224,60,95,189,587,178,267,756,737,525,12,0,0,12
172,2221,5307,1926,295,417,1152,176,476,940,553,557,171,1764,457,322,447,538,914,111,639,1284,1574,1699,0,0,0,0
173,1344,3697,967,377,319,458,245,322,312,405,456,171,1030,314,180,221,237,706,161,468,1333,927,808,0,0,0,0
174,2439,6129,1446,993,817,611,576,435,578,954,744,163,1893,546,524,341,386,1188,300,570,2358,1724,1177,14,0,0,14
175,1969,4209,502,1467,628,901,182,258,386,807,686,90,1639,330,236,447,458,828,214,383,2055,966,591,12,0,0,12
176,2007,4131,633,1374,773,722,343,169,493,849,544,121,1552,455,521,358,470,658,241,510,1662,798,920,55,43,0,12
177,3289,9259,1500,1789,701,1049,803,736,632,1168,1140,349,2562,727,569,648,746,1326,310,1033,3988,2366,1562,129,0,0,129
178,2436,6721,1580,856,433,916,555,532,550,920,641,325,1947,489,547,487,452,950,354,671,2240,1875,1581,16,0,0,16
179,2859,8476,1660,1199,583,690,585,1001,669,866,913,411,2033,826,500,749,505,1105,342,1251,3118,2222,1543,7,0,0,7
180,1777,4878,657,1120,487,550,235,505,279,698,542,258,1281,496,488,445,380,464,225,616,2140,1152,745,4,0,0,4
181,1849,5305,1423,426,362,664,305,518,395,552,663,239,1405,444,367,356,477,649,297,522,1791,1470,1225,0,0,0,0
182,2430,7431,1934,496,479,600,564,787,630,831,636,333,1592,838,458,378,599,995,399,1191,2698,1789,1354,17,0,0,17
183,2590,7157,1837,753,574,768,407,841,722,641,854,373,1869,721,657,323,648,962,483,848,2429,1782,1615,24,0,0,24
184,2976,8971,2344,632,602,954,445,975,788,917,808,463,2264,712,537,648,688,1103,547,1075,2571,2631,2147,8,0,0,8
185,2828,8285,1829,999,658,793,596,781,820,834,652,522,2232,596,643,635,589,961,354,787,2741,2144,2259,7,0,0,7
186,2884,8363,1982,902,672,866,537,809,620,1022,833,409,2092,792,356,671,578,1279,304,1253,2695,2504,1607,29,0,0,29
187,1415,3980,1222,193,256,503,254,402,434,381,439,161,939,476,299,240,222,654,167,662,1009,1239,903,0,0,0,0
188,665,3852,18,647,145,197,195,128,102,250,142,171,600,65,317,102,154,92,16,1925,1418,395,98,626,574,0,52
189,3139,6816,93,3046,1222,986,444,487,1023,1400,390,326,2774,365,1316,629,576,618,122,790,3189,1385,1330,0,0,0,0
190,1005,1897,254,751,556,242,96,111,309,509,139,48,801,204,265,310,251,179,88,274,833,384,318,42,0,0,42
191,1362,4035,1054,308,227,526,178,431,430,344,462,126,1015,347,259,331,283,489,169,630,1326,1058,852,13,0,0,13
192,2649,8390,314,2335,684,552,555,858,321,994,838,496,1694,955,837,900,696,216,653,1239,4233,1709,556,10,0,0,10
193,2121,6773,1041,1080,267,617,559,678,312,641,842,326,1280,841,390,509,580,642,516,852,2658,1713,1034,76,0,0,76
194,2113,6952,1368,745,401,711,337,664,529,533,609,442,1574,539,356,591,595,571,165,978,2250,1851,1708,194,0,0,194
195,1793,5927,1517,276,190,591,394,618,285,508,597,403,1334,459,229,352,497,715,231,1003,1927,1656,1110,9,0,0,9
196,2036,6708,1745,291,236,599,291,910,321,526,838,351,1426,610,211,645,497,683,348,776,2348,1856,1380,7,0,0,7
197,1849,6506,1467,382,354,405,370,720,306,440,414,689,1397,452,409,317,378,745,276,730,2212,1959,1329,18,0,0,18
198,1622,5221,374,1248,366,379,381,496,216,510,618,278,1155,467,541,369,379,333,193,742,1933,1303,1050,0,0,0,0
199,1120,2490,810,310,428,394,174,124,83,535,440,62,957,163,137,356,401,226,121,174,1029,815,351,1,0,0,1
200,941,2654,649,292,214,279,224,224,168,351,293,129,688,253,204,309,241,187,66,431,738,823,596,26,26,0,0
201,2545,8701,532,2013,745,444,462,894,532,657,1047,309,1530,1015,1012,532,666,335,615,1535,3363,1716,1472,36,0,0,36
202,2233,7701,1446,787,293,890,295,755,531,534,621,547,1605,628,415,648,520,650,227,987,2913,1723,1851,20,0,0,20
203,1502,4845,582,920,222,533,206,541,224,567,348,363,1115,387,321,450,438,293,52,603,2131,1329,730,0,0,0,0
204,2123,6344,1402,721,277,952,459,435,442,481,926,274,1642,481,697,388,561,477,191,613,2678,1544,1318,59,0,0,59
205,2376,8171,1911,465,414,593,405,964,495,656,530,695,1809,567,436,435,801,704,229,737,2905,2693,1607,13,0,0,13
206,1320,3883,1026,294,384,284,267,385,475,225,376,244,983,337,298,197,288,537,74,612,1189,1336,672,0,0,0,0
207,1058,4246,742,316,113,234,225,486,171,262,360,265,681,377,294,252,241,271,168,748,1460,1182,688,0,0,0,0
208,2090,5175,1423,667,782,596,221,491,612,657,722,99,1574,516,410,405,373,902,290,861,1503,1614,907,14,0,0,14
209,2596,7756,2117,479,390,880,495,831,386,924,987,299,1871,725,287,667,662,980,313,1062,2449,2259,1673,19,0,0,19
210,1072,3710,356,716,169,272,167,464,208,329,302,233,641,431,346,310,256,160,151,757,1316,969,517,0,0,0,0
211,2874,7903,575,2299,874,823,440,737,547,1143,773,411,1907,967,758,1145,410,561,529,1334,3069,2022,949,83,0,0,83
212,1286,4419,889,397,167,387,247,485,142,442,353,349,819,467,309,151,297,529,175,782,1399,1482,581,25,0,0,25
213,2791,7636,1636,1155,805,903,460,623,885,626,987,293,2194,597,600,635,723,833,305,974,2620,1938,1799,31,0,0,31
214,2205,6141,1823,382,430,788,454,533,414,571,979,241,1681,524,369,561,631,644,354,751,2146,1895,995,62,0,0,62
215,2050,6256,982,1068,389,668,373,620,360,784,751,155,1415,635,397,558,569,526,206,1282,2159,1912,697,12,0,0,12
216,1419,3488,794,625,372,587,211,249,209,482,647,81,1047,372,321,277,395,426,58,619,1092,1241,478,7,0,0,7
217,1320,4502,1188,132,141,393,347,439,219,284,640,177,826,494,129,213,369,609,258,748,1483,1155,858,64,0,0,64
218,1473,4373,823,650,401,465,115,492,482,370,381,240,1134,339,434,376,245,418,313,500,1552,927,1081,18,0,0,18
219,2053,6814,1656,397,292,556,416,789,487,555,588,423,1483,570,372,409,494,778,319,863,2167,1690,1775,11,0,0,11
220,1896,5653,1223,673,368,586,393,549,247,628,719,302,1246,650,370,353,532,641,228,936,2227,1528,734,20,0,0,20
221,1528,4825,1103,425,227,442,351,508,313,326,641,248,1015,513,288,224,377,639,281,775,1442,1399,928,0,0,0,0
222,1702,4109,1003,699,471,584,416,231,323,628,516,235,1241,461,285,397,385,635,173,560,1492,1210,674,12,0,0,12
223,2012,4575,885,1127,686,716,365,245,269,915,689,139,1644,368,347,462,501,702,119,644,1840,1286,686,31,0,0,31
224,1150,3414,1005,145,154,480,244,272,179,483,355,133,814,336,154,176,202,618,300,453,937,1049,675,0,0,0,0
225,1358,3733,1022,336,287,554,178,339,340,524,394,100,982,376,220,295,313,530,194,796,841,1236,666,0,0,0,0
226,2342,6381,1782,560,446,897,410,589,554,687,852,249,1729,613,241,567,647,887,262,1032,1861,1831,1395,14,0,0,14
227,2101,5819,1624,477,446,775,356,524,836,485,617,163,1394,707,299,561,447,794,386,1081,1242,1450,1660,0,0,0,0
228,100,344,82,18,9,24,40,27,14,29,38,19,63,37,5,3,35,57,8,57,125,101,53,1,0,0,1
229,1793,5528,1342,451,297,568,401,527,265,530,659,339,1125,668,183,235,443,932,201,828,1855,1714,930,24,0,0,24
230,2984,9013,1877,1107,536,1168,581,699,633,801,1108,442,2080,904,556,544,591,1293,452,1162,3093,2899,1407,10,0,0,10
231,1498,5293,1345,153,176,456,278,588,272,443,453,330,1101,397,253,225,332,688,159,631,1663,1453,1387,72,0,0,72
232,1863,5644,1492,371,450,488,385,540,517,541,596,209,1289,574,404,411,408,640,319,780,1883,1388,1274,127,0,0,127
233,3056,7522,2408,648,944,943,586,583,687,1260,981,128,2256,800,481,784,802,989,524,1112,2446,1956,1484,7,0,0,7
234,1599,3164,360,1239,727,499,201,172,283,764,461,91,1307,292,433,348,400,418,83,368,1674,584,455,0,0,0,0
235,1164,3273,946,218,128,548,230,258,281,265,484,134,785,379,173,224,283,484,249,399,999,1017,609,13,0,0,13
236,2127,5701,1387,740,277,1075,309,466,661,467,875,124,1534,593,308,617,467,735,172,1005,1977,1535,1012,42,0,0,42
237,2576,8206,807,1769,738,343,583,912,306,887,753,630,1677,899,665,629,756,526,284,1557,3964,1627,774,31,0,0,31
238,917,4055,721,196,125,183,114,495,142,152,375,248,498,419,100,249,258,310,213,862,1736,906,338,0,0,0,0
239,0,0,0,0,0,0,0,0,0,0,0,0,0,0,0,0,0,0,0,0,0,0,0,0,0,0,0
240,1865,5258,829,1036,579,496,330,460,318,766,596,185,1294,571,466,314,508,577,394,690,1694,1648,832,42,0,0,42
241,1289,3744,972,317,267,414,226,382,394,399,360,136,792,497,268,203,296,522,191,761,751,1111,930,24,0,0,24
242,873,2565,796,77,149,277,179,268,302,136,312,123,607,266,136,143,192,402,98,478,729,696,564,0,0,0,0
243,933,2801,780,153,158,289,103,383,179,267,405,82,659,274,158,94,142,539,103,492,764,846,596,9,0,0,9
244,1901,5349,733,1168,481,459,317,644,503,433,765,200,1315,586,436,296,434,735,179,786,1506,1858,1020,20,0,0,20
245,1209,3098,850,359,316,419,176,298,427,384,329,69,834,375,265,349,183,412,299,300,897,778,824,26,0,0,26
246,2755,8063,1657,1098,707,778,466,804,649,824,1091,191,1828,927,466,456,377,1456,501,1500,2549,1995,1518,129,0,0,129
247,1357,3652,1198,159,335,426,214,382,398,434,471,54,907,450,190,171,305,691,216,711,802,1235,688,10,0,0,10
248,1188,2927,464,724,351,340,285,212,220,437,479,52,756,432,226,227,284,451,226,502,962,801,436,76,0,0,76
249,2670,6662,1335,1335,840,803,467,560,348,1229,898,195,1920,750,370,389,734,1177,180,1209,2503,1981,789,14,0,0,14
250,1929,5120,1089,840,554,493,385,497,378,818,635,98,1142,787,296,296,411,926,297,1249,1539,1266,769,49,0,0,49
251,2608,5530,874,1734,1151,838,147,472,474,1261,796,77,2075,533,488,679,472,969,429,636,2214,1520,731,5,0,0,5
252,1799,6071,1632,167,132,600,246,821,327,696,654,122,942,857,191,141,161,1306,223,1668,1157,1817,1206,11,0,0,11
253,953,2663,750,203,211,320,159,263,293,261,331,68,662,291,123,85,264,481,154,573,671,675,590,0,0,0,0
254,1755,5384,1696,59,214,535,361,645,424,535,629,167,1102,653,75,238,209,1233,191,1225,992,1880,1096,0,0,0,0
255,1275,3310,1079,196,266,466,236,307,366,414,427,68,808,467,154,118,249,754,215,671,663,1089,672,2,0,0,2
256,2276,4491,841,1435,877,854,428,117,729,876,668,3,1822,454,589,407,283,997,193,513,1674,902,1209,10,0,0,10
257,1653,3551,926,727,806,443,189,215,614,518,453,68,1321,332,343,419,302,589,141,543,1181,750,936,149,0,0,149
258,2436,6072,697,1739,843,889,383,321,473,933,898,132,1940,496,634,490,631,681,379,718,2567,1467,941,118,0,0,118
259,2491,5604,1030,1461,980,873,283,355,449,1217,605,220,1851,640,618,616,609,648,288,1035,2775,864,642,17,0,0,17
260,2521,8033,869,1652,505,723,479,814,392,795,973,361,1561,960,775,543,452,751,660,1462,3771,1442,698,51,0,0,51
261,1482,5091,805,677,187,395,350,550,256,362,649,215,873,609,300,249,518,415,546,736,2066,1151,592,8,0,0,8
262,1379,4263,900,479,336,471,149,423,157,661,293,268,1079,300,324,215,338,502,191,528,1566,1211,767,89,0,0,89
263,847,3335,658,189,92,228,146,381,186,234,235,192,533,314,165,107,254,321,173,499,1162,781,720,121,0,0,121
264,1130,3494,1042,88,175,310,311,334,249,300,472,109,796,334,166,165,230,569,147,506,1088,879,874,75,0,0,75
265,1713,3182,869,844,780,577,247,109,337,955,403,18,1391,322,338,386,423,566,189,225,1153,945,670,0,0,0,0
266,3129,7921,990,2139,707,1089,765,568,601,1318,1023,187,2139,990,598,352,530,1649,660,1160,3090,1549,1462,120,0,0,120
267,1422,3798,808,614,239,586,336,261,376,486,500,60,872,550,190,175,351,706,152,758,1112,1070,706,48,0,0,48
268,1325,3564,893,432,215,459,410,241,254,407,553,111,816,509,49,233,259,784,191,567,1320,867,619,0,0,0,0
269,1546,3730,699,847,495,464,260,327,233,742,508,63,1079,467,186,226,363,771,246,577,1492,836,579,4,0,0,4
270,1218,3203,661,557,311,348,247,312,241,531,397,49,786,432,148,175,264,631,149,656,1063,767,568,0,0,0,0
271,1912,5047,1250,662,402,625,452,433,470,709,661,72,1126,786,262,262,425,963,398,970,1796,927,956,47,0,0,47
272,726,2226,600,126,77,298,139,212,177,188,311,50,464,262,40,123,132,431,78,462,532,585,569,3,0,0,3
273,1379,3726,743,636,222,491,392,274,224,515,597,43,852,527,188,211,352,628,193,650,1218,1105,560,0,0,0,0
274,2131,5243,705,1426,649,784,399,299,383,821,720,207,1736,395,368,382,548,833,191,528,2512,1265,747,0,0,0,0
275,1993,4636,652,1341,570,873,223,327,513,620,753,107,1471,522,523,302,404,764,252,759,2049,1021,555,12,0,0,12
276,1187,2677,585,602,331,518,111,227,292,296,529,70,939,248,216,204,370,397,117,281,1231,519,529,3,0,0,3
277,1608,5088,951,657,329,416,342,521,239,468,658,243,993,615,238,206,463,701,389,777,1957,1320,645,74,0,0,74
278,2469,6111,724,1745,605,942,476,446,201,1023,1194,51,1704,765,282,379,474,1334,504,829,3123,1243,412,176,0,0,176
279,1854,4225,882,972,741,530,177,406,303,908,602,41,1317,537,292,551,391,620,228,720,1610,953,714,19,0,0,19
280,1394,3592,923,471,433,406,186,369,293,472,520,109,955,439,107,251,272,764,224,585,1104,1005,674,0,0,0,0
281,1973,4777,918,1055,663,673,253,384,495,655,738,85,1551,422,551,229,412,781,199,661,1843,1345,729,61,0,0,61
282,946,2460,739,207,257,270,152,267,242,303,329,72,617,329,141,164,175,466,137,464,677,663,519,0,0,0,0
283,1230,3770,1036,194,247,320,264,399,222,330,486,192,800,430,153,182,109,786,184,750,1156,1118,562,47,0,0,47
284,1681,4406,505,1176,533,601,191,356,227,721,563,170,1214,467,336,402,414,529,106,935,1850,942,573,21,0,0,21
285,1058,3024,820,238,143,357,302,256,225,346,385,102,707,351,113,108,125,712,308,364,864,913,575,1,0,0,1
286,2661,7020,1973,688,665,931,477,588,429,950,1183,99,1756,905,304,374,426,1557,392,1391,2116,2150,971,370,322,0,48
287,891,2576,572,319,236,231,153,271,242,255,338,56,581,310,160,153,172,406,139,509,672,764,492,50,17,0,33
288,3130,7359,1108,2022,925,999,740,466,765,1206,1123,36,2017,1113,612,558,623,1337,397,1279,2632,2052,999,80,0,0,80
289,2125,6211,1876,249,145,763,564,653,365,572,1040,148,1127,998,127,106,340,1552,235,1493,1489,2067,927,0,0,0,0
290,1445,3534,924,521,436,524,161,324,394,549,413,89,1039,406,232,223,290,700,246,566,839,1098,785,0,0,0,0
291,1243,3599,835,408,216,430,261,336,280,351,551,61,786,457,131,188,255,669,105,820,978,1021,675,8,0,0,8
292,931,2797,759,172,107,314,282,228,189,325,337,80,621,310,91,141,144,555,151,500,715,951,480,0,0,0,0
293,2118,5807,1943,175,576,614,342,586,526,746,556,290,1646,472,209,548,448,913,329,698,1594,1502,1684,31,0,0,31
294,2436,6171,2117,319,524,954,512,446,386,1284,521,245,1908,528,315,262,509,1350,122,1008,1681,2200,1160,11,0,0,11
295,1376,4247,960,416,289,473,189,425,289,399,591,97,999,377,129,304,390,553,298,686,1065,1408,790,13,0,0,13
296,3225,8614,2345,880,857,1148,484,736,839,1235,751,400,2386,839,685,509,748,1283,435,1301,2388,2369,2121,101,0,0,101
297,1519,4050,1076,443,407,594,295,223,249,521,570,179,1124,395,181,253,214,871,208,481,1339,1179,843,106,0,0,106
298,2553,6885,2133,420,657,943,334,619,897,906,612,138,2059,494,235,261,467,1590,320,939,1282,1973,2371,4,0,0,4
299,1042,3065,833,209,151,331,263,297,267,352,375,48,632,410,171,77,115,679,187,659,668,947,604,0,0,0,0
300,805,2611,711,94,63,314,169,259,160,293,303,49,534,271,71,99,52,583,103,524,730,724,530,0,0,0,0
301,2203,6192,1822,381,365,811,475,552,451,653,941,158,1322,881,56,331,503,1313,365,1229,1803,1692,1103,42,0,0,42
302,1668,4725,1559,109,155,668,400,445,309,455,853,51,1047,621,103,199,134,1232,277,859,1167,1578,844,24,0,0,24
303,1626,4490,1363,263,318,565,278,465,426,534,556,110,1090,536,178,253,280,915,306,742,1154,1391,897,26,0,0,26
304,1873,4818,1608,265,426,733,422,292,387,738,634,114,1343,530,146,266,264,1197,181,723,1014,1586,1314,89,0,0,89
305,707,1934,596,111,121,269,157,160,146,232,287,42,439,268,76,55,81,495,116,394,440,621,363,2,0,0,2
306,1371,3945,1028,343,215,496,370,290,283,493,466,129,814,557,172,159,279,761,107,926,1073,1205,634,10,0,0,10
307,1736,5083,1464,272,240,619,359,518,296,647,650,143,1016,720,166,244,244,1082,276,1068,1236,1714,789,2,0,0,2
308,1549,4552,1162,387,224,518,294,513,232,362,820,135,844,705,156,191,310,892,251,1086,1342,1319,554,8,0,0,8
309,3554,8723,1624,1930,1070,1164,691,629,633,1379,1324,218,2473,1081,478,614,843,1619,551,1315,3286,2170,1401,42,0,0,42
310,623,1642,455,168,125,223,151,124,94,212,275,42,422,201,97,105,71,350,111,254,606,482,189,19,0,0,19
311,1650,4158,1014,636,487,503,324,336,325,672,607,46,1063,587,217,214,366,853,300,795,1156,1356,551,17,0,0,17
312,3009,7430,1969,1040,838,963,545,663,613,1263,1057,76,2018,991,495,266,543,1705,429,1325,2395,2375,906,2,0,0,2
313,1514,4398,740,774,418,445,239,412,131,703,530,150,1039,475,298,337,274,605,175,776,1950,1009,488,152,0,0,152
314,1960,5977,376,1584,501,580,232,647,314,682,693,271,1309,651,644,676,358,282,225,1167,2290,1509,786,78,0,0,78
315,2239,4847,57,2182,849,1093,138,159,271,873,1036,59,2031,208,384,389,463,1003,159,250,3516,539,383,202,0,0,202
316,993,2703,362,631,210,341,192,250,138,331,423,101,712,281,227,209,242,315,121,439,1126,813,204,17,0,0,17
317,2269,5472,854,1415,770,736,389,374,319,1019,822,109,1632,637,269,444,622,934,109,1183,1982,1458,740,27,0,0,27
318,979,2866,769,210,164,322,201,292,176,343,407,53,548,431,118,133,110,618,162,691,795,766,452,1,0,0,1
319,1197,3320,962,235,186,572,185,254,309,339,472,77,881,316,181,109,226,681,146,652,744,1160,618,11,0,0,11
320,2146,6497,986,1160,401,790,331,624,336,759,851,200,1367,779,319,523,380,924,492,1091,2505,1483,926,41,0,0,41
321,1023,2634,931,92,175,385,258,205,278,254,425,66,657,366,163,91,202,567,208,368,668,823,567,16,0,0,16
322,1783,4958,1283,500,426,623,410,324,422,639,604,118,1356,427,244,288,265,986,284,715,1609,1436,914,2,0,0,2
323,1933,6035,873,1060,492,460,422,559,334,857,575,167,1252,681,459,528,370,576,331,1075,2599,1259,771,288,0,0,288
324,1325,3858,216,1109,302,400,230,393,145,454,567,159,742,583,363,444,294,224,351,719,1844,710,234,6,0,0,6
325,2266,5735,727,1539,615,885,325,441,214,1059,754,239,1691,575,505,634,501,626,116,1055,2489,1357,718,22,0,0,22
326,832,2725,81,751,168,192,187,285,84,360,248,140,523,309,257,340,138,97,192,537,1335,498,163,38,0,0,38
327,1473,5834,438,1035,183,376,335,579,194,624,401,254,723,750,430,349,383,311,686,1074,2474,1250,350,134,0,0,134
328,1034,2982,726,308,268,311,162,293,239,324,327,144,749,285,181,139,228,486,211,458,1057,786,470,0,0,0,0
329,1293,4449,830,463,321,326,107,539,183,513,371,226,861,432,333,378,348,234,217,838,1579,1167,648,71,0,0,71
330,1435,5865,761,674,173,347,249,666,181,436,482,336,736,699,443,360,322,310,413,1602,1936,1302,612,23,0,0,23
331,1628,5699,736,892,353,506,197,572,211,595,447,375,1113,515,344,381,348,555,378,936,2807,1109,469,13,0,0,13
332,1014,4558,717,297,65,145,165,639,117,318,299,280,575,439,178,279,306,251,137,969,1821,1225,406,25,0,0,25
333,2946,11728,1932,1014,260,697,719,1270,179,851,1096,820,1895,1051,408,687,660,1191,722,2473,4521,2840,1172,76,0,0,76
334,1675,6958,952,723,274,336,210,855,293,363,597,422,975,700,383,599,337,356,134,1406,2575,1995,848,28,0,0,28
335,2832,7419,542,2290,963,702,530,637,322,1677,500,333,1864,968,1065,680,488,599,844,1315,3051,1462,747,9,0,0,9
336,1457,3948,999,458,332,416,398,311,232,644,486,95,887,570,172,171,265,849,415,678,1355,1014,486,0,0,0,0
337,556,2410,342,214,187,124,92,153,84,261,177,34,349,207,74,61,115,306,142,312,858,708,390,0,0,0,0
338,746,2335,624,122,123,205,158,260,95,256,327,68,434,312,62,103,114,467,81,543,645,714,352,65,0,0,65
339,886,2793,809,77,101,292,202,291,236,312,275,63,544,342,67,53,74,692,76,708,636,842,531,0,0,0,0
340,1849,4552,585,1264,531,639,287,392,322,866,553,108,1271,578,321,170,531,827,276,741,2048,1014,473,23,0,0,23
341,1888,4372,543,1345,680,630,307,271,432,714,713,29,1296,592,335,350,364,839,338,627,1759,870,778,8,0,0,8
342,1268,4251,1039,229,165,552,240,311,365,511,329,63,889,379,133,105,209,821,44,1017,958,1078,1154,592,535,0,57
343,773,2106,645,128,121,311,124,217,176,334,258,5,449,324,77,61,117,518,122,476,343,696,469,13,0,0,13
344,1009,3392,900,109,136,166,316,391,146,390,434,39,502,507,127,81,80,721,255,1069,797,890,381,0,0,0,0
345,1581,4378,1183,398,253,572,297,459,355,564,608,54,923,658,139,205,193,1044,292,989,1078,1313,706,10,0,0,10
346,1257,3511,917,340,317,450,206,284,388,422,371,76,892,365,162,142,185,768,70,703,868,1029,841,0,0,0,0
347,2917,7841,2640,277,586,1290,487,554,1041,741,994,141,2260,657,313,411,315,1878,221,1310,1257,2285,2768,81,0,0,81
348,0,0,0,0,0,0,0,0,0,0,0,0,0,0,0,0,0,0,0,0,0,0,0,0,0,0,0
349,404,1350,322,82,53,115,88,148,84,88,159,73,266,138,57,25,41,281,110,220,367,375,278,4,0,0,4
350,1102,3758,1023,79,207,502,153,240,296,423,304,79,812,290,63,120,87,832,81,902,932,1093,750,960,958,0,2
351,1934,4773,896,1038,495,765,326,348,474,563,797,100,1407,527,342,247,302,1043,333,758,1779,1129,774,23,0,0,23
352,361,2256,0,361,104,186,0,71,180,61,113,7,298,63,136,195,25,5,0,600,1566,90,0,1821,1818,0,3
353,1727,5347,30,1697,830,610,158,129,281,1258,177,11,1628,99,937,450,146,194,263,1218,3810,56,0,2844,2839,0,5
354,434,3177,0,434,267,112,0,55,368,-179,231,14,304,130,273,96,48,17,0,1274,1852,51,0,3723,3717,0,6
355,1782,6484,159,1623,769,675,180,158,501,835,429,17,1400,382,332,393,378,679,225,1855,2992,574,838,3144,3128,0,16
356,3527,7391,1378,2149,1517,1213,474,323,1140,1354,935,98,2908,619,1000,487,558,1482,190,852,2298,1999,2052,23,0,0,23
357,1715,4995,1277,438,236,635,364,480,271,710,584,150,1042,673,88,80,357,1190,151,1311,1265,1497,771,20,0,0,20
358,2012,5643,1681,331,425,518,459,610,599,669,680,64,1213,799,272,202,259,1279,302,1200,1236,1708,1197,0,0,0,0
359,1358,3705,938,420,236,506,216,400,273,422,611,52,755,603,100,66,152,1040,143,846,861,1091,764,15,0,0,15
360,2069,5122,1245,824,505,880,210,474,547,709,682,131,1494,575,230,284,486,1069,233,833,1577,1454,1025,0,0,0,0
361,2305,7208,1284,1021,321,580,473,931,304,873,835,293,1128,1177,184,267,458,1396,483,1731,1976,2292,726,6,0,0,6
362,1988,5595,1362,626,342,613,426,607,480,619,828,61,1090,898,226,158,325,1279,308,1261,1336,1539,1151,6,0,0,6
363,1184,3435,536,648,280,285,235,384,267,356,361,200,666,518,246,93,170,675,62,926,885,1066,496,0,0,0,0
364,709,1997,536,173,114,280,91,224,222,241,212,34,463,246,68,72,82,487,82,424,458,587,446,4,0,0,4
365,2126,4318,523,1603,964,662,205,295,311,1064,617,134,1739,387,412,341,564,809,142,571,2223,1007,375,0,0,0,0
366,2161,4784,1113,1048,717,719,451,274,337,910,846,68,1610,551,284,390,317,1170,232,676,2050,1212,614,20,0,0,20
367,2132,6100,1229,903,336,827,421,548,529,715,797,91,1477,655,339,302,454,1037,255,1454,1574,1695,1122,0,0,0,0
368,1576,4346,1458,118,259,718,161,438,529,556,386,105,1186,390,158,247,221,950,248,738,743,1380,1237,4,0,0,4
369,1674,4615,1312,362,397,542,239,496,648,343,643,40,1069,605,179,212,263,1020,114,1118,704,1353,1326,12,0,0,12
370,1771,4629,1278,493,394,661,221,495,522,603,605,41,1110,661,224,158,252,1137,329,910,1132,1247,1011,0,0,0,0
371,1296,3789,924,372,164,503,232,397,231,476,504,85,773,523,97,119,158,922,160,810,1100,1186,533,7,0,0,7
372,3007,6382,879,2128,1168,843,702,294,484,1553,863,107,2216,791,529,380,771,1327,423,964,3021,1259,715,19,0,0,19
373,1305,3552,790,515,257,494,206,348,276,470,496,63,892,413,224,242,185,654,208,570,1141,969,664,1,0,0,1
374,1144,2906,486,658,240,445,283,176,150,417,493,84,811,333,185,177,261,521,195,345,1436,687,243,40,0,0,40
375,1743,3828,567,1176,630,725,135,253,445,576,619,103,1395,348,452,183,295,813,183,568,1483,836,758,0,0,0,0
376,1667,4137,934,733,455,663,236,313,241,651,643,132,1228,439,275,249,290,853,203,643,1561,1173,557,64,0,0,64
377,2715,5611,961,1754,976,1029,453,257,486,1214,856,159,2179,536,275,620,631,1189,387,469,2598,1474,683,28,0,0,28
378,1712,3630,448,1264,598,690,266,158,244,753,671,44,1356,356,236,248,310,918,224,397,1894,742,373,40,0,0,40
379,2358,5409,319,2039,926,747,305,380,308,1117,753,180,1867,491,443,528,419,968,349,571,3284,876,329,19,0,0,19
380,2155,4895,179,1976,837,655,294,369,72,1205,770,108,1623,532,543,388,363,861,419,772,2945,600,159,67,0,0,67
381,2383,5691,1425,958,903,536,356,588,380,1239,619,145,1652,731,476,235,502,1170,319,1101,1911,1687,673,0,0,0,0
382,1097,3087,586,511,232,304,267,294,146,430,509,12,655,442,85,212,190,610,198,682,1025,733,449,6,0,0,6
383,758,2416,671,87,87,197,142,332,101,239,292,126,367,391,22,62,116,558,120,709,404,861,322,0,0,0,0
384,1617,4947,1498,119,262,460,265,630,470,555,482,110,985,632,118,165,205,1129,186,1190,979,1578,1014,6,0,0,6
385,994,2829,859,135,153,379,155,307,258,443,240,53,610,384,89,118,114,673,118,686,460,859,706,0,0,0,0
386,1028,2879,881,147,112,397,168,351,273,382,344,29,640,388,194,88,113,633,153,600,445,877,804,0,0,0,0
387,1348,4134,1178,170,136,482,199,531,240,458,544,106,747,601,114,59,175,1000,171,1041,980,1290,652,17,0,0,17
388,2006,6025,1884,122,207,628,638,533,472,663,688,183,1224,782,136,175,334,1361,196,1250,1180,2179,1220,0,0,0,0
389,1811,5228,1323,488,371,558,349,533,523,571,596,121,1101,710,343,193,231,1044,184,1142,1304,1593,1005,13,0,0,13
390,1349,3040,678,671,459,454,202,234,324,434,552,39,1007,342,227,203,209,710,187,504,1198,764,387,0,0,0,0
391,2649,6615,735,1914,772,860,370,647,524,1280,713,132,1843,806,343,430,635,1241,682,1287,2761,1166,719,154,0,0,154
392,2336,5416,150,2186,675,941,320,400,189,983,1040,124,1711,625,244,619,482,991,592,605,3269,719,231,1,0,0,1
393,1978,4264,453,1525,813,651,249,265,297,1055,504,122,1640,338,330,397,499,752,217,449,2210,833,555,1,0,0,1
394,1432,3892,868,564,264,468,394,306,246,417,599,170,960,472,249,149,256,778,220,647,1373,1109,543,178,0,0,178
395,2231,4855,683,1548,539,1015,513,164,202,1117,772,140,1691,540,194,258,572,1207,402,312,2799,940,402,0,0,0,0
396,5,10,3,2,1,3,1,0,0,3,2,0,4,1,0,1,1,3,1,1,4,3,1,0,0,0,0
397,954,2448,500,454,157,403,223,171,82,335,438,99,591,363,52,71,165,666,113,437,1275,453,170,0,0,0,0
398,1517,4124,573,944,406,487,198,426,99,772,527,119,1079,438,167,363,244,743,395,788,2244,592,105,0,0,0,0
399,15,34,9,6,6,5,1,3,2,7,5,1,10,5,3,4,2,6,2,5,13,9,5,0,0,0,0
400,1824,4489,847,977,559,520,333,412,221,841,610,152,1287,537,265,315,290,954,263,621,2359,790,456,0,0,0,0
401,526,1255,338,188,193,138,97,98,110,257,115,44,407,119,217,142,81,86,16,172,498,262,307,100,0,0,100
402,180,693,5,175,1,40,53,86,5,83,91,1,52,128,13,67,37,63,163,176,264,89,1,0,0,0,0
403,2,7,1,1,0,0,0,2,0,1,1,0,1,1,1,0,0,1,0,1,3,2,1,0,0,0,0
404,537,1904,333,204,110,103,108,216,101,173,213,50,360,177,144,123,108,162,123,324,672,584,201,18,0,0,18
405,2,8,1,1,0,0,0,2,0,1,1,0,1,1,0,1,0,1,1,1,2,3,1,0,0,0,0
406,659,1399,169,490,266,198,70,125,16,335,279,29,459,200,41,52,127,439,162,109,894,222,12,12,0,0,12
407,47,107,3,44,9,22,11,5,1,28,16,2,36,11,3,4,10,30,14,4,73,16,0,1,0,0,1
408,17,39,1,16,3,8,4,2,0,10,6,1,13,4,1,1,4,11,5,1,27,6,0,0,0,0,0
409,0,0,0,0,0,0,0,0,0,0,0,0,0,0,0,0,0,0,0,0,0,0,0,0,0,0,0
410,4864,10171,538,4326,1628,1881,729,626,96,2860,1726,182,3628,1236,447,473,1191,2753,936,729,7125,1173,208,76,0,0,76
411,0,0,0,0,0,0,0,0,0,0,0,0,0,0,0,0,0,0,0,0,0,0,0,0,0,0,0
412,8530,20096,1132,7398,2089,3832,1407,1202,498,3790,3367,875,6698,1832,879,1255,2417,3979,1412,1458,13375,2912,939,0,0,0,0
413,3946,9586,1162,2784,895,1596,873,582,359,1595,1843,149,2625,1321,645,410,737,2154,699,1408,5101,1818,560,15,0,0,15
414,1004,4285,626,378,119,321,141,423,190,301,312,201,618,386,171,260,193,380,240,762,1576,920,787,56,22,0,34
415,606,1810,515,91,139,127,144,196,116,132,227,131,290,316,113,88,191,214,56,320,641,567,226,14,0,0,14
416,2741,7627,1130,1611,525,817,691,708,332,984,1128,297,1873,868,342,301,637,1461,564,1099,3597,1741,626,15,0,0,15
417,0,0,0,0,0,0,0,0,0,0,0,0,0,0,0,0,0,0,0,0,0,0,0,0,0,0,0
418,503,1361,503,0,114,180,76,133,72,214,141,76,362,141,104,133,133,133,49,232,445,398,237,6,0,0,6
419,1092,3539,589,503,200,256,336,300,174,392,342,184,752,340,206,223,296,367,164,412,1734,712,517,15,0,0,15
420,813,2924,526,287,20,232,274,287,135,225,307,146,560,253,138,210,177,288,154,327,998,892,553,9,0,0,9
421,3215,7442,1941,1274,964,1325,387,539,421,1508,1007,279,2762,453,550,775,840,1050,226,592,3209,2187,1228,0,0,0,0
422,3368,8092,1195,2173,978,1421,454,515,304,1528,1155,381,2638,730,297,537,672,1862,567,851,4435,1447,792,82,0,0,82
423,1652,4793,837,815,474,398,202,578,254,533,657,208,1130,522,395,333,374,550,322,801,2092,1082,496,0,0,0,0
424,2426,6891,1181,1245,516,605,700,605,259,859,1047,261,1587,839,463,633,507,823,406,1168,2823,1780,714,13,0,0,13
425,1409,3556,453,956,405,430,252,322,130,475,634,170,1057,352,221,317,385,486,216,393,1780,868,299,0,0,0,0
426,1773,4414,756,1017,466,626,424,257,161,797,637,178,1320,453,197,323,312,941,333,368,2499,910,304,88,0,0,88
427,1387,3066,446,941,402,562,290,133,50,598,665,74,1147,240,100,76,337,874,240,117,2368,261,80,2,0,0,2
428,669,1470,209,460,195,272,140,62,23,287,324,35,555,114,48,35,164,422,115,53,1149,117,36,0,0,0,0
429,0,0,0,0,0,0,0,0,0,0,0,0,0,0,0,0,0,0,0,0,0,0,0,0,0,0,0
430,635,1301,29,606,266,257,60,52,101,238,223,73,467,168,83,131,115,306,57,91,776,342,35,0,0,0,0
431,12,25,1,11,5,5,1,1,2,5,4,1,9,3,2,3,2,5,1,2,14,7,1,0,0,0,0
432,196,401,9,187,82,79,19,16,31,73,69,23,144,52,26,41,35,94,18,28,239,105,11,0,0,0,0
433,2438,6327,755,1683,680,907,387,464,361,1026,793,258,1845,593,627,492,443,876,410,746,2897,1398,876,35,33,0,2
434,55,215,31,24,24,0,6,25,13,23,16,3,43,12,34,21,0,0,33,84,61,37,0,2,0,0,2
435,1995,4174,529,1466,858,691,214,232,454,866,560,115,1584,411,552,456,428,559,341,395,2279,774,385,82,0,0,82
436,1588,4688,768,820,265,477,313,533,203,652,561,172,874,714,293,329,424,542,238,1003,1710,1156,581,7,0,0,7
437,2219,5986,784,1435,558,748,392,521,214,896,786,323,1492,727,382,553,424,860,463,882,2381,1520,740,0,0,0,0
438,1663,4878,1124,539,321,478,347,517,282,556,633,192,1011,652,258,294,331,780,332,835,1924,1162,625,11,0,0,11
439,1186,3078,688,498,343,304,284,255,263,353,333,237,889,297,295,157,204,530,101,458,1171,862,486,0,0,0,0
440,3596,8563,933,2663,947,1281,809,559,464,1799,1103,230,2453,1143,579,445,855,1717,716,1036,4356,1812,643,0,0,0,0
441,2899,6630,781,2118,900,1039,514,446,477,1007,1155,260,2353,546,547,396,606,1350,524,708,3415,1320,663,13,0,0,13
442,1115,3574,878,237,148,337,255,375,159,269,418,269,853,262,92,129,188,706,86,510,1425,991,562,13,0,0,13
443,2019,5190,620,1399,470,906,340,303,131,896,855,137,1535,484,208,367,565,879,283,571,2798,991,547,0,0,0,0
444,2194,5646,1351,843,453,925,333,483,360,855,704,275,1513,681,201,516,385,1092,260,846,1978,1937,625,1,0,0,1
445,3403,8995,1233,2170,640,1092,907,764,425,1454,1297,227,2209,1194,426,722,802,1453,609,1315,4816,1421,834,18,0,0,18
446,3417,8370,1259,2158,699,1378,690,650,299,1486,1315,317,2451,966,213,532,924,1748,805,697,4489,1548,831,0,0,0,0
447,1966,4706,746,1220,548,648,494,276,343,975,549,99,1387,579,265,315,302,1084,469,420,1848,1242,727,0,0,0,0
448,3255,7686,486,2769,1091,952,663,549,485,1617,813,340,2244,1011,634,559,852,1210,574,794,4548,1116,654,28,0,0,28
449,2584,6212,621,1963,769,693,649,473,431,1021,966,166,1670,914,338,488,536,1222,498,890,3218,899,707,0,0,0,0
450,2518,5575,513,2005,781,904,649,184,425,794,1120,179,2000,518,304,413,717,1084,402,440,3001,978,754,11,0,0,11
451,2379,6553,1486,893,573,701,385,720,549,908,743,179,1534,845,425,240,463,1251,324,1362,2326,1611,930,15,0,0,15
452,988,3320,839,149,124,266,212,386,218,309,361,100,532,456,73,175,118,622,248,687,877,864,644,0,0,0,0
453,2570,8272,1589,981,348,741,467,1014,378,1006,968,218,1412,1158,261,283,612,1414,533,1751,3165,1947,876,25,0,0,25
454,1546,4702,1246,300,232,442,443,429,337,477,651,81,909,637,103,143,255,1045,140,988,1070,1377,1127,0,0,0,0
455,905,2569,819,86,98,416,138,253,329,218,282,76,640,265,158,104,117,526,68,476,498,828,699,2,0,0,2
456,3075,8734,1076,1999,469,1092,656,858,615,1302,868,290,1799,1276,592,704,627,1152,596,1863,3162,2102,1011,6,0,0,6
457,1710,5627,1044,666,252,296,327,835,327,476,852,55,813,897,148,234,238,1090,498,1234,1737,1242,916,0,0,0,0
458,1690,5138,1065,625,148,488,397,657,374,588,572,156,765,925,234,212,176,1068,276,1221,1859,1245,537,0,0,0,0
459,2866,7816,1668,1198,463,1104,647,652,493,1076,1104,193,1940,926,354,393,574,1545,530,1330,2879,1730,1347,21,0,0,21
460,1377,3556,559,818,264,428,432,253,220,621,472,64,865,512,101,166,328,782,247,578,1589,803,339,27,0,0,27
461,1506,4845,905,601,120,419,488,479,138,486,803,79,967,539,164,267,388,687,354,832,1619,1399,641,17,0,0,17
462,1743,5218,1121,622,264,496,347,636,296,740,558,149,932,811,268,196,381,898,238,1138,1597,1373,872,29,0,0,29
463,1747,4364,1039,708,360,649,396,342,352,691,521,183,1245,502,134,397,410,806,226,598,1890,902,748,0,0,0,0
464,1808,4966,1152,656,392,565,325,526,254,659,763,132,1268,540,263,259,493,793,318,648,1886,1344,770,20,0,0,20
465,3394,8103,1423,1971,1029,1233,623,509,746,1323,1031,294,2573,821,806,766,530,1292,435,1063,3495,1942,1168,40,0,0,40
466,1636,4259,1046,590,350,621,289,376,286,537,631,182,1216,420,243,356,295,742,142,643,1812,1109,553,9,0,0,9
467,2141,4710,610,1531,763,755,417,206,339,1071,610,121,1657,484,330,574,360,877,252,632,1723,1485,618,118,0,0,118
468,2191,5420,933,1258,639,836,294,422,613,770,733,75,1525,666,559,474,398,760,272,950,1865,1423,910,42,0,0,42
469,2284,7235,799,1485,629,382,460,813,410,955,598,321,1222,1062,498,750,597,439,830,1614,2715,1574,502,0,0,0,0
470,2480,6180,1177,1303,660,760,542,518,390,1092,788,210,1859,621,358,336,579,1207,194,1007,2332,1973,674,18,0,0,18
471,2154,5101,644,1510,651,885,220,398,376,729,876,173,1692,462,411,607,607,529,414,396,2098,1365,828,39,0,0,39
472,2442,6164,593,1849,706,810,343,583,265,1289,825,63,1576,866,460,702,591,689,554,1093,2880,1246,391,0,0,0,0
473,2113,5735,601,1512,483,581,523,526,389,936,658,130,1363,750,649,638,315,511,320,979,2109,1714,613,16,0,0,16
474,1539,4397,695,844,335,414,318,472,189,624,494,232,1133,406,241,391,399,508,187,628,1615,1311,656,14,0,0,14
475,1501,3790,724,777,392,503,357,249,190,718,481,112,1026,475,237,450,234,580,200,636,1403,974,577,0,0,0,0
476,2770,8409,1778,992,580,638,602,950,507,1032,1012,219,1673,1097,235,574,674,1287,528,1507,2458,2344,1572,18,0,0,18
477,1983,5546,1410,573,378,669,319,617,377,756,644,206,1200,783,324,345,307,1007,235,1105,1422,1938,846,0,0,0,0
478,2228,6127,589,1639,438,528,662,600,358,1071,492,307,1337,891,464,457,614,693,281,1088,2834,1192,732,10,0,0,10
479,2762,8215,1548,1214,433,795,632,902,473,1026,1110,153,1554,1208,386,345,499,1532,497,1699,3017,2188,814,62,0,0,62
480,1029,3061,917,112,136,279,274,340,150,352,445,82,655,374,73,95,134,727,139,626,624,1156,516,0,0,0,0
481,1749,5262,1477,272,244,392,484,629,402,590,629,128,933,816,100,256,372,1021,215,1079,1340,1639,989,0,0,0,0
482,1401,4481,1148,253,132,300,417,552,203,435,656,107,715,686,141,114,152,994,48,1070,1094,1691,578,0,0,0,0
483,1973,5181,1034,939,508,524,418,523,350,962,556,105,1249,724,478,259,408,828,257,867,1786,1719,552,0,0,0,0
484,2919,7830,1825,1094,834,624,548,913,703,1215,856,145,1778,1141,449,452,534,1484,222,1725,2047,2472,1364,0,0,0,0
485,2361,6519,1540,821,362,648,698,653,400,987,791,183,1215,1146,249,182,308,1622,473,1383,2035,1954,674,15,0,0,15
486,2066,5971,596,1470,358,424,615,669,253,1175,468,170,901,1165,364,215,478,1009,250,1574,2625,1106,416,0,0,0,0
487,2000,5284,729,1271,486,508,559,447,310,861,725,104,1237,763,271,177,450,1102,329,980,2216,1234,525,17,0,0,17
488,2442,7343,1571,871,428,657,575,782,670,744,872,156,1404,1038,429,331,259,1423,212,1659,2027,1864,1581,17,0,0,17
489,2172,6618,1930,242,255,556,535,826,414,782,738,238,1265,907,241,183,344,1404,374,1340,1678,2091,1135,0,0,0,0
490,1276,3496,966,310,215,456,267,338,304,441,412,119,827,449,166,181,209,720,107,631,920,1147,691,0,0,0,0
491,1093,3432,715,378,67,353,222,451,93,439,508,53,550,543,63,135,160,735,160,863,1030,998,381,0,0,0,0
492,1872,5811,1327,545,156,477,518,721,221,728,769,154,873,999,155,222,261,1234,256,1482,1631,1898,544,0,0,0,0
493,1952,5917,1774,178,237,615,463,637,590,555,607,200,1238,714,252,292,283,1125,89,1269,970,1976,1613,15,0,0,15
494,2057,5737,1906,151,259,709,615,474,637,709,525,186,1377,680,232,295,482,1048,91,1102,1236,1845,1463,0,0,0,0
495,2023,6035,1798,225,184,725,511,603,479,708,747,89,1262,761,158,315,270,1280,74,1257,1287,2030,1387,0,0,0,0
496,912,2640,742,170,155,414,145,198,253,264,298,97,713,199,137,53,132,590,114,327,586,799,814,0,0,0,0
497,2455,6803,2033,422,376,891,450,738,855,599,821,180,1540,915,361,206,200,1688,196,1448,1243,2180,1736,0,0,0,0
498,1502,3980,1209,293,263,608,270,361,306,512,586,98,1028,474,171,184,234,913,144,668,899,1349,920,0,0,0,0
499,2423,7362,1902,521,341,696,439,947,413,955,906,149,1226,1197,236,382,458,1347,443,1713,2142,2139,925,13,0,0,13
500,1309,4268,1064,245,113,361,286,549,238,378,427,266,757,552,84,232,242,751,264,733,1295,1333,643,0,0,0,0
501,1515,4252,993,522,182,568,313,452,240,599,612,64,877,638,161,209,230,915,158,993,1202,1390,509,0,0,0,0
502,1788,5137,1017,771,441,575,157,615,486,496,596,210,1179,609,462,395,350,581,365,976,1486,1393,917,10,0,0,10
503,2716,6094,951,1765,999,1012,236,469,869,898,811,138,2057,659,919,525,515,757,409,885,2198,1188,1414,0,0,0,0
504,2121,4925,888,1233,697,626,385,413,345,962,586,228,1452,669,366,514,494,747,418,815,2091,1186,415,8,0,0,8
505,1987,5795,1110,877,342,488,502,655,388,744,717,138,1096,891,317,497,361,812,273,1418,1881,1630,593,24,0,0,24
506,1344,3590,685,659,263,498,270,313,393,446,444,61,953,391,277,207,281,579,270,511,1137,980,692,24,0,0,24
507,1872,4793,1595,277,443,567,418,444,430,846,504,92,1145,727,223,246,404,999,177,1034,1250,1437,895,0,0,0,0
508,1207,3192,611,596,219,433,276,279,154,448,559,46,712,495,171,134,238,664,117,794,901,924,456,0,0,0,0
509,1384,3023,501,883,480,514,104,286,182,888,303,11,1044,340,224,272,289,599,201,533,897,972,420,21,0,0,21
510,863,2446,809,54,103,338,194,228,279,309,254,21,566,297,60,67,119,617,25,572,321,889,639,0,0,0,0
511,2935,7000,2038,897,835,1078,468,554,844,1282,723,86,2189,746,488,347,497,1603,254,1274,1327,2481,1664,14,0,0,14
512,1656,4538,1360,296,319,589,352,396,225,689,664,78,1136,520,154,262,350,890,133,905,1140,1770,590,22,0,0,22
513,1128,3415,1065,63,139,559,79,351,292,483,263,90,779,349,169,84,105,770,65,733,535,1360,722,94,0,0,94
514,2802,8174,2246,556,555,666,671,910,820,884,939,159,1671,1131,305,361,554,1582,240,2040,1838,2468,1588,0,0,0,0
515,2288,7090,1532,756,302,724,421,841,338,911,805,234,1229,1059,352,558,296,1082,241,1688,2397,2003,761,19,0,0,19
516,1587,4602,1240,347,187,428,546,426,240,459,784,104,866,721,111,254,289,933,150,1102,971,1755,624,0,0,0,0
517,1946,5885,1424,522,255,532,431,728,348,428,965,205,1041,905,311,216,360,1059,266,1357,1964,1563,735,8,0,0,8
518,2113,6141,1418,695,465,704,308,636,455,798,724,136,1331,782,249,300,346,1218,310,1354,1612,1803,1062,0,0,0,0
519,3196,8158,1919,1277,830,1234,433,699,426,1552,1133,85,2152,1044,357,536,747,1556,425,1517,2386,2594,1236,36,0,0,36
520,1425,4419,1112,313,214,348,290,573,169,560,499,197,749,676,223,210,257,735,341,880,1188,1511,499,26,0,0,26
521,2081,5611,1120,961,440,670,479,492,454,653,786,188,1195,886,524,378,422,757,472,1085,2064,1320,670,27,0,0,27
522,2155,6213,1317,838,388,530,693,544,287,595,1021,252,1309,846,421,394,448,892,332,1004,2282,1819,776,62,0,0,62
523,3018,9082,2548,470,388,980,765,885,627,777,1303,311,1619,1399,276,564,649,1529,551,2172,2545,2446,1368,50,0,0,50
524,1881,5270,1642,239,301,620,412,548,412,662,660,147,1180,701,246,242,337,1056,495,871,1404,1527,973,16,0,0,16
525,1650,4455,1348,302,299,688,238,425,439,665,466,80,1001,649,164,414,388,684,360,885,899,1361,950,17,0,0,17
526,2378,6537,1880,498,504,654,494,726,330,822,1149,77,1399,979,274,230,422,1452,655,1204,2214,1631,833,21,0,0,21
527,2752,6930,1920,832,826,790,585,551,520,1098,904,230,2024,728,524,475,309,1444,393,1042,1840,2279,1376,91,0,0,91
528,2599,6517,1250,1349,747,806,536,510,373,1159,826,241,1812,787,354,584,687,974,370,974,2463,1698,1012,26,0,0,26
529,1396,3121,893,503,519,399,160,318,542,505,324,25,997,399,189,226,387,594,138,635,476,992,880,0,0,0,0
530,3141,7024,1255,1886,1088,1115,562,376,518,1553,891,179,2391,750,537,815,692,1097,462,1054,2650,1971,887,2,0,0,2
531,1383,2910,659,724,579,506,178,120,351,651,290,91,1129,254,408,293,267,415,117,291,1129,788,585,44,0,0,44
532,2981,7453,604,2377,1025,834,729,393,586,1055,1138,202,2336,645,898,836,534,713,472,1046,3403,1669,863,93,0,0,93
533,2629,6895,702,1927,913,712,333,671,388,1109,802,330,1948,681,822,785,490,532,223,1124,2909,1859,780,41,0,0,41
534,2135,5045,1262,873,660,780,465,230,530,724,637,244,1744,391,614,306,448,767,208,788,1955,1221,873,36,22,0,14
535,2032,4767,981,1051,801,500,401,330,470,692,660,210,1558,474,485,503,530,514,289,693,2045,1115,625,0,0,0,0
536,1810,5308,505,1305,490,413,424,483,174,662,630,344,1177,633,357,571,367,515,270,1134,2475,1186,243,0,0,0,0
537,2992,6003,743,2249,1485,834,324,349,299,1738,794,161,2530,462,604,583,769,1036,234,701,3452,1249,367,80,0,0,80
538,1259,3113,474,785,366,635,91,167,153,626,404,76,1051,208,229,404,236,390,114,323,1517,856,303,622,0,0,622
539,422,1043,143,279,139,187,38,58,66,148,175,33,332,90,85,80,95,162,49,123,500,308,63,270,0,0,270
540,2285,6069,694,1591,744,628,353,560,433,956,698,198,1687,598,489,616,533,647,150,1264,2848,1194,613,15,0,0,15
541,2093,5020,1649,444,638,842,320,293,412,1018,512,151,1740,353,249,294,534,1016,196,569,1437,1732,1086,11,0,0,11
542,1029,2545,438,591,256,436,210,127,95,489,389,56,752,277,97,260,273,399,160,271,1237,618,259,20,0,0,20
543,1411,5549,697,714,404,575,188,244,262,569,537,43,1191,220,380,305,221,505,216,1637,2853,608,235,2243,2215,0,28
544,2378,5836,618,1760,872,650,417,439,390,1001,719,268,2085,293,600,610,592,576,208,505,3407,1235,481,50,50,0,0
545,1232,4379,314,918,405,433,162,232,251,460,457,64,1014,218,347,233,283,369,181,1267,1896,501,534,998,935,0,63
546,1927,5406,565,1362,613,751,351,212,147,871,824,85,1495,432,222,555,372,778,365,498,3528,753,262,15,0,0,15
547,2872,7903,1093,1779,742,1235,430,465,437,917,1250,268,2145,727,674,336,692,1170,582,1146,3644,1604,927,87,0,0,87
548,3260,8560,1327,1933,1189,902,543,626,677,1436,804,343,2514,746,879,680,827,874,444,1077,3537,2358,1144,67,0,0,67
549,2378,5003,242,2136,1238,559,203,378,752,1059,363,204,2008,370,1130,726,264,258,283,589,2349,990,792,96,0,0,96
550,1460,4345,529,931,263,604,219,374,151,510,607,192,1065,395,376,316,401,367,177,598,2129,965,476,51,0,0,51
551,1829,5659,647,1182,399,546,351,533,388,679,532,230,1236,593,612,595,369,253,297,1009,1998,1498,857,273,0,0,273
552,1323,4159,471,852,266,426,210,421,217,559,438,109,825,498,459,480,177,207,419,770,1575,993,402,0,0,0,0
553,1212,4160,708,504,125,408,201,478,224,478,325,185,788,424,363,291,184,374,258,680,1804,929,489,116,0,0,116
554,1099,4063,568,531,198,515,129,257,203,369,444,83,846,253,385,122,212,380,132,742,1791,996,402,570,249,0,321
555,2741,7343,520,2221,886,857,353,645,282,1293,801,365,2297,444,987,784,496,474,253,918,4736,1016,420,157,0,0,157
556,550,4613,0,550,161,128,32,229,110,196,165,79,457,93,345,156,40,9,38,2176,2021,316,62,3457,3445,0,12
557,2192,4459,450,1742,1184,567,226,215,509,1197,354,132,2097,95,857,395,446,494,48,453,2729,729,500,142,0,0,142
558,2425,4483,567,1858,1096,1016,193,120,496,1092,725,112,2248,177,667,294,449,1015,72,239,2679,992,501,184,0,0,184
559,1717,4622,845,872,470,534,271,442,220,745,588,164,1184,533,267,428,334,688,397,679,1783,1088,675,7,0,0,7
560,1393,4466,360,1033,408,259,248,478,237,567,343,246,805,588,474,285,276,358,409,881,1954,975,247,231,0,0,231
561,1435,4062,478,957,466,330,159,480,344,596,358,137,964,471,552,460,265,158,371,570,1734,1032,355,11,0,0,11
562,1321,4725,452,869,219,363,218,521,269,299,501,252,830,491,439,361,242,279,337,946,2193,800,449,36,0,0,36
563,4377,12284,1420,2957,1606,938,747,1086,1087,1860,977,453,2977,1400,2039,1125,809,404,399,2686,4369,3021,1809,604,0,0,604
564,3204,9422,1076,2128,568,1004,704,928,334,1528,1060,282,2004,1200,752,711,849,892,500,1700,3714,2481,1027,32,0,0,32
565,2406,6469,1284,1122,449,1038,438,481,554,946,711,195,1773,633,687,494,619,606,375,984,2384,1547,1179,0,0,0,0
566,3350,8493,2540,810,1029,872,694,755,365,1666,968,351,2341,1009,691,577,630,1452,490,1550,3511,1912,1030,19,0,0,19
567,2368,8441,1200,1168,471,350,405,1142,356,816,721,475,1422,946,754,753,587,274,442,1741,2895,2037,1326,29,0,0,29
568,2149,7740,1338,811,415,445,302,987,590,734,578,247,1144,1005,769,561,383,436,302,2011,2716,1897,814,20,0,0,20
569,967,4412,466,501,74,169,123,601,126,284,307,250,451,516,288,293,221,165,263,1359,1499,913,378,0,0,0,0
570,1087,4532,345,742,150,204,260,473,223,407,223,234,539,548,455,353,179,100,147,1160,1748,1109,368,18,0,0,18
571,743,3265,550,193,48,187,101,407,52,221,223,247,440,303,148,133,215,247,245,574,1233,859,354,0,0,0,0
572,990,4435,654,336,31,163,243,553,138,206,331,315,513,477,158,298,256,278,167,813,1684,1296,475,0,0,0,0
573,926,3589,757,169,46,220,197,463,212,242,314,158,539,387,174,223,206,323,124,717,1000,956,792,46,0,0,46
574,1275,5140,830,445,197,164,226,688,160,493,302,320,673,602,383,498,285,109,205,1451,1517,1385,582,79,0,0,79
575,991,4176,738,253,86,255,177,473,182,299,216,294,647,344,202,246,232,311,191,586,1384,1267,748,44,0,0,44
576,1164,4160,926,238,29,390,304,441,231,337,418,178,787,377,190,427,301,246,199,560,1237,1358,806,50,0,0,50
577,1132,5243,652,480,29,157,233,713,70,292,467,303,677,455,131,368,395,238,276,969,1813,1265,920,35,0,0,35
578,2209,7236,803,1406,489,559,374,787,267,913,695,334,1479,730,561,719,594,335,332,1430,2897,1811,766,6,0,0,6
579,739,2139,176,563,232,236,75,196,306,161,164,108,566,173,354,214,84,87,68,292,739,536,504,163,0,0,163
580,956,4067,207,749,49,185,165,557,165,232,326,233,429,527,301,321,262,72,294,1128,1447,943,255,98,0,0,98
581,1061,4686,392,669,85,216,125,635,154,499,209,199,452,609,457,292,126,186,247,1402,1502,992,543,16,0,0,16
582,1758,6804,937,821,191,404,359,804,269,558,566,365,1101,657,581,408,434,335,228,1248,1940,1983,1405,37,0,0,37
583,1405,5854,768,637,148,267,214,776,248,290,584,283,858,547,474,379,232,320,344,1271,1918,1361,960,15,0,0,15
584,861,4217,711,150,53,116,125,567,150,145,243,323,443,418,216,205,197,243,131,801,1430,1326,529,8,0,0,8
585,934,4240,685,249,135,157,139,503,175,232,281,246,558,376,237,298,253,146,248,867,1356,1100,669,3,0,0,3
586,1112,5601,744,368,56,46,175,835,49,287,234,542,584,528,164,247,340,361,216,1085,2465,1368,467,0,0,0,0
587,368,2162,257,111,43,19,42,264,32,63,91,182,146,222,56,97,105,110,76,544,775,467,300,5,0,0,5
588,1249,6883,599,650,79,153,148,869,189,183,432,445,555,694,177,452,303,317,239,1859,2547,1356,882,39,0,0,39
589,1428,6385,763,665,155,234,120,919,172,424,393,439,808,620,411,422,299,296,290,1077,2435,1862,721,22,0,0,22
590,866,3888,402,464,106,85,181,494,113,217,235,301,420,446,268,304,160,134,192,865,1384,1037,410,0,0,0,0
591,2022,8114,678,1344,293,310,519,900,425,483,598,516,962,1060,721,549,403,349,743,1832,2915,1699,925,148,0,0,148
592,1268,5255,598,670,172,264,154,678,191,399,344,334,619,649,392,360,276,240,254,1255,1991,955,800,20,0,0,20
593,885,3582,388,497,95,182,159,449,102,264,304,215,450,435,211,266,178,230,172,793,1341,896,380,8,0,0,8
594,1353,5264,519,834,132,255,241,725,200,329,530,294,800,553,332,416,341,264,224,940,1985,1517,598,67,0,0,67
595,2402,7671,563,1839,628,619,431,724,677,773,599,353,1616,786,995,718,484,205,363,1672,2670,1721,1245,0,0,0,0
596,713,2662,388,325,75,216,97,325,118,215,190,190,511,202,207,153,191,162,123,381,1021,684,453,24,0,0,24
597,2199,6178,637,1562,538,606,436,619,657,716,666,160,1542,657,1073,392,172,562,308,1055,2465,1301,1049,70,0,0,70
598,2113,6720,1719,394,256,745,393,719,457,572,811,273,1309,804,298,356,413,1046,339,1105,2677,1486,1113,58,0,0,58
599,1510,5410,1040,470,116,339,370,685,214,393,547,356,895,615,160,294,350,706,240,872,1902,1605,791,17,0,0,17
600,1037,3763,791,246,34,276,326,401,161,204,441,231,667,370,84,221,314,418,186,448,1468,856,805,26,0,0,26
601,2999,8064,1828,1171,663,896,698,742,441,1141,1197,220,2245,754,348,462,810,1379,452,1077,3639,2003,893,133,0,0,133
602,730,2464,575,155,117,173,128,312,79,339,181,131,460,270,134,293,167,136,63,513,718,852,318,145,0,0,145
603,207,700,169,38,50,53,67,37,36,28,83,60,84,123,32,25,26,124,39,97,293,205,66,66,0,0,66
604,962,4049,779,183,134,127,163,538,137,280,317,228,491,471,246,174,274,268,118,1204,1404,1095,228,253,0,0,253
605,3979,11800,1851,2128,594,1309,925,1151,429,1924,1112,514,2408,1571,483,642,1126,1728,992,1644,5134,2502,1528,46,0,0,46
606,3944,10718,1725,2219,586,1616,782,960,373,1396,1709,466,2745,1199,319,464,882,2279,945,1116,6429,1547,681,15,0,0,15
607,2156,8627,1295,861,256,703,401,796,202,883,824,247,1237,919,125,365,753,913,631,1071,4387,1745,793,18,0,0,18
608,1898,4740,705,1193,222,891,459,326,213,772,842,71,1268,630,117,227,602,952,363,535,3047,612,183,44,0,0,44
609,1686,5389,1211,475,287,384,312,703,411,424,599,252,1036,650,323,255,354,754,148,1154,1513,1499,1075,0,0,0,0
610,747,1955,456,291,185,179,202,181,287,152,257,51,501,246,263,70,102,312,75,357,559,511,453,0,0,0,0
611,1658,6238,1183,475,108,484,293,773,243,511,559,345,911,747,250,322,384,702,360,1294,2206,1621,757,33,0,0,33
612,2177,6701,1324,853,318,457,618,784,240,679,866,392,1277,900,402,299,571,905,332,1217,2906,1665,581,1,0,0,1
613,932,3316,653,279,135,234,171,392,154,266,359,153,505,427,231,210,202,289,153,633,981,970,579,0,0,0,0
614,1552,5631,1189,363,121,455,302,674,233,428,627,264,850,702,263,236,246,807,198,1200,1618,1699,916,4,0,0,4
615,1473,5038,958,515,163,392,374,544,299,377,498,299,995,478,288,301,252,632,138,835,1543,1656,866,20,0,0,20
616,1416,5044,796,620,103,308,468,537,111,472,403,430,784,632,173,401,417,425,306,985,1876,1460,417,0,0,0,0
617,1200,4118,583,617,105,393,200,502,192,361,398,249,729,471,260,258,363,319,133,737,1474,1139,635,3,0,0,3
618,653,2332,534,119,78,163,146,266,128,192,198,135,411,242,81,116,138,318,74,472,686,635,465,7,0,0,7
619,1473,4690,1338,135,232,393,354,494,354,375,481,263,903,570,281,223,242,727,204,851,1367,1367,901,16,0,0,16
620,1129,3927,836,293,146,253,149,581,140,374,464,151,582,547,159,154,224,592,277,844,1414,980,412,11,0,0,11
621,1187,4124,701,486,146,399,213,429,208,328,382,269,919,268,273,132,381,401,128,482,1486,1360,668,28,0,0,28
622,1580,5901,1207,373,222,316,237,805,301,359,390,530,1039,541,269,217,408,686,207,804,2291,1775,824,22,0,0,22
623,1983,7029,1614,369,162,501,444,876,330,417,771,465,1253,730,195,299,591,898,178,1095,2341,2358,1057,12,0,0,12
624,912,3000,675,237,100,296,156,360,192,276,283,161,616,296,134,112,244,422,70,463,867,946,654,38,0,0,38
625,1640,5412,1141,499,240,430,309,661,225,556,549,310,1067,573,241,330,345,724,404,684,2105,1323,896,31,0,0,31
626,1243,4435,1014,229,85,317,259,582,293,221,448,281,787,456,157,216,265,605,170,763,1337,1456,709,8,0,0,8
627,1848,5740,1503,345,263,485,549,551,276,782,602,188,1159,689,227,327,555,739,377,877,1916,1678,892,56,0,0,56
628,1529,4884,1228,301,203,470,343,513,498,380,392,259,984,545,292,176,294,767,323,690,1226,1742,903,16,0,0,16
629,1775,5844,1458,317,198,477,441,659,318,312,755,390,1073,702,159,292,440,884,242,988,1860,1795,959,70,0,0,70
630,2040,7937,1157,883,382,387,368,903,332,598,727,383,1365,675,364,519,587,570,258,1667,2599,2105,1308,39,0,0,39
631,1242,4988,953,289,88,330,295,529,215,318,440,269,650,592,163,225,330,524,337,1067,1378,1350,856,5,0,0,5
632,1711,5372,1003,708,274,480,377,580,450,497,409,355,1223,488,478,368,420,445,156,1000,1846,1338,1032,49,0,0,49
633,2378,9476,1402,976,321,459,496,1102,378,653,679,668,1284,1094,521,702,610,545,576,2160,3329,2142,1269,47,0,0,47
634,1506,5085,775,731,316,243,285,662,309,517,301,379,1073,433,534,434,283,255,115,792,1871,1576,731,36,0,0,36
635,1059,4452,750,309,108,188,273,490,188,241,299,331,720,339,254,251,297,257,217,664,1761,1043,767,9,0,0,9
636,1317,5768,921,396,138,250,208,721,314,317,256,430,726,591,340,326,319,332,485,1011,1992,1383,897,25,0,0,25
637,1326,4379,1195,131,152,416,309,449,226,328,504,268,884,442,66,255,351,654,172,566,1193,1596,852,21,0,0,21
638,1221,5982,902,319,87,179,220,735,191,255,357,418,645,576,279,242,421,279,363,1241,1993,1546,839,24,0,0,24
639,1156,4592,687,469,106,325,182,543,141,312,415,288,590,566,242,380,293,241,154,1119,1819,1164,336,22,0,0,22
640,814,3499,643,171,35,148,239,392,135,230,222,227,485,329,122,266,186,240,150,605,1217,969,558,0,0,0,0
641,834,4396,625,209,53,169,127,485,122,213,168,331,419,415,144,201,230,259,246,1093,1556,880,621,0,0,0,0
642,1041,3448,845,196,299,255,170,317,162,474,306,99,745,296,92,185,267,497,309,494,1092,898,655,0,0,0,0
643,1141,4635,857,284,73,266,306,496,147,375,336,283,714,427,201,327,318,295,83,820,1489,1364,879,53,0,0,53
644,1103,4301,1008,95,166,217,171,549,186,343,297,277,766,337,99,212,322,470,212,435,1643,1035,976,39,0,0,39
645,1014,3750,828,186,119,230,242,423,134,341,312,227,633,381,150,217,240,407,160,660,1149,1168,613,42,0,0,42
646,908,3420,703,205,91,179,124,514,140,268,325,175,559,349,115,191,208,394,86,747,1147,664,776,12,0,0,12
647,1254,4729,1112,142,88,276,248,642,212,237,585,220,607,647,174,128,251,701,272,1042,1388,1188,839,0,0,0,0
648,1918,7172,1582,336,99,341,467,1011,397,511,658,352,991,927,204,246,471,997,230,1683,1993,2137,1129,0,0,0,0
649,1138,4391,886,252,54,236,273,575,160,329,371,278,652,486,130,182,309,517,159,773,1190,1582,687,34,11,0,23
650,2154,8473,1297,857,119,407,678,950,240,524,834,556,1243,911,294,380,696,784,517,1460,2980,2440,1076,19,0,0,19
651,1862,7342,1551,311,147,425,352,938,239,476,668,479,1098,764,369,380,562,551,311,1206,2679,2170,976,71,0,0,71
652,1446,4704,1084,362,274,277,406,489,382,413,485,166,835,611,248,295,265,638,135,1072,1357,1160,980,24,0,0,24
653,3006,10735,2724,282,101,658,843,1404,193,1018,1563,232,1368,1638,80,245,342,2339,400,2986,2370,3542,1437,20,0,0,20
654,4214,9718,3767,447,1364,1677,437,736,2126,943,796,349,3536,678,1039,802,881,1492,193,1010,1720,2167,4628,8,0,0,8
655,3758,12609,3282,476,279,983,954,1542,483,1179,1615,481,2125,1633,237,355,681,2485,392,2825,3610,4244,1538,31,0,0,31
656,1808,6296,1622,186,180,539,335,754,144,492,921,251,1108,700,168,237,457,946,494,1346,1796,1949,711,32,0,0,32
657,2468,9296,1830,638,178,765,569,956,324,757,857,530,1368,1100,569,515,723,661,638,2137,3479,2304,738,61,0,0,61
658,1304,4870,951,353,133,367,201,603,319,212,584,189,775,529,224,134,289,657,342,1123,1648,951,806,0,0,0,0
659,988,2932,793,195,196,272,189,331,108,395,434,51,580,408,159,157,205,467,208,524,869,964,367,16,0,0,16
660,1148,3314,893,255,147,366,274,361,313,282,456,97,708,440,243,126,330,449,291,637,950,887,549,17,0,0,17
661,4531,12431,1943,2588,923,1552,955,1101,659,1995,1471,406,2761,1770,771,1078,1202,1480,907,2344,5596,2613,971,59,0,0,59
662,1377,4378,1142,235,212,333,291,541,261,435,520,161,757,620,73,305,293,706,192,883,1363,1297,643,24,0,0,24
663,905,2922,816,89,130,230,202,343,210,252,348,95,524,381,92,150,209,454,226,548,843,819,486,0,0,0,0
664,2586,7424,1282,1304,449,893,532,712,206,1033,1160,187,1702,884,281,499,801,1005,422,1298,2884,2031,789,38,0,0,38
665,2684,8373,2174,510,522,787,468,907,440,845,970,429,1741,943,335,412,731,1206,398,1635,3074,2413,853,58,0,0,58
666,1853,6213,1093,760,402,443,345,663,345,617,674,217,1209,644,520,564,506,263,442,1062,1971,1657,1081,46,0,0,46
667,1927,5737,909,1018,345,569,561,452,234,787,727,179,1144,783,299,726,572,330,427,1163,2447,1141,559,6,0,0,6
668,2037,6137,1568,469,331,614,516,576,255,717,754,311,1210,827,219,374,644,800,462,877,2168,1722,908,29,0,0,29
669,2463,8910,1118,1345,358,556,363,1186,442,766,859,396,1355,1108,885,747,408,423,532,2008,2978,2232,1160,43,0,0,43
670,1974,7154,1406,568,314,528,366,766,339,576,505,554,1278,696,492,352,521,609,272,1079,2757,1996,1050,28,0,0,28
671,2626,7790,390,2236,546,846,559,675,235,1036,983,372,1763,863,363,926,666,671,409,1250,3897,1346,888,51,0,0,51
672,1451,4296,893,558,296,448,317,390,332,473,542,104,1055,396,241,339,420,451,142,716,1636,971,831,46,0,0,46
673,1362,3951,1044,318,296,382,265,419,192,413,573,184,960,402,239,310,341,472,104,695,1449,1225,478,3,0,0,3
674,1683,5177,1399,284,219,488,450,526,362,495,559,267,980,703,204,330,370,779,490,820,1614,1560,693,37,0,0,37
675,1609,5635,1254,355,179,521,272,637,297,398,570,344,1057,552,168,266,409,766,380,884,1987,1595,789,46,0,0,46
676,3113,9049,1657,1456,536,1128,529,920,443,1196,1029,445,2043,1070,405,792,885,1031,472,1656,3111,2684,1126,64,0,0,64
677,1466,4237,648,818,331,435,311,389,340,433,516,177,1046,420,304,378,316,468,247,580,1434,1109,867,16,0,0,16
678,874,2692,743,131,118,310,179,267,244,203,302,125,586,288,115,126,133,500,150,410,887,646,599,32,0,0,32
679,1737,4977,914,823,294,672,366,405,312,636,675,114,1221,516,332,351,432,622,189,1089,1466,1447,786,44,0,0,44
680,2113,6633,1668,445,302,659,462,690,411,590,925,187,1319,794,284,323,456,1050,443,1281,2132,1712,1065,26,0,0,26
681,1335,3802,910,425,335,431,190,379,351,359,457,168,874,461,133,380,320,502,310,508,1190,884,910,43,0,0,43
682,1787,5050,1523,264,320,571,361,535,339,731,568,149,1195,592,220,238,484,845,382,832,1510,1660,666,20,0,0,20
683,1336,3912,1084,252,259,479,264,334,280,546,418,92,859,477,210,252,247,627,175,663,1211,1058,805,52,0,0,52
684,2196,6464,1520,676,393,606,490,707,416,706,869,205,1274,922,525,373,432,866,521,1204,2112,1843,784,13,0,0,13
685,1625,4995,954,671,237,408,423,557,226,588,651,160,918,707,285,394,355,591,332,995,1816,1354,498,9,0,0,9
686,2016,4918,1017,999,618,641,289,468,438,725,725,128,1364,652,454,476,565,521,368,875,1716,1329,630,0,0,0,0
687,1419,3960,703,716,299,598,175,347,284,438,549,148,994,425,238,348,292,541,243,693,1430,1069,525,2,0,0,2
688,2845,8304,1461,1384,670,660,610,905,592,1120,917,216,1537,1308,624,519,552,1150,696,1996,2743,1889,980,48,0,0,48
689,1419,4579,1294,125,112,470,225,612,256,381,564,218,795,624,102,176,151,990,157,1168,1082,1294,878,0,0,0,0
690,2055,6541,1763,292,155,735,460,705,567,458,780,250,1247,808,227,181,326,1321,372,1553,1462,1707,1447,23,0,0,23
691,1107,3108,982,125,108,488,288,223,287,298,424,98,795,312,113,92,147,755,57,592,419,1304,736,0,0,0,0
692,1064,3135,908,156,104,430,184,346,214,376,393,81,627,437,99,146,120,699,68,816,625,1063,563,0,0,0,0
693,1342,4417,1233,109,145,421,185,591,208,424,597,113,711,631,107,158,171,906,157,1167,1090,1371,632,2,0,0,2
694,1717,5705,1487,230,105,459,371,782,250,663,641,163,914,803,187,118,246,1166,157,1529,1229,1914,876,13,0,0,13
695,2474,7169,2373,101,344,792,607,731,556,948,832,138,1557,917,252,209,444,1569,184,1625,1313,2576,1471,0,0,0,0
696,2197,5446,1627,570,534,882,341,440,463,901,674,159,1619,578,342,393,535,927,135,915,1328,2013,1055,34,0,0,34
697,491,1697,239,252,65,117,169,140,69,270,120,32,304,187,103,172,69,147,46,356,547,393,355,30,0,0,30
698,2649,8460,2443,206,406,871,303,1069,447,1070,796,336,1532,1117,162,436,477,1574,562,1797,2394,2257,1450,13,0,0,13
699,1685,5295,1419,266,185,514,463,523,339,440,638,268,1150,535,138,231,451,865,151,1046,1413,1733,952,0,0,0,0
700,4217,13038,2741,1476,910,1057,782,1468,740,1626,1456,395,2419,1798,783,973,940,1521,1190,2897,4111,3516,1324,25,0,0,25
701,2329,6918,1738,591,364,889,323,753,644,928,630,127,1441,888,357,572,514,886,578,1412,1841,1439,1648,18,0,0,18
702,3416,10910,1740,1676,541,1071,623,1181,474,1429,1146,367,2002,1414,637,1052,715,1012,909,2044,4097,2465,1395,347,0,0,347
703,1399,4679,1219,180,52,575,288,484,249,489,419,242,859,540,103,161,324,811,251,874,1323,1443,788,20,0,0,20
704,1699,4905,1541,158,286,666,196,551,357,656,444,242,1137,562,85,290,319,1005,249,971,1224,1495,966,0,0,0,0
705,4451,14900,3242,1209,777,1333,672,1669,909,1400,1610,532,2437,2014,863,959,1051,1578,988,3665,4477,3592,2178,62,0,0,62
706,751,2838,521,230,120,259,124,248,162,312,167,110,552,199,153,170,176,252,152,504,776,898,508,55,0,0,55
707,2252,9101,776,1476,239,445,497,1071,226,867,656,503,1110,1142,627,758,520,347,756,2180,3487,1799,879,231,0,0,231
708,2656,8924,1474,1182,538,583,464,1071,693,900,668,395,1617,1039,749,642,673,592,770,2187,2973,1769,1225,3,0,0,3
709,1906,6685,1014,892,255,505,353,793,280,765,605,256,973,933,564,416,529,397,396,1719,2436,1427,707,27,0,0,27
710,2293,7947,1301,992,124,713,377,1079,320,735,911,327,1153,1140,364,698,669,562,491,2064,2851,1716,825,23,0,0,23
711,2922,9553,2422,500,288,1030,453,1151,475,1317,756,374,1667,1255,239,407,1156,1120,339,2383,2708,2936,1187,2,0,0,2
712,1492,4600,1145,347,213,664,225,390,382,508,435,167,1058,434,242,286,320,644,91,845,1036,1546,1082,180,0,0,180
713,1620,5246,1150,470,115,520,518,467,352,537,597,134,1053,567,280,368,409,563,121,795,1691,1473,1166,46,0,0,46
714,328,1308,233,95,58,89,46,135,49,117,112,50,219,109,31,117,71,109,55,303,295,301,354,37,0,0,37
715,2556,8528,2095,461,401,547,453,1155,387,886,1047,236,1219,1337,261,383,554,1358,704,1883,2513,2509,919,7,0,0,7
716,1763,4510,1002,761,360,728,311,364,425,549,666,123,1232,531,389,256,353,765,284,714,1359,1352,801,39,0,0,39
717,2199,6189,1808,391,414,678,615,492,444,646,903,206,1371,828,421,305,542,931,466,1030,1683,2007,1003,145,0,0,145
718,2680,8161,2024,656,502,830,446,902,353,944,995,388,1632,1048,206,520,755,1199,467,1722,2458,2464,1050,125,0,0,125
719,2744,7569,1732,1012,719,702,420,903,548,1121,871,204,1809,935,608,718,788,630,582,1301,2545,2174,967,14,0,0,14
720,2122,5513,1819,303,429,750,491,452,316,811,849,146,1539,583,248,268,647,959,398,810,2169,1427,709,6,0,0,6
721,2250,6166,1318,932,604,611,442,593,492,780,753,225,1533,717,482,618,471,679,531,919,1831,1858,1027,88,0,0,88
722,2773,8410,1689,1084,563,921,359,930,547,699,1074,453,1765,1008,563,787,711,712,689,1628,3251,2035,807,41,0,0,41
723,1786,5367,1299,487,214,716,256,600,200,719,765,102,1100,686,130,344,358,954,286,1077,1350,1818,836,65,0,0,65
724,2656,6909,1620,1036,777,827,498,554,650,960,717,329,1860,796,379,572,631,1074,400,1062,2212,1725,1510,156,0,0,156
725,1266,3950,1219,47,90,493,248,435,239,428,408,191,816,450,82,96,242,846,119,818,803,1488,722,29,0,0,29
726,2887,8147,2341,546,517,1018,537,815,530,1015,1025,317,1953,934,432,499,710,1246,428,1368,2414,2482,1455,10,0,0,10
727,1039,2936,888,151,208,330,220,281,197,301,446,95,678,361,106,143,296,494,229,520,1097,683,407,17,0,0,17
728,2484,6768,1976,508,554,787,412,731,513,639,1090,242,1684,800,334,699,569,882,339,1341,2430,1607,1051,36,0,0,36
729,9045,29151,6999,2046,958,1913,2047,4127,703,3306,4221,815,3741,5304,619,676,1559,6191,2024,7520,10944,6743,1920,0,0,0,0
730,4428,14259,1862,2566,544,1594,950,1340,390,1832,1881,325,2267,2161,550,687,1099,2092,1171,2189,7313,2895,691,242,0,210,32
731,2447,5272,885,1562,879,769,443,356,402,1304,672,69,1713,734,449,760,655,583,446,740,2230,1159,697,0,0,0,0
732,1901,5441,1061,840,325,690,416,470,289,694,826,92,1211,690,166,544,570,621,387,996,2162,1131,765,36,0,0,36
733,2680,7841,1694,986,477,923,637,643,428,1101,969,182,1720,960,382,609,545,1144,415,1384,2964,1989,1089,46,0,0,46
734,3313,9644,2822,491,551,996,741,1025,641,1033,1257,382,2074,1239,226,530,705,1852,555,1793,2710,2916,1670,15,0,0,15
735,1357,3683,1203,154,215,438,466,238,281,571,451,54,878,479,126,173,222,836,135,642,811,1275,820,0,0,0,0
736,3328,9607,2418,910,505,1137,778,908,569,1170,1310,279,2084,1244,287,580,834,1627,512,1827,3012,2774,1482,113,0,0,113
737,1475,4897,1185,290,157,372,316,630,185,387,801,102,763,712,179,222,238,836,409,1094,1506,1203,685,21,0,0,21
738,2049,6028,1749,300,164,721,508,656,385,599,955,110,1158,891,186,261,366,1236,124,1371,1668,1855,1010,13,0,0,13
739,2388,5405,924,1464,973,600,304,511,548,840,840,160,1716,672,718,509,344,817,396,740,1926,1524,819,356,0,0,356
740,1336,3789,1040,296,174,494,315,353,279,564,407,86,670,666,97,197,349,693,126,986,916,1178,583,7,0,0,7
741,1714,5018,1301,413,273,560,233,648,399,532,608,175,1042,672,169,230,499,816,159,1100,1312,1414,1033,23,0,0,23
742,4872,13253,2234,2638,924,1660,1008,1280,899,2061,1555,357,2874,1998,666,844,1191,2171,688,2616,5221,2999,1729,73,0,0,73
743,3428,9524,2619,809,692,967,706,1063,823,1062,1355,188,2030,1398,565,429,628,1806,272,2407,2475,3105,1265,31,0,0,31
744,1878,5519,977,901,380,690,306,502,375,660,722,121,1230,648,435,256,347,840,330,1146,1433,1498,1112,10,0,0,10
745,2117,5508,1657,460,471,843,184,619,494,839,680,104,1436,681,347,356,449,965,239,1061,1641,1498,1069,0,0,0,0
746,2659,8725,2356,303,237,895,377,1150,373,1143,915,228,1592,1067,173,330,385,1771,202,2105,2027,3087,1304,51,0,0,51
747,1131,3611,1098,33,74,404,190,463,291,296,473,71,725,406,131,110,123,767,315,492,882,1202,720,0,0,0,0
748,1277,4399,1126,151,67,230,394,586,262,364,572,79,567,710,131,94,234,818,191,951,1189,1329,739,14,0,0,14
749,2119,6683,1356,763,252,528,474,865,395,865,767,92,969,1150,219,412,501,987,520,1470,2272,1599,822,0,0,0,0
750,655,2142,475,180,55,131,218,251,97,213,310,35,220,435,114,54,146,341,105,632,797,452,156,19,0,0,19
751,12,42,9,3,0,2,4,6,2,4,5,1,4,8,1,1,3,7,2,13,16,9,2,0,0,0,0
752,596,1634,227,369,110,202,127,157,81,330,171,14,302,294,49,89,133,325,206,254,989,157,28,166,0,0,166
753,1518,4816,1359,159,152,324,438,604,346,544,535,93,844,674,105,145,303,965,139,1032,1238,1673,734,12,0,0,12
754,1230,4134,1098,132,148,331,221,530,318,421,290,201,880,350,100,83,238,809,89,718,1061,1385,881,76,0,0,76
755,3190,10408,2385,805,228,851,892,1219,604,1041,1265,280,1867,1323,354,414,548,1874,546,2001,2878,3444,1539,1,0,0,1
756,2143,7111,1765,378,145,471,645,882,296,578,1080,189,1049,1094,186,202,400,1355,389,1661,2092,2277,692,24,0,0,24
757,834,2762,678,156,69,257,170,338,100,350,318,66,411,423,164,130,251,289,132,622,822,949,237,30,0,0,30
758,1967,6599,1449,518,245,414,401,907,323,796,593,255,1029,938,395,437,341,794,205,1596,2032,1930,836,20,0,0,20
759,2290,7780,1251,1039,156,594,588,952,264,877,920,229,1090,1200,153,307,774,1056,520,1593,2481,2244,942,27,0,0,27
760,1983,6417,1248,735,289,599,381,714,396,679,634,274,1235,748,334,418,536,695,467,786,2791,1650,723,22,0,0,22
761,3748,11583,1482,2266,761,794,861,1332,791,1257,1426,274,1963,1785,764,668,906,1410,525,2846,4236,3035,941,191,0,0,191
762,1278,3827,322,956,188,472,315,303,154,478,432,214,866,412,53,246,420,559,235,494,2147,673,278,19,0,0,19
763,3196,8411,799,2397,816,974,666,740,826,1372,783,215,2035,1161,587,830,914,865,619,1212,4221,1536,823,35,0,0,35
764,2163,7230,1092,1071,247,785,262,869,339,807,567,450,1448,715,237,762,489,675,209,968,2581,2432,1040,36,0,0,36
765,922,3115,781,141,92,262,251,317,148,253,382,139,502,420,86,151,271,414,203,533,1112,805,462,33,0,0,33
766,1039,3139,771,268,98,390,229,322,239,350,388,62,628,411,107,96,313,523,116,688,1002,875,458,22,0,0,22
767,3638,11016,3096,542,487,1202,844,1105,584,1003,1549,502,2277,1361,318,588,808,1924,712,1316,4789,2887,1312,14,0,0,14
768,3119,10106,2117,1002,365,983,689,1082,503,806,1404,406,1942,1177,356,466,692,1605,654,1503,4621,2252,1076,74,0,0,74
769,4195,13373,2622,1573,406,762,1189,1838,592,1432,1939,232,1666,2529,193,359,939,2704,757,3495,5303,2944,874,69,0,0,69
770,2028,6787,1565,463,215,700,360,753,235,716,717,360,1426,602,261,400,513,854,310,910,2464,2159,944,11,0,0,11
771,2601,7211,1917,684,405,1176,364,656,712,795,816,278,1869,732,543,365,732,961,305,1155,2062,2266,1423,21,0,0,21
772,1468,5337,699,769,148,336,264,720,308,335,546,279,804,664,244,471,482,271,358,1121,1956,1403,499,137,0,0,137
773,1952,7018,897,1055,293,516,335,808,376,620,693,263,1127,825,253,422,591,686,740,1373,2805,1408,692,32,0,0,32
774,3381,9146,1636,1745,962,898,692,829,655,1532,1102,92,2348,1033,775,908,695,1003,715,1366,3844,2219,1002,870,0,0,870
775,2835,8606,1637,1198,496,875,619,845,675,1165,758,237,1821,1014,592,522,621,1100,522,1550,2696,2516,1322,36,0,0,36
776,2272,6265,1417,855,447,690,498,637,521,910,712,129,1376,896,420,373,567,912,338,1142,2356,1552,877,41,0,0,41
777,2218,5743,147,2071,514,791,372,541,528,1023,643,24,1351,867,368,510,695,645,554,754,2801,1008,626,0,0,0,0
778,5523,13981,2168,3355,1224,1976,1329,994,1058,2462,1723,280,3760,1763,917,884,1501,2221,1146,1552,7117,2818,1348,26,0,0,26
779,1590,5322,1269,321,170,319,373,728,250,408,780,152,917,673,108,176,305,1001,80,1151,1459,1829,803,0,0,0,0
780,959,2984,847,112,158,241,187,373,292,256,329,82,623,336,158,90,193,518,140,596,672,983,593,19,0,0,19
781,1846,4737,1451,395,645,481,245,475,658,552,493,143,1370,476,455,256,355,780,200,837,1301,1277,1122,11,0,0,11
782,2562,7266,1642,920,442,673,763,684,478,1074,893,117,1470,1092,252,615,686,1009,388,1358,2492,1943,1085,50,0,0,50
783,1089,3003,515,574,179,447,180,283,175,430,435,49,748,341,143,154,310,482,89,521,1379,558,456,0,0,0,0
784,1891,5856,1354,537,213,571,378,729,512,463,765,151,1080,811,241,250,303,1097,261,1158,2124,1457,856,11,0,0,11
785,2282,7529,1383,899,408,604,233,1037,461,685,926,210,1300,982,534,513,463,772,896,1424,2315,1618,1276,91,0,0,91
786,1538,4754,1268,270,159,548,370,461,347,622,396,173,1045,493,200,206,384,748,165,639,1721,1416,813,21,0,0,21
787,2367,7549,1363,1004,215,631,661,860,532,903,738,194,1144,1223,330,238,635,1164,517,1531,3139,1379,983,18,0,0,18
788,1864,6122,1441,423,206,386,392,880,379,582,637,266,1016,848,272,244,288,1060,382,1157,2023,1513,1047,18,0,0,18
789,1422,5116,1178,244,151,236,246,789,338,342,590,152,676,746,194,237,324,667,259,1280,1788,1117,672,8,0,0,8
790,1818,6296,1593,225,166,613,330,709,392,616,633,177,1217,601,215,240,418,945,322,882,1956,1777,1359,33,0,0,33
791,1005,3748,722,283,148,200,184,473,229,259,297,220,664,341,98,408,204,295,176,574,1367,1029,602,21,0,0,21
792,869,3531,780,89,48,237,117,467,172,316,263,118,489,380,108,155,236,370,181,544,1212,848,746,60,0,0,60
793,1404,4852,1025,379,168,345,285,606,400,226,526,252,930,474,213,359,332,500,253,634,1582,1220,1163,20,0,0,20
794,897,3203,800,97,60,182,226,429,144,207,420,126,531,366,79,142,205,471,138,515,954,1186,410,0,0,0,0
795,872,3086,480,392,34,189,246,403,128,246,256,242,524,348,90,262,291,229,138,483,1239,824,402,21,0,0,21
796,1960,6932,1640,320,241,526,362,831,531,510,606,313,1227,733,287,442,588,643,271,1000,2156,1981,1524,81,0,0,81
797,2109,7126,1591,518,299,579,460,771,477,831,564,237,1313,796,459,495,347,808,248,1414,2627,1921,916,34,0,0,34
798,1495,4481,1004,491,443,386,348,318,490,522,362,121,1146,349,380,369,255,491,189,627,1358,1146,1161,17,0,0,17
799,1796,5344,1367,429,308,464,464,560,506,547,613,130,1102,694,140,312,392,952,218,925,1493,1748,960,14,0,0,14
800,1898,5864,844,1054,403,557,409,529,686,570,363,279,1425,473,539,425,445,489,231,506,2104,1664,1359,183,0,0,183
801,3702,11210,1855,1847,607,1312,682,1101,553,1483,1349,317,2555,1147,422,615,1004,1661,614,1730,4758,2829,1279,118,0,0,118
802,1449,5683,725,724,109,221,312,807,253,500,399,297,797,652,218,426,488,317,333,1127,2142,1354,727,22,0,0,22
803,1022,2699,573,449,289,413,95,225,561,246,167,48,777,245,254,238,241,289,56,474,783,631,755,0,0,0,0
804,1196,3823,810,386,225,404,187,380,300,372,339,185,782,414,154,412,306,324,158,705,1285,1167,508,31,0,0,31
805,2213,7775,1741,472,265,519,500,929,392,509,797,515,1272,941,237,456,666,854,552,1087,2677,2542,917,13,0,0,13
806,3194,10462,2613,581,571,825,641,1157,948,921,885,440,2403,791,696,936,755,807,334,1299,3569,3054,2206,166,0,0,166
807,1205,4895,999,206,177,210,136,682,329,275,391,210,664,541,290,329,343,243,279,1003,1604,1333,676,13,0,0,13
808,862,3899,751,111,101,144,115,502,142,193,293,234,436,426,115,232,289,226,211,726,1378,1119,465,26,0,0,26
809,743,2671,602,141,119,186,148,290,202,161,260,120,516,227,109,296,238,100,140,355,775,877,524,18,0,0,18
810,3773,12400,2820,953,534,1023,721,1495,825,1174,1000,774,2649,1124,930,1024,646,1173,572,1620,4327,3772,2109,51,0,0,51
811,2616,8491,1743,873,416,974,404,822,669,786,817,344,1765,851,592,768,629,627,592,968,3093,2398,1440,75,0,0,75
812,1113,3471,858,255,292,302,157,362,327,357,321,108,808,305,266,261,310,276,290,423,1159,1073,526,46,0,0,46
813,1050,3135,497,553,256,303,198,293,231,427,202,190,719,331,460,223,202,165,187,400,1391,650,507,40,0,0,40
814,1064,3733,929,135,207,295,158,404,335,278,228,223,690,374,211,374,261,218,155,653,1363,922,640,17,0,0,17
815,1166,4172,283,883,197,223,267,479,329,487,231,119,604,562,429,298,275,164,282,1176,1343,960,411,23,0,0,23
816,902,3455,478,424,130,233,177,362,265,237,227,173,566,336,189,261,278,174,169,552,1119,955,660,23,0,0,23
817,2045,7477,325,1720,227,353,487,978,379,672,542,452,986,1059,593,825,440,187,242,1981,3215,1707,332,79,0,0,79
818,1346,4940,954,392,189,259,284,614,342,272,288,444,929,417,192,340,329,485,155,801,1979,1473,532,0,0,0,0
819,670,2032,212,458,114,198,137,221,195,247,138,90,395,275,224,189,145,112,231,357,825,385,234,18,0,0,18
820,4889,14488,3222,1667,716,1722,958,1493,1024,1450,1947,468,3225,1664,676,913,1172,2128,712,2411,5318,4058,1989,67,0,0,67
821,1395,5414,1041,354,270,445,235,445,345,431,481,138,999,396,188,286,465,456,129,1319,1957,1338,671,1111,1084,0,27
822,1229,3515,1048,181,245,469,174,341,345,492,273,119,905,324,47,232,462,488,107,477,1126,1033,772,204,175,0,29
823,2692,7476,1591,1101,712,786,511,683,597,933,922,240,2062,630,698,451,787,756,502,780,2826,2236,1132,64,0,0,64
824,1866,5564,705,1161,311,541,462,552,278,831,599,158,1206,660,497,672,422,275,334,1047,2673,1051,459,168,149,0,19
825,1893,6569,708,1185,297,613,240,743,495,537,603,258,1219,674,615,586,389,303,478,1160,2669,1604,658,31,0,0,31
826,1645,5255,407,1238,259,441,314,631,360,552,575,158,916,729,467,509,483,186,384,1131,2162,1112,466,38,0,0,38
827,1347,4167,692,655,281,277,334,455,237,550,220,340,827,520,221,450,344,332,164,607,1743,1195,458,8,0,0,8
828,3184,9252,1607,1577,730,880,550,1024,615,1262,1056,251,2025,1159,596,943,722,923,661,1560,3997,2098,936,31,0,0,31
829,1160,3396,687,473,270,304,265,321,272,487,279,122,676,484,340,279,323,218,206,754,1351,737,348,20,0,0,20
830,1865,6403,891,974,254,453,490,668,352,667,531,315,998,867,685,372,491,317,392,1588,2229,1556,638,0,0,0,0
831,1271,4128,159,1112,283,283,151,554,325,435,287,224,823,448,415,461,249,146,349,557,1744,871,607,90,0,0,90
832,1705,5782,1014,691,375,380,322,628,473,422,407,403,1083,622,492,423,292,498,376,1005,1807,1603,991,0,0,0,0
833,1408,5114,1230,178,189,459,191,569,296,340,579,193,926,482,307,351,411,339,478,645,1813,1409,769,21,0,0,21
834,1529,5290,1282,247,273,389,264,603,395,356,446,332,1006,523,260,399,475,395,229,742,1804,1712,803,28,0,0,28
835,1721,5687,1238,483,231,463,354,673,323,597,533,268,1011,710,422,472,495,332,127,1277,1742,1765,776,21,0,0,21
836,1479,4819,1040,439,318,406,208,547,378,486,519,96,1086,393,254,553,387,285,149,674,1432,1606,958,24,0,0,24
837,3131,10987,907,2224,579,941,513,1098,750,1043,1039,299,1952,1179,841,1306,673,311,532,2257,4013,2818,1367,168,0,0,168
838,1403,4153,416,987,462,368,150,423,379,533,328,163,1012,391,523,399,287,194,138,902,1380,1189,544,50,0,0,50
839,1918,5048,662,1256,769,435,351,363,616,557,591,154,1393,525,633,554,391,340,365,752,2069,1230,632,122,0,0,122
840,2443,5818,1132,1311,878,894,342,329,776,940,613,114,1870,573,501,800,686,456,159,871,2250,1336,1202,32,0,0,32
841,1702,4845,783,919,323,745,332,302,227,725,617,133,1266,436,472,513,440,277,174,610,1640,1495,926,0,0,0,0
842,1286,3273,343,943,375,547,108,256,197,405,573,111,946,340,327,420,391,148,176,463,1386,906,342,20,0,0,20
843,1442,4647,1175,267,219,551,245,427,376,509,409,148,992,450,184,346,516,396,262,636,1268,1354,1127,33,0,0,33
844,3226,9605,2899,327,552,1058,634,982,779,985,1035,427,2207,1019,418,359,690,1759,327,1770,2685,2852,1971,24,3,0,21
845,2376,7725,2179,197,227,623,591,935,598,576,953,249,1259,1117,280,420,533,1143,353,1641,1751,2395,1585,3,0,0,3
846,2053,5835,1425,628,543,429,437,644,600,636,504,313,1406,647,636,526,450,441,287,1047,1842,1617,1042,14,0,0,14
847,1096,3049,394,702,213,400,238,245,287,389,333,87,751,345,266,394,243,193,113,474,1082,729,651,0,0,0,0
848,1778,5236,608,1170,425,621,248,484,340,654,657,127,1019,759,517,421,478,362,356,1012,1752,1374,742,48,0,0,48
849,1362,4085,1056,306,292,357,263,450,294,463,517,88,787,575,362,281,310,409,253,838,1231,1127,636,17,0,0,17
850,1309,4290,1147,162,153,434,216,506,281,337,499,192,780,529,132,166,379,632,310,767,1356,982,875,0,0,0,0
851,703,2132,651,52,48,339,86,230,128,196,337,42,475,228,38,82,181,402,102,364,698,521,447,0,0,0,0
852,2207,6244,2042,165,349,883,342,633,494,564,945,204,1489,718,422,515,417,853,297,879,1691,2090,1287,17,0,0,17
853,2105,6250,1195,910,424,1112,166,403,493,657,732,223,1523,582,591,579,540,395,300,975,2399,1713,863,18,0,0,18
854,2304,7216,440,1864,456,522,570,756,509,839,907,49,1194,1110,982,703,490,129,955,1657,2899,1218,487,24,0,0,24
855,1656,5137,550,1106,347,490,322,497,381,697,369,209,1093,563,891,292,207,266,189,1010,1969,1254,715,65,0,0,65
856,2493,7686,1265,1228,445,768,524,756,368,841,949,335,1645,848,747,643,690,413,361,1031,2790,2284,1220,49,0,0,49
857,1019,3258,553,466,241,269,107,402,176,406,302,135,611,408,324,317,216,162,227,566,1104,1000,361,27,0,0,27
858,2174,5844,1333,841,544,639,590,401,739,727,506,202,1520,654,644,710,490,330,217,785,1675,1859,1308,33,0,0,33
859,1493,4277,1227,266,369,453,280,391,527,370,319,277,1178,315,631,249,296,317,44,529,1372,1490,842,10,0,0,10
860,2107,5885,1548,559,485,691,429,502,519,559,842,187,1575,532,397,570,471,669,327,784,2161,1506,1107,23,0,0,23
861,2020,7426,1639,381,167,554,456,843,396,521,649,454,1375,645,418,638,642,322,138,1278,2259,2339,1412,30,0,0,30
862,2629,8120,1196,1433,1029,378,391,831,677,935,526,491,1944,685,977,825,444,383,254,1527,2733,2214,1392,21,0,0,21
863,1246,4239,890,356,217,363,180,486,172,485,355,234,792,454,258,315,324,349,140,733,1473,1203,690,26,0,0,26
864,3195,8214,960,2235,1035,1012,455,693,846,1278,787,284,2456,739,1202,1069,558,366,255,1194,2977,2434,1354,18,0,0,18
865,1347,3785,941,406,291,428,304,324,318,500,370,159,947,400,376,387,336,248,269,511,1153,1064,788,23,0,0,23
866,1386,3775,1142,244,375,544,141,326,501,391,306,188,1055,331,321,251,390,424,115,627,1024,943,1066,26,0,0,26
867,1015,2853,786,229,263,252,246,254,226,413,238,138,707,308,255,302,137,321,107,428,976,857,485,1,0,0,1
868,1284,3653,928,356,303,432,180,369,177,476,437,194,906,378,195,179,279,631,166,591,1294,1105,497,198,0,0,198
869,1461,3764,677,784,505,449,281,226,404,581,363,113,1105,356,462,357,302,340,246,478,1354,1014,672,57,0,0,57
870,1677,4767,1145,532,366,574,293,444,317,512,648,200,1259,418,405,206,400,666,182,682,1553,1581,769,40,0,0,40
871,3043,7215,1035,2008,1128,927,590,398,607,1286,929,221,2337,706,890,875,786,492,355,1000,2723,2035,1102,77,0,0,77
872,2833,10018,1426,1407,422,814,541,1056,358,924,858,693,1904,929,791,655,735,652,400,1507,3874,2588,1649,22,0,0,22
873,1775,6475,924,851,288,432,347,708,391,500,584,300,978,797,522,516,456,281,336,1420,2305,1603,811,25,0,0,25
874,0,0,0,0,0,0,0,0,0,0,0,0,0,0,0,0,0,0,0,0,0,0,0,0,0,0,0
875,1080,5152,505,575,158,183,143,596,159,422,299,200,515,565,382,374,192,132,589,1103,2089,885,486,749,0,0,749
876,653,2419,423,230,176,129,60,288,135,228,149,141,435,218,219,244,119,71,117,484,1034,547,237,0,0,0,0
877,1031,3615,600,431,249,186,149,447,229,397,264,141,625,406,316,458,203,54,178,842,1383,865,347,65,0,0,65
878,1715,5750,619,1096,434,265,449,567,534,537,360,284,848,867,760,664,199,92,547,1175,2325,1324,379,91,0,0,91
879,1364,4487,691,673,389,265,232,478,210,563,302,289,923,441,449,325,406,184,292,725,1650,1257,563,13,0,0,13
880,1194,4306,515,679,237,177,278,502,230,385,367,212,548,646,577,333,224,60,326,1115,1750,916,199,14,0,0,14
881,1027,3052,526,501,272,325,127,303,202,389,327,109,660,367,349,363,187,128,241,601,997,874,339,29,0,0,29
882,1273,3556,780,493,282,425,271,295,283,501,428,61,760,513,403,351,314,205,279,660,1232,911,474,6,0,0,6
883,1309,3382,1161,148,338,517,200,254,455,279,509,66,1034,275,252,249,260,548,295,222,868,944,1053,11,0,0,11
884,1414,3976,1275,139,288,425,372,329,332,411,623,48,1006,408,199,273,365,577,140,545,1296,1064,931,22,0,0,22
885,2896,7249,2497,399,702,1183,365,646,710,971,1134,81,2089,807,384,537,630,1345,420,1012,2366,2112,1339,0,0,0,0
886,1831,4722,1292,539,541,674,380,236,408,716,558,149,1503,328,494,358,450,529,377,406,2033,1291,615,32,0,0,32
887,1210,3580,740,470,260,432,340,178,266,548,274,122,800,410,278,328,274,330,198,474,1557,955,396,63,0,0,63
888,1648,5240,445,1203,518,266,268,596,546,583,387,132,999,649,980,448,161,59,380,1525,1907,1053,375,40,0,0,40
889,1328,4045,578,750,290,391,332,315,255,485,431,157,916,412,520,437,204,167,258,644,1713,927,503,16,0,0,16
890,1741,5891,719,1022,500,281,313,647,443,613,420,265,1091,650,758,466,319,198,438,1211,2160,1557,525,20,0,0,20
891,1694,4956,595,1099,478,613,56,547,514,622,412,146,1251,443,856,464,142,232,287,1081,1900,1182,506,15,0,0,15
892,1267,4465,634,633,355,170,146,596,292,431,305,239,796,471,581,353,232,101,247,1066,1820,1019,313,102,0,0,102
893,1015,3819,330,685,197,159,158,501,177,510,215,113,454,561,508,316,130,61,203,1026,1393,907,290,176,0,0,176
894,1215,4403,341,874,324,267,112,512,377,451,233,154,719,496,661,303,177,74,291,987,1707,1000,418,242,0,0,242
895,2412,8163,532,1880,708,531,185,988,622,976,483,331,1312,1100,1369,695,301,47,826,2058,3180,1499,600,219,0,0,219
896,637,2416,221,416,138,134,107,258,110,290,110,127,380,257,244,181,165,47,100,447,1111,571,187,1046,0,0,1046
897,1281,4271,392,889,430,230,178,443,431,374,270,206,757,524,621,366,244,50,206,974,1354,1147,590,74,0,0,74
898,1306,4032,422,884,424,226,307,349,379,549,342,36,747,559,704,376,149,77,419,983,1551,698,381,41,0,0,41
899,2684,7538,1158,1526,1027,561,418,678,906,1170,266,342,1835,849,1444,669,300,271,437,1598,2609,2069,825,36,0,0,36
900,1988,6484,853,1135,495,592,269,632,411,683,565,329,1306,682,810,525,534,119,373,1368,2337,1764,642,158,0,0,158
901,1891,4399,918,973,673,558,463,197,485,712,550,144,1344,547,677,474,268,472,273,708,1463,1239,716,0,0,0,0
902,775,2841,588,187,239,216,142,178,171,263,319,22,544,231,233,143,172,227,134,768,1026,581,332,310,276,0,34
903,1684,4238,1330,354,458,588,337,301,394,617,598,75,1147,537,267,542,350,525,319,598,1527,1167,627,9,0,0,9
904,2047,6473,1010,1037,643,410,261,733,234,913,609,291,1290,757,622,618,457,350,458,1107,3180,1061,667,53,0,0,53
905,2548,8409,1088,1460,611,596,412,929,561,878,921,188,1547,1001,1168,631,355,394,631,1805,3291,1825,857,22,0,0,22
906,1995,6202,1113,882,428,531,393,643,369,658,816,152,1249,746,529,600,531,335,640,897,2637,1019,1009,28,0,0,28
907,1354,3105,1011,343,279,620,323,132,182,671,468,33,806,548,194,343,333,484,128,573,1008,926,470,20,0,0,20
908,1472,3632,877,595,465,578,175,254,312,435,696,29,1179,293,262,306,474,430,167,513,1260,1045,647,16,0,0,16
909,1516,4204,1092,424,342,573,263,338,303,511,659,43,1067,449,172,397,384,563,173,863,1408,986,774,36,0,0,36
910,2083,5380,1379,704,689,584,303,507,395,667,776,245,1567,516,322,480,471,810,522,453,1833,1627,945,237,0,0,237
911,1045,2780,904,141,293,399,242,111,331,302,313,99,834,211,126,202,178,539,155,382,800,770,673,104,104,0,0
912,1924,4906,1647,277,391,722,448,363,611,605,628,80,1355,569,198,239,349,1138,328,685,1184,1528,1181,1,1,0,0
913,2597,6149,2459,138,616,1076,480,425,650,822,988,137,1864,733,239,302,475,1581,513,784,1554,1931,1367,29,0,0,29
914,2501,5914,2178,323,778,913,298,512,630,1018,743,110,1876,625,459,327,405,1310,247,1037,1699,1759,1172,0,0,0,0
915,1614,3909,1335,279,442,565,303,304,427,451,676,60,1101,513,157,248,268,941,130,729,947,1291,812,7,2,0,5
916,1703,4320,1279,424,428,693,285,297,443,561,620,79,1178,525,126,251,362,964,300,776,1143,1223,878,116,104,0,12
917,2227,5949,1556,671,577,625,400,625,530,722,897,78,1433,794,322,329,339,1237,369,1280,1378,1740,1182,1,0,0,1
918,2041,6025,1923,118,292,706,316,727,432,681,819,109,1183,858,57,173,239,1572,341,1387,1401,1382,1514,9,0,0,9
919,707,1891,634,73,122,295,141,149,134,258,272,43,458,249,30,76,150,451,81,423,271,689,427,0,0,0,0
920,856,2206,810,46,114,451,104,187,202,263,319,72,633,223,74,100,128,554,147,287,486,819,467,0,0,0,0
921,1145,2744,566,579,458,299,185,203,373,442,288,42,886,259,316,263,190,376,105,469,771,778,621,0,0,0,0
922,2007,4594,1170,837,482,971,257,297,374,575,999,59,1517,490,441,273,530,763,250,572,1485,1338,949,0,0,0,0
923,2761,7071,1130,1631,920,673,645,523,696,1127,775,163,2093,668,1092,816,407,446,350,997,2756,1867,1101,67,0,0,67
924,1920,6494,625,1295,437,457,260,766,271,692,675,282,1136,784,769,475,447,229,284,1367,2222,1681,940,46,0,0,46
925,1815,6456,539,1276,360,406,217,832,314,614,630,257,1073,742,783,635,261,136,352,1404,2769,1363,568,42,0,0,42
926,1803,4914,634,1169,521,660,245,377,481,661,522,139,1380,423,745,544,180,334,312,552,2284,1097,669,827,0,0,827
927,1350,4733,172,1178,300,239,290,521,377,459,263,251,865,485,671,425,139,115,308,755,2014,975,681,0,0,0,0
928,1477,4940,301,1176,373,237,225,642,270,613,381,213,843,634,747,498,139,93,256,1090,1924,1246,424,39,0,0,39
929,1367,4515,611,756,213,477,229,448,270,493,393,211,818,549,608,340,207,212,309,860,1872,875,599,37,0,0,37
930,824,2598,344,480,260,188,85,291,218,356,166,84,484,340,337,215,126,146,149,382,735,474,858,56,0,0,56
931,1505,3522,463,1042,664,457,125,259,182,741,484,98,1250,255,382,655,305,163,84,615,1451,1068,304,9,0,0,9
932,1354,4223,483,871,354,267,212,521,265,604,315,170,840,514,548,450,205,151,229,848,1818,926,402,0,0,0,0
933,2050,7027,643,1407,327,504,403,816,430,743,487,390,1208,842,931,553,353,213,379,1458,2740,1780,670,217,0,0,217
934,3393,8309,347,3046,1205,1162,524,502,817,1333,996,247,2774,619,1448,916,592,437,319,909,4159,1916,1006,25,0,0,25
935,1601,3520,404,1197,622,573,188,218,380,664,471,86,1340,261,592,407,300,302,83,384,1622,848,583,84,0,0,84
936,1442,3032,376,1066,713,418,100,211,210,760,318,154,1224,218,544,392,217,289,125,314,1551,804,238,0,0,0,0
937,1622,3764,1133,489,431,677,291,223,287,531,753,51,1136,486,312,192,403,715,263,572,1156,1098,675,8,0,0,8
938,1702,4508,1616,86,266,764,169,503,327,494,791,90,1066,636,142,144,238,1178,239,924,1265,1156,924,10,0,0,10
939,2000,4131,698,1302,806,750,209,235,254,1056,660,30,1624,376,332,331,491,846,262,420,1861,947,641,12,0,0,12
940,2319,4123,755,1564,1236,686,342,55,647,921,735,16,1994,325,533,583,509,694,234,259,1982,902,746,21,0,0,21
941,3013,5430,453,2560,1565,988,325,135,721,1290,972,30,2512,501,586,1088,734,605,225,397,2847,1479,482,34,0,0,34
942,2957,5132,386,2571,1446,1249,190,72,739,1241,948,29,2607,350,656,941,769,591,259,210,2917,842,904,67,0,0,67
943,2397,5103,593,1804,1177,738,292,190,393,1138,781,85,2022,375,602,535,685,575,288,449,2159,1452,755,11,0,0,11
944,2365,4208,205,2160,1115,977,158,115,516,1062,672,115,2177,188,830,539,385,611,146,208,2338,713,803,49,0,0,49
945,3661,5440,320,3341,2347,1134,137,43,1172,1906,560,23,3449,212,1622,870,551,618,145,121,2586,1050,1538,288,0,0,288
946,2187,4386,642,1545,1018,860,118,191,491,825,691,180,1884,303,724,255,579,629,65,273,2388,1036,624,319,0,0,319
947,1823,4760,337,1486,718,429,253,423,501,634,462,226,1420,403,851,415,245,312,174,741,1546,1531,768,881,0,107,774
948,1648,4632,590,1058,433,459,303,453,214,712,642,80,974,674,462,329,450,407,276,963,1603,1267,523,122,0,104,18
949,1375,4222,1046,329,203,489,187,496,315,385,569,106,813,562,115,180,306,774,316,744,1232,1187,743,0,0,0,0
950,1867,4887,967,900,471,603,338,455,398,612,720,137,1251,616,277,357,490,743,244,984,1364,1407,888,0,0,0,0
951,2701,6454,1495,1206,758,952,531,460,890,851,836,124,1880,821,763,575,531,832,361,1110,1840,1592,1551,0,0,0,0
952,2326,7203,1888,438,371,738,515,702,435,621,941,329,1423,903,178,411,531,1206,374,1222,2630,1739,1238,45,0,0,45
953,2516,7022,2179,337,438,879,458,741,746,600,921,249,1629,887,326,215,492,1483,263,1258,1565,2226,1710,18,0,0,18
954,1836,4756,638,1198,566,590,331,349,357,799,611,69,1258,578,523,506,402,405,268,698,1813,1164,813,0,0,0,0
955,1261,2906,231,1030,413,395,273,180,258,635,357,11,851,410,322,427,353,159,339,378,1162,685,342,0,0,0,0
956,2009,4686,607,1402,717,629,352,311,513,674,707,115,1394,615,440,531,418,620,269,675,1457,1549,736,46,0,0,46
957,1466,3370,399,1067,514,502,249,201,316,571,557,22,1136,330,253,267,432,514,192,453,1435,725,565,14,0,0,14
958,1518,3167,661,857,609,637,114,158,291,722,457,48,1241,277,248,382,378,510,181,273,1008,903,802,10,0,0,10
959,1789,4301,793,996,627,540,255,367,326,815,557,91,1301,488,552,305,243,689,355,545,1807,1079,515,2,0,0,2
960,1957,5132,1004,953,551,551,372,483,426,686,756,89,1278,679,492,421,363,681,231,1019,2026,1043,813,306,0,0,306
961,1177,3705,686,491,167,408,207,395,354,344,411,68,612,565,338,126,157,556,342,749,1370,761,483,42,0,0,42
962,1883,4761,347,1536,669,532,300,382,423,717,649,94,1413,470,547,649,428,259,314,638,2060,1232,517,1,0,0,1
963,2185,5039,880,1305,815,742,243,385,417,870,799,99,1784,401,530,474,496,685,266,615,1986,1411,761,0,0,0,0
964,305,1322,0,305,52,92,77,84,66,65,161,13,199,106,175,88,9,33,185,351,348,276,162,8,0,0,8
965,245,625,142,103,35,160,25,25,80,99,22,44,188,57,68,43,60,74,9,9,349,144,114,233,0,0,233
966,32,50,28,4,17,15,0,0,4,24,4,0,32,0,0,3,19,10,0,0,9,21,20,113,0,0,113
967,554,930,407,147,304,234,12,4,66,309,179,0,533,21,59,74,172,249,17,9,507,297,100,121,0,0,121
968,1211,2242,472,739,494,595,28,94,636,345,213,17,1126,85,658,228,198,127,48,151,764,431,848,94,0,0,94
969,1235,2522,385,850,653,418,113,51,342,588,287,18,1126,109,437,161,299,338,76,167,1170,650,459,148,0,0,148
970,2615,5172,285,2330,1285,924,244,162,820,1245,485,65,2090,525,1281,360,481,493,181,554,2378,952,1107,527,284,0,243
971,723,1048,6,717,542,154,20,7,303,292,127,1,685,38,358,104,130,131,4,19,628,124,273,38,9,0,29
972,3720,6605,586,3134,1938,1244,432,106,932,1732,954,102,3260,460,1245,743,834,898,173,334,3665,1290,1143,122,0,0,122
973,1495,2592,385,1110,816,423,175,81,300,771,401,23,1235,260,403,400,340,352,89,256,1218,657,372,9,0,0,9
974,3048,5372,822,2226,1584,1117,255,92,903,1156,959,30,2728,320,797,649,682,920,329,269,2414,1102,1258,24,0,0,24
975,1301,2735,505,796,414,591,186,110,187,548,498,68,1105,196,272,316,213,500,113,222,1490,628,282,155,0,0,155
976,2614,5480,549,2065,1164,829,402,219,435,1324,704,151,2086,528,619,886,507,602,225,638,3020,1174,423,188,0,0,188
977,2698,7089,999,1699,820,1028,409,441,411,1005,991,291,2165,533,593,452,632,1021,436,803,3744,1580,526,199,0,0,199
978,1687,5202,399,1288,471,471,194,551,288,595,488,316,1358,329,509,532,349,297,290,575,3068,870,399,672,0,0,672
979,2301,4516,290,2011,1314,661,214,112,353,1252,612,84,2036,265,662,581,620,438,151,265,2502,1073,525,1408,0,0,1408
980,501,1433,199,302,146,172,56,127,122,184,135,60,405,96,139,80,129,153,34,250,711,303,135,14,0,0,14
981,340,719,60,280,176,105,19,40,132,146,40,22,291,49,208,67,22,43,14,122,232,160,191,23,0,0,23
982,773,2010,124,649,273,210,96,194,303,280,171,19,556,217,444,203,89,37,65,473,799,465,208,7,0,0,7
983,1242,2623,287,955,567,432,105,138,518,509,135,80,1017,225,855,145,129,113,143,399,893,707,481,29,0,0,29
984,171,480,20,151,43,59,39,30,51,68,42,10,91,80,107,31,10,23,46,109,192,80,53,52,0,0,52
985,832,2601,127,705,165,244,222,201,211,406,174,41,504,328,476,150,71,135,209,554,1140,434,264,213,0,0,213
986,694,1737,217,477,254,234,103,103,142,165,310,77,593,101,195,206,162,131,23,276,1030,275,133,406,0,0,406
987,693,1709,211,482,213,271,110,99,140,309,196,48,483,210,214,248,93,138,146,211,907,318,127,22,0,0,22
988,1393,3239,664,729,447,584,282,80,36,767,499,91,1142,251,168,253,485,487,86,391,1815,816,131,2099,0,0,2099
989,920,2437,260,660,335,221,153,211,156,414,258,92,636,284,294,206,132,288,82,427,1293,510,125,437,0,0,437
990,1206,3043,434,772,519,313,189,185,346,454,247,159,995,211,521,237,240,208,129,357,1542,841,174,107,0,0,107
991,6741,11825,2094,4647,3469,2292,808,172,1207,3580,1731,223,6136,605,1556,1632,1482,2071,441,469,7198,2284,1433,254,0,0,254
992,1099,2794,397,702,276,421,201,201,146,380,417,156,767,332,167,375,199,358,193,297,1506,661,137,12,0,0,12
993,2013,4611,713,1300,653,873,244,243,323,853,710,127,1621,392,600,456,399,558,152,447,2240,1180,592,122,0,0,122
994,928,2385,473,455,244,344,166,174,201,354,315,58,661,267,258,220,246,204,175,316,1078,498,318,28,0,0,28
995,1405,3648,408,997,431,510,133,331,265,688,334,118,1079,326,523,269,287,326,98,609,1713,783,445,395,42,0,353
996,2038,4831,753,1285,655,726,365,292,289,857,663,229,1602,436,473,551,504,510,288,638,2219,1200,486,36,2,0,34
997,701,1891,292,409,167,273,120,141,81,250,325,45,520,181,108,102,207,284,126,189,899,533,144,17,0,0,17
998,2355,5140,906,1449,961,710,300,384,669,757,794,135,1808,547,410,480,403,1062,125,865,2017,1309,824,131,29,0,102
999,1014,2452,564,450,281,416,170,147,200,430,330,54,775,239,109,139,196,570,182,244,865,554,607,66,0,0,66
1000,1752,4291,847,905,607,532,232,381,401,528,720,103,1294,458,313,244,406,789,329,614,1834,973,541,25,0,0,25
1001,1669,3947,789,880,510,541,171,447,340,685,483,161,1371,298,488,402,349,430,156,440,2069,639,643,4,0,0,4
1002,829,2183,298,531,230,374,53,172,198,258,283,90,661,168,246,170,152,261,61,261,1080,411,370,68,1,0,67
1003,685,1561,225,460,281,217,95,92,143,261,237,44,567,118,183,77,98,327,34,190,697,344,296,1,0,0,1
1004,1384,3339,938,446,333,640,164,247,363,614,374,33,1058,326,194,184,255,751,199,385,980,896,879,0,0,0,0
1005,1310,3151,1185,125,332,547,214,217,395,551,290,74,942,368,168,101,263,778,127,530,664,991,839,0,0,0,0
1006,1205,3606,574,631,439,396,162,208,383,409,334,79,943,262,339,264,141,461,120,893,1403,630,560,1032,1021,0,11
1007,999,4803,151,848,425,276,159,139,455,323,131,90,950,49,517,185,144,153,17,1467,2848,339,132,2348,2340,0,8
1008,1363,8980,25,1338,691,378,165,129,527,683,70,83,1363,0,972,273,89,29,0,4355,4352,188,85,7441,7364,0,77
1009,2170,7044,569,1601,518,819,277,556,618,682,633,237,1973,197,959,617,238,356,203,1013,4737,403,688,165,113,0,52
1010,1168,2892,529,639,353,453,201,161,205,521,346,96,967,201,225,213,265,465,59,297,1269,557,710,20,2,0,18
1011,1518,3540,517,1001,545,528,298,147,347,633,447,91,1185,333,497,360,263,398,143,368,1728,626,675,238,45,0,193
1012,2159,5551,792,1367,773,487,336,563,583,549,703,324,1657,502,651,424,408,676,133,746,3035,996,641,54,0,0,54
1013,1429,3476,777,652,471,473,233,252,434,457,486,52,1040,389,524,275,204,426,150,677,1189,860,600,0,0,0,0
1014,1179,2441,216,963,489,500,103,87,143,529,469,38,1022,157,157,256,394,372,137,174,1201,522,407,1527,0,0,1527
1015,1131,3003,381,750,420,282,156,273,302,450,312,67,847,284,467,235,163,266,78,503,1256,873,293,60,0,0,60
1016,2008,4275,727,1281,786,628,350,244,781,839,339,49,1449,559,942,360,378,328,235,646,1437,1076,881,142,122,0,20
1017,1837,4405,731,1106,637,627,293,280,344,804,480,209,1523,314,581,451,245,560,145,421,2022,1227,590,178,36,0,142
1018,2123,4942,25,2098,912,487,441,283,613,1073,343,94,1909,214,1098,545,333,147,46,752,3232,685,227,539,137,0,402
1019,180,1190,15,165,136,15,18,11,43,110,19,8,167,13,103,51,11,15,0,355,748,75,12,888,852,0,36
1020,1909,4907,394,1515,960,620,205,124,415,988,389,117,1781,128,916,411,296,286,84,822,2639,914,448,1987,1910,0,77
1021,1650,3840,318,1332,480,814,86,270,527,620,389,114,1559,91,601,427,217,405,148,86,2577,571,458,59,0,0,59
1022,1604,3461,600,1004,627,577,220,180,556,660,301,87,1345,259,416,465,335,388,100,497,1476,716,672,35,0,0,35
1023,1456,3352,692,764,605,377,200,274,300,664,442,50,1049,407,327,412,257,460,127,620,1291,894,420,42,0,0,42
1024,1310,3064,634,676,418,426,240,226,237,520,512,41,976,334,305,281,310,414,127,394,1083,897,563,0,0,0,0
1025,1693,4181,1008,685,498,538,290,367,330,600,622,141,1163,530,332,293,342,726,149,727,1441,1155,709,15,0,0,15
1026,812,1978,539,273,248,290,157,117,196,331,229,56,639,173,113,122,226,351,47,277,610,593,451,0,0,0,0
1027,1776,3703,622,1154,663,748,179,186,593,697,398,88,1486,290,562,320,437,457,155,362,1588,683,915,38,0,0,38
1028,1493,3848,1236,257,360,555,189,389,471,533,438,51,1185,308,176,170,285,862,154,670,952,1099,973,96,8,0,88
1029,1522,3961,1252,270,294,653,243,332,405,533,542,42,1145,377,178,190,317,837,162,622,1087,1041,1049,46,27,0,19
1030,828,2091,725,103,123,433,146,126,222,295,267,44,640,188,73,97,133,525,52,273,421,702,643,20,0,0,20
1031,1399,3557,1325,74,222,750,110,317,415,415,519,50,1030,369,62,240,230,867,133,511,673,972,1268,0,0,0,0
1032,620,1638,558,62,114,253,136,117,238,100,233,49,492,128,75,104,116,325,60,220,328,380,650,0,0,0,0
1033,1884,4199,1494,390,722,629,195,338,663,625,504,92,1476,408,496,303,314,771,298,599,721,1338,1243,0,0,0,0
1034,1328,3488,1025,303,277,490,249,312,256,575,454,43,809,519,280,240,196,612,197,766,801,1097,627,13,0,0,13
1035,946,2443,717,229,195,350,183,218,283,230,414,19,557,389,118,172,176,480,90,569,582,760,442,0,0,0,0
1036,1303,3275,524,779,316,458,304,225,279,376,489,159,822,481,210,292,338,463,73,625,1235,868,474,13,0,0,13
1037,971,2573,471,500,243,338,169,221,178,413,314,66,594,377,171,247,205,348,88,664,836,671,314,13,0,0,13
1038,1084,2994,0,1084,157,578,154,195,299,425,351,9,709,375,467,277,202,138,340,428,1983,114,129,1327,1223,0,104
1039,2047,5091,1114,933,583,574,477,413,419,858,712,58,1263,784,296,623,492,636,416,972,1745,1212,746,19,0,0,19
1040,662,1877,117,545,189,169,116,188,69,290,236,67,456,206,215,206,197,44,146,216,899,412,204,10,0,0,10
1041,1076,2455,339,737,386,333,119,238,209,445,302,120,860,216,293,261,260,262,113,293,1052,551,446,2,0,0,2
1042,744,1713,617,127,145,383,110,106,183,296,238,27,579,165,104,124,135,381,68,222,477,532,414,49,39,0,10
1043,1119,2675,924,195,318,435,164,202,354,381,348,36,790,329,117,170,262,570,71,585,599,794,626,13,3,0,10
1044,931,2416,811,120,193,386,108,244,299,167,403,62,675,256,70,180,173,508,135,375,572,718,616,0,0,0,0
1045,1242,3075,977,265,312,474,225,231,444,399,349,50,977,265,200,259,190,593,142,311,934,794,894,0,0,0,0
1046,946,2225,845,101,202,465,135,144,274,361,281,30,727,219,156,133,232,425,121,284,523,687,610,0,0,0,0
1047,1211,3090,587,624,314,411,207,279,302,427,374,108,795,416,333,296,240,342,223,493,1207,660,507,8,0,0,8
1048,1094,2711,516,578,292,338,280,184,203,449,413,29,701,393,216,299,289,290,116,501,1031,716,347,12,0,0,12
1049,2310,5973,1079,1231,587,655,554,514,367,823,960,160,1540,770,760,483,524,543,715,575,2227,1544,912,34,0,0,34
1050,3088,8496,1020,2068,748,1000,556,784,698,1340,722,328,1786,1302,1498,837,481,272,243,1814,3241,2117,1081,259,0,0,259
1051,1524,3692,360,1164,486,517,134,387,500,389,472,163,1203,321,680,369,289,186,116,381,1766,819,610,13,0,0,13
1052,557,1413,421,136,87,219,119,132,192,159,177,29,350,207,120,87,136,214,51,267,305,471,319,0,0,0,0
1053,1617,3711,1365,252,393,669,387,168,346,625,611,35,1182,435,236,303,315,763,245,446,1164,1011,845,1,0,0,1
1054,1133,2951,940,193,157,453,337,186,176,332,552,73,768,365,140,201,343,449,185,384,1038,778,566,46,0,0,46
1055,2113,5776,1228,885,597,473,465,578,275,906,549,383,1481,632,305,921,563,324,326,925,2066,1511,948,52,0,0,52
1056,1780,4687,905,875,602,457,311,410,520,607,570,83,1170,610,715,411,502,152,347,820,1721,1058,741,3,0,0,3
1057,1351,5271,475,876,175,258,170,748,353,331,341,326,555,796,546,383,326,96,262,1667,2048,849,445,10,0,0,10
1058,2230,6700,890,1340,764,442,280,744,723,761,511,235,1342,888,911,574,464,281,336,1625,2472,1443,824,283,0,0,283
1059,3044,6366,1876,1168,1175,944,459,466,661,1594,742,47,2537,507,938,677,746,683,446,542,2762,1433,1183,289,0,0,289
1060,1938,8386,763,1175,274,288,283,1093,248,761,545,384,763,1175,775,684,382,97,484,2555,3004,1780,563,31,0,0,31
1061,2579,7826,1162,1417,759,494,439,887,1001,837,519,222,1424,1155,1524,625,330,100,442,1794,2322,2188,1080,31,0,0,31
1062,1873,3887,1145,728,677,785,220,191,509,678,572,114,1568,305,335,394,481,663,207,298,1267,1096,1019,10,0,0,10
1063,1763,6712,579,1184,312,289,323,839,363,589,508,303,937,826,744,575,304,140,324,1763,2738,1415,472,40,0,0,40
1064,1349,4386,560,789,161,257,360,571,200,404,551,194,687,662,352,474,377,146,192,1014,1825,845,510,0,0,0,0
1065,2445,7610,1575,870,606,614,355,870,199,1006,916,324,1617,828,521,1050,637,237,428,1365,2854,2120,843,53,0,0,53
1066,2626,7347,957,1669,795,854,350,627,644,1231,516,235,1646,980,1024,1090,427,85,236,1785,2283,1817,1226,46,0,0,46
1067,2568,9115,1097,1471,312,538,603,1115,449,1010,861,248,1201,1367,869,971,569,159,552,2379,3445,2043,696,9,0,0,9
1068,1360,5171,805,555,217,175,174,794,190,453,443,274,581,779,402,472,336,150,266,1512,1724,1209,460,385,0,0,385
1069,3983,10835,1614,2369,991,1335,689,968,832,1549,1399,203,2780,1203,1060,1425,832,666,534,1838,4627,2480,1356,0,0,0,0
1070,1257,4586,700,557,152,338,196,571,179,510,353,215,682,575,399,383,313,162,185,1194,1721,1106,380,0,0,0,0
1071,1806,6876,885,921,290,300,248,968,427,539,516,324,854,952,673,609,395,129,457,1924,2428,1442,625,0,0,0,0
1072,1807,6034,971,836,412,446,256,693,327,752,430,298,1092,715,574,493,448,292,141,1417,2202,1738,536,0,0,0,0
1073,2001,5712,954,1047,467,624,457,453,445,884,434,238,1305,696,700,665,494,142,317,900,2139,1431,925,23,0,0,23
1074,2764,7793,1940,824,414,1048,593,709,526,1078,812,348,1997,767,467,1065,778,454,247,867,2630,2203,1846,64,0,0,64
1075,1053,2776,520,533,319,220,205,309,179,452,371,51,710,343,284,440,183,146,195,381,1001,803,396,33,0,0,33
1076,1206,2907,972,234,422,448,169,167,264,433,384,125,987,219,276,283,368,279,123,435,752,876,721,10,0,0,10
1077,1932,5468,1260,672,329,672,370,561,370,713,690,159,1260,672,437,474,599,422,292,888,1831,1476,981,3,0,0,3
1078,1651,5012,791,860,365,320,416,550,317,545,508,281,1050,601,317,449,544,341,188,854,1847,1444,679,15,0,0,15
1079,3277,9397,2800,477,727,1088,546,916,1057,1155,567,498,2407,870,756,650,925,946,386,1424,2638,2634,2315,1,0,0,1
1080,1862,5355,1302,560,370,402,599,491,480,443,733,206,1079,783,422,494,597,349,425,832,1713,1581,804,11,0,0,11
1081,1438,4675,1108,330,264,258,346,570,289,420,359,370,965,473,251,417,454,316,70,720,1802,1206,877,19,0,0,19
1082,1827,5086,1234,593,500,609,226,492,366,784,518,159,1235,592,466,449,591,321,279,776,1858,1259,914,33,0,0,33
1083,6070,16703,4613,1457,1655,1646,1243,1526,1119,2398,1911,642,4157,1913,1442,1415,1439,1774,737,2976,5628,4805,2557,17,0,0,17
1084,2274,6578,1821,453,256,1069,401,548,590,663,785,236,1706,568,252,685,599,738,352,941,1821,1548,1916,26,0,0,26
1085,1427,4211,1174,253,228,443,343,413,447,319,368,293,1022,405,282,305,425,415,158,497,1214,1222,1120,9,0,0,9
1086,2303,7301,1762,541,372,703,499,729,403,781,783,336,1536,767,392,554,608,749,263,1300,2403,1984,1351,18,0,0,18
1087,2184,6083,1979,205,447,747,332,658,556,640,630,358,1582,602,437,364,528,855,188,992,1751,1854,1298,4,1,0,3
1088,1180,4125,795,385,123,393,220,444,244,500,216,220,763,417,214,294,323,349,192,659,1549,981,744,14,0,0,14
1089,2171,5759,1058,1113,494,913,396,368,538,816,713,104,1420,751,935,539,464,233,372,1122,2061,1320,884,163,0,0,163
1090,1623,3458,894,729,655,528,269,171,540,538,432,113,1342,281,428,490,359,346,65,405,989,1205,794,0,0,0,0
1091,1432,3449,770,662,418,549,210,255,359,690,292,91,1081,351,415,369,262,386,170,498,1146,957,678,0,0,0,0
1092,561,1112,130,431,300,187,60,14,248,245,68,0,453,108,288,182,68,23,47,119,465,284,197,103,0,0,103
1093,968,1934,423,545,411,305,161,91,282,413,264,9,711,257,418,204,212,134,176,273,697,380,408,11,0,0,11
1094,3165,8264,1995,1170,831,813,714,807,480,1148,1384,153,1912,1253,530,791,1046,798,616,1503,2689,2506,950,11,0,0,11
1095,1024,3100,788,236,233,288,222,281,177,403,355,89,762,262,157,366,293,208,112,619,1025,1038,306,18,0,0,18
1096,3705,9677,2725,980,912,1062,794,937,764,1302,1371,268,2456,1249,494,1005,921,1285,1007,1380,3567,2433,1290,29,0,0,29
1097,1183,3762,825,358,197,335,259,392,245,333,372,233,794,389,159,511,228,285,265,472,1697,897,431,24,0,0,24
1098,3464,12095,2470,994,406,874,723,1461,458,1159,1113,734,1865,1599,404,674,1240,1146,1024,2084,4587,3096,1304,0,0,0,0
1099,3027,8202,2374,653,725,896,665,741,787,1044,830,366,2139,888,540,794,913,780,412,1304,2400,2527,1559,29,0,0,29
1100,2954,7984,2492,462,671,960,474,849,849,1019,899,187,1979,975,409,592,788,1165,337,1777,2035,2663,1172,16,0,0,16
1101,1347,3841,1273,74,219,460,231,437,393,363,482,109,912,435,172,242,390,543,120,848,945,1147,781,0,0,0,0
1102,260,709,260,0,65,84,10,101,93,85,56,26,158,102,46,56,62,96,0,224,135,163,187,0,0,0,0
1103,2753,8220,2405,348,497,805,749,702,718,734,925,376,1874,879,529,503,724,997,501,1086,2831,2304,1498,9,0,0,9
1104,1187,3303,906,281,191,364,305,327,261,401,422,103,714,473,173,126,334,554,168,735,768,1056,576,0,0,0,0
1105,470,1428,226,244,45,198,77,150,83,220,134,33,320,150,73,87,214,96,117,294,546,227,244,0,0,0,0
1106,3485,7263,2218,1267,1397,1196,426,466,1063,1327,972,123,2757,728,1056,611,1057,761,526,731,2486,2057,1463,147,0,0,147
1107,1368,3891,848,520,301,426,279,362,368,458,392,150,1046,322,371,334,378,285,204,571,1413,1022,681,14,0,0,14
1108,2090,5866,1644,446,443,803,345,499,468,690,745,187,1438,652,224,652,538,676,282,1020,1975,1445,1144,39,0,0,39
1109,2813,8192,2135,678,372,1226,384,831,506,862,1197,248,1795,1018,467,704,816,826,417,1630,2663,2141,1341,21,0,0,21
1110,2803,7739,1623,1180,663,1048,493,599,744,1011,814,234,2167,636,942,525,627,709,493,1153,2818,1947,1328,36,0,0,36
1111,2090,5724,1644,446,415,698,433,544,490,548,757,295,1435,655,377,472,794,447,282,836,2063,1598,945,16,0,0,16
1112,2044,6371,1323,721,422,712,410,500,501,478,817,248,1434,610,512,500,472,560,643,1008,1972,1706,1042,90,0,0,90
1113,1419,2305,42,1377,875,455,30,59,602,478,302,37,1329,90,703,371,305,40,77,64,881,549,734,28,0,0,28
1114,2687,7401,533,2154,747,622,503,815,415,1276,820,176,1543,1144,973,945,617,152,875,1487,3645,1093,301,0,0,0,0
1115,1608,4438,155,1453,508,364,266,470,244,570,542,252,1048,560,510,568,318,212,189,970,2098,911,270,0,0,0,0
1116,1159,3612,921,238,219,345,262,333,209,359,442,149,752,407,210,230,285,434,400,456,1368,941,447,37,0,0,37
1117,1167,3171,878,289,226,483,182,276,298,317,358,194,839,328,198,308,207,454,97,555,849,902,768,17,0,0,17
1118,3201,8643,2006,1195,898,1022,441,840,592,1460,868,281,2268,933,1115,840,660,586,630,932,2980,2490,1611,18,0,0,18
1119,3105,8774,2021,1084,701,881,659,864,661,1319,646,479,2050,1055,641,1114,655,695,611,1547,3199,2035,1382,15,0,0,15
1120,3107,9448,1219,1888,783,758,434,1132,639,1246,786,436,2036,1071,1099,924,745,339,721,1785,3987,2066,889,32,0,0,32
1121,5652,10602,1279,4373,2645,1863,653,491,1002,3003,1394,253,4638,1014,1356,1504,1291,1501,514,942,5024,2561,1561,42,0,0,42
1122,2721,7252,1990,731,615,992,370,744,663,882,899,277,1954,767,706,987,620,408,551,789,2713,2165,1034,159,0,0,159
1123,2354,5616,1013,1341,476,916,648,314,578,794,771,211,1527,827,560,579,758,457,223,1037,2185,1463,708,38,0,0,38
1124,2516,6866,2000,516,532,837,518,629,474,886,916,240,1582,934,298,536,801,881,464,1142,2369,1640,1251,0,0,0,0
1125,1794,4674,1519,275,380,695,250,469,544,494,596,160,1240,554,242,343,404,805,198,834,1096,1587,959,0,0,0,0
1126,2597,6241,2452,145,485,1410,210,492,651,1083,759,104,1965,632,501,536,672,888,261,978,1387,2169,1446,10,0,0,10
1127,2455,6753,1959,496,567,749,486,653,618,866,683,288,1611,844,564,333,480,1078,268,1306,1885,1906,1388,17,0,0,17
1128,1719,4650,1279,440,292,618,421,388,283,609,754,73,1062,657,199,399,577,544,181,1193,1267,1276,733,56,0,0,56
1129,2279,6186,1623,656,731,557,406,585,652,651,744,232,1611,668,380,379,796,724,446,795,2046,1520,1379,97,0,0,97
1130,1415,3639,1239,176,274,544,218,379,465,458,374,118,920,495,286,245,367,517,201,659,817,1043,919,6,0,0,6
1131,2168,6528,1951,217,249,780,351,788,516,643,718,291,1283,885,181,209,298,1480,193,1482,1217,2313,1323,1,0,0,1
1132,1531,4801,1397,134,133,564,286,548,401,410,620,100,852,679,146,143,164,1078,279,1183,854,1511,974,21,0,0,21
1133,3112,7658,2313,799,743,1221,541,607,956,1050,921,185,2207,905,664,475,580,1393,477,1113,2047,2278,1743,52,0,0,52
1134,2210,6093,1327,883,583,760,348,519,383,919,771,137,1517,693,543,443,384,840,495,1043,2335,1479,741,32,0,0,32
1135,2920,6223,1743,1177,914,1121,581,304,665,1049,1012,194,2274,646,565,535,873,947,305,700,2309,1456,1453,10,0,0,10
1136,2768,5808,965,1803,842,1271,341,314,445,1202,994,127,2327,441,389,467,1000,912,319,437,3016,1343,693,12,0,0,12
1137,1558,4019,1340,218,359,613,266,320,374,605,455,124,1106,452,174,210,321,853,171,645,1001,1102,1100,85,0,0,85
1138,2371,5994,1869,502,654,808,412,497,712,861,694,104,1700,671,410,421,473,1067,353,1078,1549,1778,1236,2,0,0,2
1139,1220,3454,1163,57,111,526,245,338,349,393,422,56,727,493,90,146,183,801,245,573,899,1046,691,3,0,0,3
1140,1086,2910,1041,45,156,406,223,301,268,376,353,89,763,323,58,146,218,664,122,482,581,981,744,74,0,0,74
1141,2027,5513,1674,353,372,813,334,508,506,650,794,77,1484,543,231,316,403,1077,268,989,1388,1599,1269,7,0,0,7
1142,1392,3847,1148,244,193,578,258,363,362,458,458,114,961,431,127,293,349,623,151,634,1109,1082,871,0,0,0,0
1143,1737,4658,1124,613,420,643,246,428,384,619,655,79,1166,571,404,179,412,742,173,795,1460,1219,1011,0,0,0,0
1144,2282,5940,1465,817,422,992,361,507,531,804,698,249,1646,636,277,410,588,1007,84,1071,1667,1888,1230,10,0,0,10
1145,4256,7472,942,3314,2126,1411,406,313,843,2141,1085,187,3650,606,864,945,1155,1292,353,708,3906,1543,962,60,0,0,60
1146,1939,3659,304,1635,938,627,171,203,174,1257,476,32,1672,267,407,757,553,222,210,298,2265,657,229,11,0,0,11
1147,2381,6288,1670,711,702,802,274,603,937,620,661,163,1606,775,420,364,481,1116,307,1070,1293,1574,2044,0,0,0,0
1148,5813,8147,5376,437,3679,2104,30,0,4995,683,135,0,5804,9,2169,1832,1131,681,0,10,42,689,7406,6,0,0,6
1149,2059,4805,1274,785,738,613,287,421,461,945,540,113,1459,600,316,467,441,835,325,715,1386,1544,835,135,0,0,135
1150,2205,5846,1185,1020,704,538,433,530,700,880,513,112,1495,710,598,340,457,810,157,1160,1667,1723,1139,1,0,0,1
1151,1971,5525,1814,157,183,735,457,596,420,525,1020,6,1148,823,175,208,356,1232,273,1312,1023,1605,1312,0,0,0,0
1152,2331,6113,1396,935,401,913,492,525,370,916,969,76,1603,728,186,438,392,1315,316,1036,2040,1691,1030,0,0,0,0
1153,1522,4148,1473,49,189,667,318,348,337,543,617,25,897,625,72,195,251,1004,163,927,725,1352,981,0,0,0,0
1154,2841,6943,2505,336,693,1185,349,614,1019,900,837,85,2098,743,427,125,386,1903,76,1413,1015,2436,2003,4,0,0,4
1155,872,2441,761,111,163,268,145,296,171,374,317,10,447,425,101,112,138,521,111,714,406,757,453,0,0,0,0
1156,1531,4491,1474,57,209,474,308,540,370,354,639,168,827,704,138,177,293,923,537,828,1111,1180,835,0,0,0,0
1157,1079,2674,974,105,330,401,103,245,375,296,292,116,755,324,198,146,231,504,150,516,646,623,739,0,0,0,0
1158,2315,6070,1799,516,551,781,339,644,495,958,709,153,1560,755,491,365,384,1075,304,1052,1892,1673,1149,0,0,0,0
1159,907,3628,818,89,120,345,155,287,293,288,278,48,597,310,87,110,154,556,73,990,999,922,644,911,895,0,16
1160,1659,5187,1488,171,201,665,341,452,438,489,674,58,941,718,134,195,266,1064,206,1394,1161,1501,925,535,524,0,11
1161,4310,11420,3483,827,1136,1383,504,1287,972,1640,1318,380,2851,1459,756,604,673,2277,345,3109,2259,3854,1853,10,0,0,10
1162,455,1190,278,177,78,133,172,72,180,118,126,31,308,147,76,139,79,161,0,165,315,442,268,0,0,0,0
1163,1288,3364,1200,88,203,563,217,305,443,374,381,90,880,408,102,215,245,726,215,478,773,923,975,0,0,0,0
1164,1808,5396,1724,84,180,905,145,578,400,588,652,168,1313,495,130,63,165,1450,94,987,863,2290,1162,50,0,0,50
1165,2704,7541,2391,313,369,1173,363,799,1017,677,841,169,1819,885,393,301,370,1640,415,1536,1472,2105,2013,42,0,0,42
1166,4158,11908,3790,368,424,1714,798,1222,1043,1381,1487,247,2529,1629,262,392,882,2622,426,2904,2028,4330,2220,22,0,0,22
1167,4197,11296,3764,433,682,1666,758,1091,1121,1612,1247,217,2567,1630,635,547,749,2266,492,2489,2214,3338,2763,16,0,0,16
1168,3538,8145,2477,1061,1186,1062,580,710,714,1602,1070,152,2399,1139,528,618,745,1647,150,1952,2095,2699,1249,0,0,0,0
1169,2097,6233,1706,391,385,655,357,700,412,796,750,139,1210,887,163,238,642,1054,304,1547,1661,1803,918,28,0,0,28
1170,3146,8080,2027,1119,688,1142,483,833,427,1477,1010,232,1868,1278,244,589,996,1317,492,1635,2395,2526,1032,0,0,0,0
1171,3096,9719,2590,506,301,930,625,1240,651,792,1438,215,1646,1450,371,360,528,1837,544,2236,2389,2835,1715,16,0,0,16
1172,2119,6622,1711,408,330,536,421,832,384,599,917,219,1129,990,262,339,439,1079,484,1350,2112,1722,954,13,0,0,13
1173,1411,4773,1242,169,97,360,277,677,170,501,582,158,714,697,165,157,342,747,235,1108,1358,1432,640,13,0,0,13
1174,1946,5103,1529,417,485,565,384,512,632,433,649,232,1305,641,324,236,308,1078,101,974,1291,1686,1051,11,0,0,11
1175,5215,15031,3099,2116,836,1531,1001,1847,770,2347,1790,308,2618,2597,720,907,1114,2474,1025,3801,4915,3955,1335,0,0,0,0
1176,16080,49919,12612,3468,1756,4568,3730,6026,2309,6134,6420,1217,7845,8235,1720,1833,2903,9624,2271,12448,12828,16275,6097,140,0,0,140
1177,6490,18062,5671,819,1051,2821,1039,1579,1753,2386,1767,584,4385,2105,978,1294,1679,2539,888,3467,4123,5554,4030,0,0,0,0
1178,15207,47591,12271,2936,2652,4544,2761,5250,3622,5185,4303,2097,8852,6355,2302,3826,3960,5119,1604,11766,13519,13101,7601,147,0,0,147
1179,8283,27893,6449,1834,931,2122,1559,3671,1385,3369,2411,1118,3907,4376,1603,1962,2296,2422,1223,7529,8901,7104,3136,67,0,0,67
1180,5011,17426,4123,888,734,917,953,2407,886,1847,1811,467,2751,2260,1115,1034,1596,1266,1463,3598,6153,4711,1501,15,0,0,15
1181,1916,5331,1389,527,491,541,257,627,504,793,497,122,1354,562,415,568,478,455,328,1124,1877,1248,754,23,0,0,23
1182,3569,11673,2266,1303,735,738,651,1445,716,1051,1018,784,2086,1483,1025,816,924,804,741,2222,4510,2926,1274,51,0,0,51
1183,1473,4439,915,558,197,461,221,594,370,763,212,128,965,508,393,475,383,222,299,911,1336,1185,708,16,0,0,16
1184,1501,4486,1306,195,302,389,375,435,258,511,591,141,943,558,284,358,428,431,169,796,1692,1441,388,18,0,0,18
1185,5560,17518,4709,851,684,1543,1429,1904,835,1656,2357,712,3169,2391,810,1150,1956,1644,1321,3357,5645,5128,2067,45,0,0,45
1186,5505,18790,3996,1509,892,1454,1099,2060,979,2217,1429,880,3520,1985,1312,1466,1413,1314,1117,3861,5592,5635,2585,21,0,0,21
1187,2889,7580,2029,860,750,795,548,796,943,1212,405,329,1765,1124,580,1162,733,414,306,1698,2331,2020,1225,0,0,0,0
1188,3125,9029,1904,1221,980,570,640,935,1059,1031,609,426,1980,1145,1263,937,562,363,761,1453,3225,2175,1415,30,0,0,30
1189,2338,7363,491,1847,392,752,427,767,518,1121,523,176,1401,937,1144,676,270,248,560,1676,2442,1585,1100,58,0,0,58
1190,1521,4481,238,1283,369,379,255,518,382,662,349,128,763,758,819,459,187,56,365,1208,1929,718,261,8,0,0,8
1191,1915,5756,787,1128,361,545,183,826,480,588,582,265,1196,719,770,632,342,171,397,1026,2311,1268,754,0,0,0,0
1192,1515,4567,1170,345,208,578,277,452,343,440,575,157,1036,479,232,605,439,239,141,860,1664,1271,631,15,0,0,15
1193,2800,7818,1113,1687,753,699,846,502,498,1061,1009,232,1817,983,867,1166,411,356,761,1293,2961,1851,952,29,0,0,29
1194,1535,4639,1041,494,418,463,181,473,518,444,327,246,1077,458,627,327,380,201,468,761,1496,1008,906,0,0,0,0
1195,5402,17775,4100,1302,788,1623,1118,1873,827,1924,1635,1016,3599,1803,1195,1154,1287,1766,708,3556,5593,5542,2376,122,0,0,122
1196,2982,9812,2221,761,208,927,618,1229,471,974,960,577,1831,1151,361,699,1109,813,583,1452,4052,2436,1289,22,0,0,22
1197,1154,4224,634,520,206,184,312,452,137,526,311,180,578,576,522,262,185,185,177,1132,1394,955,566,10,0,0,10
1198,1568,4796,767,801,407,405,309,447,330,702,363,173,990,578,397,547,399,225,330,807,1906,1071,682,211,0,0,211
1199,3043,8916,1247,1796,663,1070,680,630,637,959,1336,111,2030,1013,978,1125,741,199,548,1507,3739,1834,1288,21,0,0,21
1200,2939,9246,1706,1233,426,1080,367,1066,467,1219,874,379,1788,1151,508,965,965,501,682,1518,3178,2558,1310,42,0,0,42
1201,1126,4227,896,230,64,339,160,563,232,275,389,230,543,583,203,377,391,155,245,782,1727,916,557,7,0,0,7
1202,1023,4041,425,598,123,184,249,467,178,405,269,171,597,426,420,315,261,27,262,1066,1479,756,478,9,0,0,9
1203,1478,5392,812,666,241,230,220,787,317,477,454,230,839,639,573,385,233,287,322,1271,1979,1233,587,22,0,0,22
1204,781,2818,278,503,226,169,110,276,298,209,174,100,509,272,413,156,160,52,176,580,1127,614,321,0,0,0,0
1205,1375,3600,789,586,501,335,138,401,458,457,375,85,1007,368,467,492,260,156,249,516,1346,763,726,1,0,0,1
1206,1988,6257,1149,839,545,423,327,693,558,634,471,325,1271,717,831,464,383,310,419,1472,2116,1456,794,8,0,0,8
1207,1787,6438,1372,415,251,452,384,700,188,709,457,433,1086,701,287,771,506,223,386,1173,2367,1806,706,0,0,0,0
1208,2262,8134,1250,1012,309,608,466,879,426,911,526,399,1346,916,806,691,428,337,721,1651,3064,1721,977,18,0,0,18
1209,1649,6028,706,943,226,320,290,813,224,632,535,258,867,782,499,707,319,124,425,1410,2589,1186,418,22,0,0,22
1210,1747,7185,1135,612,171,240,375,961,255,619,674,199,809,938,670,539,341,197,373,1611,2847,1699,655,3,0,0,3
1211,1642,4224,1127,515,487,571,320,264,449,615,531,47,1201,441,427,428,373,414,529,522,1448,1018,707,6,0,0,6
1212,2192,4203,1421,771,1110,631,195,256,693,972,442,85,1862,330,769,468,603,352,93,463,1099,1157,1391,0,0,0,0
1213,1044,2585,758,286,299,412,136,197,225,432,355,32,801,243,181,141,297,425,77,460,748,766,534,17,0,0,17
1214,1421,3502,898,523,395,562,178,286,405,498,392,126,1007,414,391,242,313,475,107,708,990,872,825,15,0,0,15
1215,1952,5101,1151,801,555,533,374,490,501,828,495,128,1262,690,404,513,413,622,193,1222,1322,1374,990,1,0,0,1
1216,1192,2997,1018,174,339,377,259,217,242,516,334,100,913,279,170,278,399,345,121,474,773,965,664,0,0,0,0
1217,1706,5448,1489,217,197,507,368,634,305,523,729,149,931,775,206,300,442,758,378,1124,1294,1761,891,0,0,0,0
1218,2114,6806,1140,974,410,675,421,608,484,621,790,219,1318,796,508,619,540,447,534,956,2656,1418,1242,11,0,0,11
1219,1357,3250,1094,263,456,472,214,215,355,623,312,67,1020,337,321,381,290,365,79,547,880,1247,497,35,0,0,35
1220,2957,8026,2414,543,653,1116,426,762,752,992,949,264,2309,648,637,688,846,786,308,1119,2241,2758,1600,0,0,0,0
1221,1473,5270,1021,452,310,274,262,627,284,552,395,242,861,612,447,464,335,227,433,1147,1795,1250,645,0,0,0,0
1222,1336,3232,602,734,559,428,233,116,300,638,307,91,1080,256,306,443,413,174,59,401,1500,869,403,629,626,0,3
1223,1260,3589,799,461,299,305,212,444,170,777,282,31,807,453,620,374,225,41,116,855,1399,844,375,20,0,0,20
1224,1495,2901,82,1413,973,172,151,199,707,618,147,23,1223,272,1077,289,90,39,351,326,1082,568,574,107,0,0,107
1225,1108,2177,380,728,437,341,253,77,209,710,171,18,751,357,567,284,137,120,114,339,799,676,249,0,0,0,0
1226,1082,3015,590,492,444,249,65,324,375,274,276,157,849,233,392,439,189,62,122,554,1108,631,600,8,0,0,8
1227,1284,3511,815,469,338,377,235,334,234,629,327,94,854,430,380,508,354,42,78,848,1404,749,432,5,0,0,5
1228,905,2473,634,271,221,259,274,151,160,297,369,79,554,351,222,252,233,198,56,486,807,939,185,35,0,0,35
1229,1525,4560,801,724,353,399,351,422,306,527,531,161,952,573,476,531,329,189,225,1018,1722,981,614,9,0,0,9
1230,2192,6457,1422,770,560,635,398,599,706,679,494,313,1697,495,648,547,594,403,155,1109,2039,1645,1509,37,0,0,37
1231,1226,3526,675,551,391,241,264,330,272,511,311,132,863,363,309,612,213,92,98,604,1190,915,719,26,0,0,26
1232,1226,3266,453,773,374,351,197,304,278,509,260,179,888,338,485,425,188,128,62,516,1583,607,498,90,0,0,90
1233,1215,3185,884,331,365,388,179,283,277,464,437,37,857,358,238,460,314,203,185,529,940,944,587,0,0,0,0
1234,1372,3621,439,933,454,356,200,362,385,661,211,115,932,440,695,380,172,125,256,791,897,1062,615,28,0,0,28
1235,1164,2628,281,883,462,416,65,221,335,664,153,12,814,350,616,352,130,66,124,494,1076,674,260,10,0,0,10
1236,1483,3425,527,956,509,485,264,225,324,720,390,49,1127,356,591,527,310,55,379,278,1323,939,506,28,0,0,28
1237,962,2803,578,384,223,305,179,255,161,296,388,117,616,346,294,328,255,85,110,714,808,913,258,0,0,0,0
1238,388,1000,331,57,56,104,150,78,85,191,86,26,316,72,24,114,148,102,34,65,602,166,133,177,176,0,1
1239,882,3241,693,189,37,251,320,274,94,211,479,98,654,228,50,308,298,226,99,510,1062,697,873,25,0,0,25
1240,1531,4606,1128,403,301,431,297,502,287,728,281,235,1004,527,286,671,395,179,287,589,1507,1363,860,119,0,0,119
1241,1350,3163,402,948,536,423,232,159,435,588,303,24,997,353,888,259,110,93,92,567,940,1000,564,181,0,0,181
1242,2361,5952,1567,794,389,1173,328,471,589,867,698,207,1783,578,612,771,494,484,108,738,2091,2036,979,13,0,0,13
1243,1813,5732,824,989,545,521,280,467,690,519,464,140,1255,558,675,580,359,199,300,1127,1823,1221,1261,70,0,0,70
1244,1590,5492,1140,450,343,393,263,591,375,451,555,209,972,618,386,613,395,196,392,1127,1537,1569,867,68,0,0,68
1245,1726,5672,1212,514,378,424,324,600,420,632,514,160,948,778,521,528,388,289,332,1275,1715,1447,903,14,0,0,14
1246,3610,11263,2519,1091,407,1185,924,1094,795,1362,1139,314,2394,1216,605,794,1187,1024,443,1972,3510,2954,2384,51,0,0,51
1247,4071,14456,3560,511,387,1164,890,1630,550,1173,1838,510,2490,1581,525,910,1140,1496,1146,2745,4869,3468,2228,50,0,0,50
1248,3160,9645,2637,523,460,1106,365,1229,643,844,1462,211,1727,1433,345,642,971,1202,526,2202,2690,2536,1691,0,0,0,0
1249,2077,6178,1319,758,225,812,447,593,377,560,888,252,1370,707,326,537,744,470,382,1070,2221,1603,902,15,0,0,15
1250,1747,5610,948,799,440,313,346,648,357,839,469,82,933,814,593,696,318,140,502,1422,2139,1126,421,47,0,0,47
1251,2679,6893,1576,1103,940,623,320,796,726,1270,540,143,1860,819,1098,759,418,404,287,1580,1895,1926,1205,21,0,0,21
1252,862,3337,12,850,25,238,196,403,0,486,372,4,264,598,157,478,178,49,543,756,1900,130,8,917,0,917,0
1253,1246,4247,857,389,166,226,309,545,118,380,484,264,674,572,208,328,443,267,161,1145,1415,1082,444,0,0,0,0
1254,1870,6372,1466,404,294,578,274,724,237,653,715,265,1234,636,243,705,596,326,271,1133,2503,1507,958,9,0,0,9
1255,1786,5345,709,1077,469,471,177,669,383,639,563,201,1160,626,557,502,478,249,482,1048,1875,1362,578,0,0,0,0
1256,1619,4297,1021,598,522,449,292,356,474,548,383,214,1260,359,641,442,397,139,125,699,1601,1110,762,0,0,0,0
1257,2097,6752,1251,846,499,434,499,665,528,714,548,307,1308,789,561,901,527,108,472,1301,2498,1553,928,0,0,0,0
1258,1495,4559,794,701,303,329,306,557,227,690,481,97,870,625,459,676,253,107,456,781,1654,1273,395,0,0,0,0
1259,1905,6206,827,1078,452,450,248,755,550,627,486,242,1133,772,849,614,316,126,542,1307,2135,1338,884,18,0,0,18
1260,1174,3663,444,730,184,324,254,412,217,688,235,34,573,601,531,479,126,38,382,821,1471,753,236,3,0,0,3
1261,1398,4222,1073,325,241,387,444,326,407,348,492,151,930,468,386,463,339,210,302,838,1533,915,634,21,0,0,21
1262,546,1599,102,444,160,172,147,67,95,257,157,37,368,178,184,258,76,28,100,234,740,374,151,38,0,0,38
1263,972,3144,275,697,277,212,169,314,260,332,316,64,587,385,443,356,144,29,219,757,873,978,317,22,0,0,22
1264,2001,5914,803,1198,426,493,326,756,307,972,538,184,1073,928,805,640,388,168,600,1296,2549,1092,377,0,0,0,0
1265,1136,4004,488,648,129,406,187,414,106,500,326,204,640,496,279,346,362,149,247,872,1559,875,451,35,21,0,14
1266,1373,4820,717,656,162,268,421,522,362,480,307,224,741,632,442,530,323,78,292,1059,1663,1250,556,4,0,0,4
1267,1081,3058,845,236,283,446,114,238,324,345,245,167,818,263,210,302,354,215,179,541,838,829,671,0,0,0,0
1268,4061,11173,2710,1351,904,1650,558,949,1149,1192,1376,344,2944,1117,681,972,1052,1356,715,1899,3610,2755,2194,19,0,0,19
1269,3535,9339,1999,1536,1152,1124,542,717,1304,1181,659,391,2755,780,994,1087,795,659,326,1312,3016,2374,2311,48,0,0,48
1270,5948,21215,4273,1675,760,1648,1212,2328,1223,1789,1849,1087,3470,2478,882,1364,1968,1734,1396,4193,7692,5171,2763,11,0,0,11
1271,5253,16460,4127,1126,643,1747,977,1886,762,2015,1992,484,3042,2211,681,1315,1678,1579,1410,3617,5880,3855,1698,16,0,0,16
1272,0,5774,0,0,0,0,0,0,0,0,0,0,0,0,0,0,0,0,0,17,2717,2351,689,0,0,0,0
1273,1501,3875,958,543,497,499,123,382,378,706,292,125,1121,380,540,497,244,220,300,529,1383,955,708,18,0,0,18
1274,2031,5862,870,1161,504,614,291,622,578,554,675,224,1457,574,627,777,432,195,375,1122,2328,1164,873,0,0,0,0
1275,1467,3797,645,822,516,327,328,296,329,633,398,107,1079,388,364,576,345,182,211,739,1596,958,293,0,0,0,0
1276,1236,3708,661,575,243,367,286,340,168,507,426,135,784,452,192,485,422,137,130,843,1400,883,452,0,0,0,0
1277,1766,5107,1369,397,342,520,397,507,411,533,697,125,1090,676,245,530,632,359,343,954,1725,1401,684,10,0,0,10
1278,1568,5095,1415,153,175,487,401,505,387,267,577,337,952,616,175,414,491,488,316,1102,1989,1242,446,0,0,0,0
1279,3362,9344,2201,1161,804,1077,509,972,705,1188,1213,256,2193,1169,555,964,987,856,769,1700,3364,2253,1258,25,0,0,25
1280,4537,10825,3353,1184,1537,1599,601,800,1624,1643,713,557,3733,804,1135,1210,1182,1010,333,1389,3007,2624,3472,0,0,0,0
1281,2656,7130,901,1755,602,897,578,579,396,974,1108,178,1771,885,518,1115,709,314,482,1339,3464,1244,601,0,0,0,0
1282,4794,14368,3367,1427,721,1631,864,1578,859,1727,1811,397,2982,1812,1090,1098,1236,1370,744,3273,4677,3992,1682,75,0,0,75
1283,1421,3922,822,599,330,514,243,334,319,654,372,76,901,520,481,447,348,145,294,912,1320,847,549,0,0,0,0
1284,1901,5156,1295,606,465,727,189,520,653,490,501,257,1455,446,446,502,502,451,180,938,1712,1260,1066,23,0,0,23
1285,1884,5230,1576,308,251,734,514,385,516,799,409,160,1265,619,275,434,506,669,276,1129,1224,1315,1286,0,0,0,0
1286,1752,4692,1413,339,301,821,362,268,612,469,565,106,1414,338,259,536,396,561,155,671,967,1479,1420,6,0,0,6
1287,438,1160,243,195,83,200,39,116,161,131,101,45,331,107,100,162,57,119,95,176,298,371,220,1,0,0,1
1288,3867,11835,2346,1521,550,1203,713,1401,664,1401,1065,737,2114,1753,848,1360,1176,483,835,2710,4284,2632,1374,4,0,0,4
1289,3052,8566,1842,1210,813,652,426,1161,482,1214,1042,314,1803,1249,872,961,615,604,533,1903,2896,2035,1199,0,0,0,0
1290,5440,10869,4206,1234,2032,2697,365,346,3074,1668,506,192,4999,441,1802,1894,1167,577,247,597,2016,2749,5260,6,0,0,6
1291,3279,11862,2646,633,377,855,499,1548,549,911,1169,650,1773,1506,582,848,848,1001,697,2744,3816,3086,1519,14,0,0,14
1292,2685,10391,2068,617,293,598,527,1267,477,652,1044,512,1544,1141,552,632,783,718,473,2253,3434,2821,1410,68,0,0,68
1293,2239,6466,1107,1132,555,737,453,494,554,839,556,290,1402,837,590,568,555,526,351,1361,2097,1550,1107,25,0,0,25
1294,28,438,0,28,21,7,0,0,5,23,0,0,21,7,28,0,0,0,7,7,211,130,83,22,0,0,22
1295,3005,8836,1694,1311,785,923,456,841,656,1150,905,294,2012,993,812,874,765,554,512,1940,3240,2128,1016,104,0,0,104
1296,1488,3440,1106,382,368,779,182,159,529,597,336,26,1225,263,312,317,306,553,32,519,946,696,1247,16,0,0,16
1297,3372,8843,1421,1951,837,1209,578,748,547,1187,1288,350,2240,1132,965,1036,858,513,421,1555,3282,2397,1188,28,0,0,28
1298,710,1755,292,418,209,277,100,124,80,255,325,50,567,143,115,216,208,171,67,245,751,461,231,990,0,0,990
1299,986,2089,268,718,399,437,74,76,310,453,182,41,782,204,396,309,183,98,162,187,995,394,351,57,0,0,57
1300,750,2062,392,358,233,200,153,164,177,310,208,55,488,262,273,233,136,108,157,366,788,459,292,52,0,0,52
1301,1379,3906,731,648,293,512,253,321,247,581,497,54,936,443,355,530,235,259,217,681,1180,1212,616,20,0,0,20
1302,2463,7581,1385,1078,497,804,256,906,521,783,888,271,1468,995,479,801,605,578,512,1801,2373,2028,867,23,0,0,23
1303,1163,3036,1022,141,216,409,333,205,419,347,272,125,811,352,159,202,422,380,71,533,620,915,897,0,0,0,0
1304,2865,7810,1559,1306,1028,763,241,833,882,898,682,403,2070,795,1039,777,640,409,297,1511,2640,2018,1344,0,0,0,0
1305,1687,5648,776,911,367,480,207,633,242,525,745,175,946,741,387,612,474,214,410,1487,2165,1118,468,9,0,0,9
1306,4903,12864,3590,1313,1240,1954,578,1131,1702,1325,1382,494,3633,1270,1313,1212,1049,1329,537,2185,3604,3404,3134,25,0,0,25
1307,2823,7171,2142,681,654,1043,426,700,904,760,928,231,2082,741,636,533,833,821,350,1084,2033,1903,1801,44,34,0,10
1308,1535,3980,1385,150,303,738,208,286,559,481,338,157,1241,294,244,381,440,470,95,498,915,1237,1235,34,0,0,34
1309,153,296,144,9,55,78,8,12,88,29,33,3,127,26,67,31,29,26,0,38,12,92,154,0,0,0,0
1310,1533,3437,1017,516,806,526,132,69,700,582,221,30,1369,164,585,416,256,276,34,184,600,944,1675,463,0,0,463
1311,2470,5863,2184,286,660,1155,275,380,971,625,725,149,2115,355,406,420,638,1006,144,561,1100,2016,2042,105,0,0,105
1312,567,1554,421,146,157,203,81,126,137,257,150,23,441,126,189,159,151,68,55,255,418,456,370,39,4,0,35
1313,1449,4551,986,463,381,581,280,207,281,636,488,44,1067,382,345,286,473,345,131,1010,1519,1086,805,673,560,0,113
1314,2466,5426,1674,792,708,1066,405,287,700,1187,500,79,1847,619,591,464,475,936,261,678,1565,1155,1767,45,21,0,24
1315,823,1935,548,275,241,295,165,122,265,263,229,66,638,185,208,155,179,281,32,227,509,602,565,20,0,0,20
1316,263,868,176,87,47,122,35,59,50,91,87,35,221,42,43,55,73,92,30,78,297,272,191,42,0,0,42
1317,2229,5557,1416,813,781,663,295,490,520,1030,466,213,1754,475,665,586,515,463,304,557,1540,1694,1462,37,0,0,37
1318,1923,4478,1450,473,517,1043,80,283,546,911,386,80,1687,236,302,292,451,878,37,452,809,2207,973,53,0,0,53
1319,3390,10153,1835,1555,823,952,393,1222,760,1145,781,704,2213,1177,834,867,900,789,879,2020,3319,2326,1609,43,0,0,43
1320,2579,5692,1568,1011,862,981,444,292,770,1000,686,123,2209,370,642,773,479,685,202,530,1144,1905,1911,46,0,0,46
1321,2519,6152,1624,895,657,1000,245,617,893,973,462,191,2117,402,734,744,575,466,335,535,1879,1806,1597,16,0,0,16
1322,36,81,35,1,8,14,14,0,19,12,4,1,35,1,6,4,4,22,0,0,17,24,40,0,0,0,0
1323,4237,8661,2837,1400,1768,1441,610,418,1892,1330,910,105,3474,763,1192,1122,875,1048,263,1098,1573,2590,3137,3,0,0,3
1324,1983,4311,1578,405,669,914,167,233,589,965,299,130,1827,156,646,437,354,546,100,337,801,960,2113,4,0,0,4
1325,3634,10065,2232,1402,681,1204,851,898,898,1094,1220,422,2504,1130,516,985,933,1200,529,1823,3092,2753,1868,12,0,0,12
1326,1902,4587,1573,329,507,703,315,377,443,702,645,112,1398,504,399,448,294,761,174,893,1016,1504,1000,23,0,0,23
1327,1953,4550,1171,782,752,618,217,366,504,780,530,139,1451,502,543,491,422,497,84,819,1151,1554,942,0,0,0,0
1328,1757,5073,1115,642,403,509,337,508,390,590,592,185,1112,645,359,439,339,620,252,994,1634,1297,896,278,0,278,0
1329,1389,3353,774,615,319,502,338,230,294,667,335,93,976,413,451,254,271,413,125,618,856,979,775,0,0,0,0
1330,1520,3668,960,560,428,514,226,352,426,600,279,215,1126,394,316,347,393,464,110,619,1076,1105,758,20,0,0,20
1331,2042,5130,1177,865,491,767,315,469,364,790,765,123,1339,703,518,560,636,328,378,911,1829,1064,948,9,0,0,9
1332,2235,4903,803,1432,803,788,349,295,650,576,891,118,1667,568,522,635,521,557,75,762,1892,1395,779,151,0,0,151
1333,1394,3857,908,486,261,413,403,317,266,625,359,144,1011,383,221,616,371,186,156,574,1416,1120,591,32,0,0,32
1334,1640,4841,1342,298,238,516,367,519,386,510,439,305,1079,561,255,455,473,457,295,810,1298,1615,823,0,0,0,0
1335,3064,7048,1563,1501,1128,923,459,554,1166,889,719,290,2319,745,1056,757,700,551,370,841,2267,1813,1757,20,0,0,20
1336,5119,13421,3664,1455,1260,1744,932,1183,1565,1575,1537,442,3682,1437,1067,1319,1175,1558,597,2277,3793,4091,2663,4,0,0,4
1337,3222,7851,1692,1530,1133,993,490,606,1015,1259,523,425,2562,660,1078,991,488,665,586,911,2812,1757,1785,23,0,0,23
1338,1331,3180,703,628,505,409,147,270,266,569,371,125,980,351,475,380,252,224,162,489,1139,891,499,7,0,0,7
1339,2099,4753,1252,847,747,647,202,503,400,1061,530,108,1602,497,528,601,683,287,390,573,1691,1331,768,3,0,0,3
1340,2618,7364,1393,1225,300,1275,461,582,306,683,1395,234,1817,801,517,739,668,694,405,1341,3440,1491,687,11,0,0,11
1341,2263,5975,1444,819,446,955,400,462,584,824,735,120,1663,600,501,524,604,634,371,993,1691,1519,1401,98,97,0,1
1342,1553,5692,864,689,407,393,375,378,259,471,638,185,1225,328,441,526,377,209,182,1530,2517,1065,398,2791,2776,0,15
1343,1427,4176,882,545,275,486,262,404,297,713,315,102,895,532,491,543,260,133,374,738,1827,634,603,39,0,0,39
1344,2500,6385,432,2068,896,684,165,755,696,795,736,273,1816,684,881,929,533,157,336,1392,2880,1171,606,9,0,0,9
1345,1754,3804,1047,707,687,397,444,226,431,594,545,184,1237,517,446,628,481,199,204,496,1311,1209,584,0,0,0,0
1346,1935,5055,973,962,310,928,177,520,494,351,895,195,1440,495,456,479,527,473,229,927,1933,905,1061,5,0,0,5
1347,1832,5254,1465,367,354,668,259,551,351,744,467,270,1279,553,311,469,581,471,334,796,1690,1600,834,30,0,0,30
1348,3786,10234,1314,2472,870,1295,678,943,878,1294,1356,258,2554,1232,1716,1318,538,214,514,2250,4298,2019,1153,39,0,0,39
1349,2707,7794,1513,1194,706,776,377,848,459,1026,884,338,1504,1203,656,1155,606,290,636,1814,2871,1688,785,102,0,0,102
1350,3035,7897,1728,1307,675,1022,474,864,703,1125,1048,159,2175,860,761,753,860,661,233,1588,2515,1976,1585,42,0,0,42
1351,1397,4178,1128,269,171,580,146,500,278,528,439,152,967,430,131,325,391,550,143,746,1198,1209,882,120,0,0,120
1352,1069,2733,1014,55,161,547,129,232,346,284,346,93,831,238,196,157,254,462,42,370,501,887,933,20,0,0,20
1353,3401,5903,2435,966,1652,1420,141,188,2412,717,187,85,3280,121,926,974,749,752,135,171,657,837,4103,0,0,0,0
1354,3043,7746,2408,635,648,1201,487,707,798,1305,741,199,2216,827,454,671,726,1192,324,1491,1726,2417,1788,36,0,0,36
1355,1592,3945,1178,414,491,504,246,351,524,609,313,146,1155,437,566,407,404,215,104,817,1227,852,945,20,0,0,20
1356,2820,6366,1807,1013,888,1028,485,419,1003,834,854,129,2111,709,860,728,556,676,204,1044,1578,1797,1743,58,0,0,58
1357,1541,4015,734,807,391,469,260,421,309,568,493,171,1030,511,438,318,416,369,225,772,1592,919,507,31,0,0,31
1358,3496,8280,1502,1994,1117,1291,569,519,1268,969,1006,253,2733,763,1071,1016,996,413,514,1011,2846,1723,2186,53,0,0,53
1359,2015,4821,1343,672,554,931,177,353,310,866,759,80,1398,617,197,667,598,553,239,855,1514,1339,874,24,0,0,24
1360,1294,2881,474,820,496,460,168,170,404,446,388,56,958,336,537,370,250,137,208,376,991,760,546,35,0,0,35
1361,1079,2345,113,966,529,281,114,155,184,599,195,101,849,230,425,445,136,73,133,232,1397,442,141,27,0,0,27
1362,1792,3362,632,1160,941,489,159,203,578,824,320,70,1527,265,732,408,408,244,133,379,1143,915,792,8,0,0,8
1363,944,3057,387,557,267,319,220,138,182,330,307,125,738,206,242,332,238,132,77,563,1561,693,163,5,0,0,5
1364,1845,4315,730,1115,548,644,366,287,288,739,692,126,1362,483,608,554,491,192,292,754,1787,891,591,20,0,0,20
1365,1828,4125,1479,349,646,692,171,319,687,697,338,106,1475,353,296,477,470,585,150,506,917,1308,1244,40,0,0,40
1366,3546,7211,2272,1274,1212,1485,545,304,1541,867,956,182,2798,748,667,713,827,1339,173,924,1419,2400,2295,259,0,0,259
1367,1675,4387,1285,390,460,707,171,337,705,423,489,58,1301,374,531,532,285,327,285,863,940,892,1407,56,0,0,56
1368,1537,4401,947,590,489,357,251,440,283,699,452,103,1031,506,374,409,416,338,198,871,1654,1189,489,40,0,0,40
1369,1499,3965,1010,489,449,402,240,408,372,479,492,156,1126,373,489,412,409,189,127,682,1113,1147,896,50,0,0,50
1370,3687,10373,2580,1107,893,1018,824,952,796,1294,1143,454,2633,1054,935,636,1042,1074,706,1578,3395,2968,1726,37,0,0,37
1371,1949,5535,1363,586,463,496,369,621,331,594,632,392,1296,653,285,529,711,424,175,1164,1690,1649,857,19,0,0,19
1372,1648,5026,925,723,396,459,189,604,371,509,533,235,986,662,447,488,545,168,344,953,1532,1463,734,48,0,0,48
1373,2857,7903,838,2019,687,902,580,688,572,1041,1084,160,1767,1090,1002,1141,589,125,396,1943,3098,1698,768,55,0,0,55
1374,2783,7215,810,1973,893,773,407,710,657,907,755,464,2168,615,975,776,639,393,239,1377,2767,1632,1200,21,0,0,21
1375,2919,7652,1992,927,603,1250,527,539,532,1133,958,296,2012,907,671,1065,748,435,637,993,2096,2131,1795,77,0,0,77
1376,2108,7218,1264,844,367,520,418,803,350,759,601,398,1353,755,707,792,472,137,445,1155,3151,1762,705,176,0,0,176
1377,1989,5449,1114,875,460,566,364,599,375,832,622,160,1272,717,706,669,473,141,299,1177,2194,1184,595,21,0,0,21
1378,2799,8722,1109,1690,720,601,457,1021,634,852,896,417,1667,1132,1106,961,546,186,507,2051,3202,2122,840,70,0,0,70
1379,1458,6000,715,743,123,271,337,727,168,326,493,471,584,874,381,479,457,141,334,1643,2173,1436,414,40,0,0,40
1380,2450,7494,1545,905,453,667,399,931,568,621,968,293,1429,1021,756,802,646,246,277,1925,2572,1810,910,126,0,0,126
1381,3824,12178,2450,1374,558,1346,732,1188,787,1173,1285,579,2284,1540,980,1398,836,610,538,2468,4314,3308,1550,374,0,0,374
1382,2391,6471,1930,461,571,817,420,583,591,813,748,239,1730,661,547,554,670,620,210,1204,1768,2008,1281,20,0,0,20
1383,2738,6579,2212,526,724,1248,331,435,831,914,731,262,2337,401,699,377,606,1056,154,620,1338,2236,2231,14,0,0,14
1384,2376,6092,1465,911,525,930,405,516,636,707,757,276,1643,733,534,682,754,406,209,1065,1746,1561,1511,16,0,0,16
1385,1843,4456,1295,548,550,637,274,382,574,683,421,165,1482,361,574,409,442,418,130,672,949,1268,1437,0,0,0,0
1386,1556,3689,1078,478,547,470,337,202,564,558,327,107,1230,326,480,406,351,319,91,552,866,1133,1047,39,0,0,39
1387,1776,4614,1264,512,363,704,321,388,559,576,480,161,1238,538,435,442,543,356,142,874,1047,1375,1176,0,0,0,0
1388,396,1092,322,74,81,136,56,123,167,123,65,41,289,107,59,94,115,128,20,269,231,282,290,0,0,0,0
1389,1722,4222,1275,447,541,783,199,199,626,646,326,124,1436,286,298,447,418,559,112,563,813,1314,1420,14,0,0,14
1390,1608,3033,1244,364,623,712,136,137,701,527,320,60,1399,209,634,464,259,251,50,296,601,1076,1010,38,0,0,38
1391,1931,3976,1232,699,703,783,250,195,838,496,454,143,1646,285,642,560,381,348,43,500,1120,1208,1105,123,0,0,123
1392,1943,4854,1478,465,580,586,145,632,686,481,698,78,1304,639,491,609,460,383,460,849,1330,1217,998,0,0,0,0
1393,1446,3408,997,449,524,532,140,250,436,433,458,119,1167,279,388,372,342,344,132,449,1001,1011,815,0,0,0,0
1394,2888,9398,2101,787,348,840,596,1104,432,725,1355,376,1462,1426,419,567,906,996,662,2222,2827,2653,1034,67,0,0,67
1395,3063,8391,2171,892,736,964,531,832,902,1026,689,446,2028,1035,846,675,930,612,297,1579,2732,2349,1434,45,0,0,45
1396,3821,10202,3173,648,808,1315,743,955,1006,1068,1300,447,2616,1205,765,891,1034,1131,363,2019,2664,3152,2004,88,0,0,88
1397,2247,5147,1555,692,467,1157,308,315,815,715,566,151,1811,436,579,683,530,455,284,615,1263,1231,1754,0,0,0,0
1398,1711,3966,1065,646,515,605,240,351,460,636,540,75,1291,420,476,434,344,457,57,723,936,1201,1049,0,0,0,0
1399,1778,4486,767,1011,271,909,292,306,391,684,601,102,1273,505,491,520,362,405,331,559,1631,1160,805,25,0,0,25
1400,921,2273,696,225,169,480,121,151,313,300,241,67,719,202,164,184,216,357,131,226,560,661,695,39,0,0,39
1401,1484,3736,1074,410,275,767,238,204,467,368,516,133,1246,238,301,298,387,498,81,427,706,1312,1210,33,0,0,33
1402,3930,10208,2660,1270,898,1492,489,1051,949,1413,1239,329,2905,1025,1154,1013,1041,722,296,2017,3241,2547,2107,24,0,0,24
1403,1770,3774,1331,439,673,757,133,207,814,597,352,7,1532,238,563,611,304,292,100,407,737,954,1576,43,0,0,43
1404,1109,2502,1000,109,269,531,199,110,407,311,326,65,926,183,219,178,187,525,75,325,426,747,929,55,0,0,55
1405,1064,2770,902,162,254,359,256,195,217,409,316,122,689,375,172,204,203,485,148,403,625,1018,576,35,0,0,35
1406,722,1741,658,64,165,272,166,119,169,187,331,35,576,146,102,94,173,353,41,209,343,569,579,0,0,0,0
1407,2692,7394,1628,1064,905,649,460,678,885,904,710,193,1861,831,724,742,524,702,486,1486,1845,1710,1867,127,0,0,127
1408,2333,5554,1473,860,714,864,353,402,586,807,751,189,1837,496,330,852,535,616,331,682,1302,1896,1343,0,0,0,0
1409,3179,8171,2120,1059,798,1325,455,601,750,1127,1081,221,2356,823,443,811,713,1212,407,1191,2150,2710,1713,21,0,0,21
1410,1915,5274,1174,741,420,542,452,501,570,557,599,189,1228,687,637,403,435,440,335,1176,1857,1166,740,29,0,0,29
1411,2678,7457,1750,928,477,1349,294,558,1194,587,643,254,2035,643,922,504,545,707,315,1042,1556,2145,2399,82,0,0,82
1412,4423,10860,2835,1588,1222,1690,556,955,1373,1479,1327,244,3216,1207,1212,1225,806,1180,465,2041,2466,3299,2589,128,0,0,128
1413,993,2124,807,186,310,449,99,135,401,241,315,36,819,174,245,219,247,282,77,283,396,656,712,15,0,0,15
1414,2705,7228,2415,290,509,1016,588,592,805,898,774,228,1892,813,513,491,471,1230,99,1342,1622,2211,1954,41,0,0,41
1415,1521,3515,1016,505,492,657,119,253,403,605,441,72,1256,265,386,267,361,507,98,494,979,923,1021,27,0,0,27
1416,757,1337,587,170,419,248,21,69,347,266,122,22,710,47,270,204,156,127,28,46,237,408,618,3,0,0,3
1417,147,433,100,47,32,56,32,27,32,64,46,5,96,51,36,13,26,72,37,66,109,129,92,8,2,0,6
1418,1612,3623,1245,367,580,589,243,200,481,576,353,202,1373,239,336,325,412,539,103,374,870,1100,1176,19,0,0,19
1419,1382,3320,846,536,425,505,163,289,382,557,364,79,1046,336,385,273,303,421,176,521,884,905,834,3,0,0,3
1420,2829,7965,2167,662,481,1005,519,824,651,1151,821,206,1727,1102,249,648,628,1304,365,1829,1873,2363,1535,32,10,0,22
1421,3345,7886,1691,1654,1414,926,449,556,1416,1018,645,266,2678,667,1025,884,656,780,377,1194,1601,2338,2376,190,24,0,166
1422,2329,5957,1936,393,504,933,412,480,637,789,743,160,1610,719,353,610,577,789,154,1114,1219,2213,1257,43,0,0,43
1423,2422,6340,2196,226,589,807,547,479,695,693,878,156,1706,716,345,281,438,1358,96,1339,1058,2080,1767,65,0,0,65
1424,1783,4808,618,1165,560,722,70,431,348,665,456,314,1515,268,408,381,516,478,0,598,2199,950,1061,17,0,0,17
1425,2434,6605,1533,901,962,659,305,508,818,700,671,245,1845,589,609,479,507,839,320,886,1886,1887,1626,56,0,0,56
1426,2157,5212,2014,143,296,1221,264,376,657,542,876,82,1648,509,247,229,438,1243,187,705,916,1622,1782,0,0,0,0
1427,2733,7459,1392,1341,1047,804,357,525,890,1028,608,207,1977,756,697,733,379,924,73,1732,1977,1827,1850,607,482,0,125
1428,2427,11541,557,1870,394,434,365,1234,308,713,653,753,1194,1233,739,720,528,440,984,2826,4618,2370,743,68,0,0,68
1429,1933,4352,1027,906,632,662,332,307,366,757,712,98,1397,536,413,500,395,625,206,748,1354,1266,778,31,0,0,31
1430,2629,4868,820,1809,1350,852,277,150,609,1228,694,98,2308,321,819,727,473,610,66,436,1667,1736,963,195,0,0,195
1431,3739,8214,2170,1569,1130,1553,512,544,914,1324,1352,149,2820,919,847,847,835,1210,338,1192,2200,2642,1842,48,4,0,44
1432,1864,4576,1064,800,507,680,245,432,413,580,800,71,1233,631,321,289,359,895,228,1049,1036,1471,792,43,0,0,43
1433,1291,3143,871,420,353,466,223,249,246,490,450,105,882,409,229,253,178,631,170,564,613,1142,654,14,0,0,14
1434,2147,5093,1482,665,481,950,392,324,606,568,874,99,1604,543,514,361,541,731,240,778,1215,1928,932,14,0,0,14
1435,877,2503,717,160,181,244,188,264,201,368,265,43,478,399,86,82,145,564,120,621,477,768,517,50,0,0,50
1436,1970,5110,1383,587,488,727,253,502,492,891,560,27,1303,667,390,277,285,1018,303,1126,908,1695,1078,18,0,0,18
1437,3438,7516,1976,1462,1193,1298,410,537,1010,1371,853,204,2613,825,745,689,544,1460,347,1108,1401,2375,2285,0,0,0,0
1438,2110,5878,1024,1086,748,709,303,350,454,776,818,62,1570,540,177,466,287,1180,242,711,2014,1999,912,15,0,0,15
1439,0,0,0,0,0,0,0,0,0,0,0,0,0,0,0,0,0,0,0,0,0,0,0,0,0,0,0
1440,2789,6420,1733,1056,1014,734,496,545,825,1066,715,183,1860,929,615,399,459,1316,425,1151,1469,1959,1416,13,0,0,13
1441,2500,6006,1645,855,620,1000,437,443,835,882,735,48,1496,1004,328,498,402,1272,405,1269,1225,1949,1158,4,0,0,4
1442,2367,6105,1555,812,499,894,252,722,551,953,733,130,1476,891,244,302,379,1442,179,1550,1238,2119,1019,11,0,0,11
1443,1762,4180,1152,610,632,461,370,299,655,671,371,65,1310,452,250,315,414,783,225,554,1074,1168,1159,115,0,0,115
1444,1916,4541,791,1125,798,558,178,382,598,696,552,70,1423,493,375,516,300,725,353,874,1016,1178,1120,109,103,0,6
1445,2590,6353,1695,895,557,938,529,566,465,1088,895,142,1801,789,338,243,490,1519,324,977,1601,2091,1360,2,0,0,2
1446,2184,5703,1504,680,509,888,299,488,639,1063,439,43,1553,631,247,265,475,1197,19,1130,1055,1916,1583,0,0,0,0
1447,879,2312,652,227,195,333,102,249,312,321,221,25,586,293,115,106,110,548,104,532,399,713,564,0,0,0,0
1448,4421,7908,2547,1874,2026,1941,163,291,1375,2001,970,75,4008,413,773,753,1121,1774,241,495,2330,2323,2519,158,0,0,158
1449,1239,3074,412,827,394,408,237,200,221,681,319,18,785,454,523,215,182,319,225,670,1084,738,357,19,0,0,19
1450,2616,7208,2165,451,562,888,487,679,497,1032,939,148,1511,1105,210,397,414,1595,406,1534,1501,2278,1489,22,0,0,22
1451,1934,5297,1569,365,406,642,368,518,529,624,689,92,1151,783,292,223,270,1149,201,1413,1015,1844,824,0,0,0,0
1452,1773,4588,1158,615,338,791,260,384,379,766,534,94,1242,531,215,265,267,1026,129,780,1182,1570,927,13,0,0,13
1453,279,822,189,90,61,107,60,51,60,123,86,10,182,97,69,25,49,136,71,126,206,245,174,15,4,0,11
1454,812,1755,514,298,303,354,62,93,287,332,122,71,719,93,304,149,108,251,40,69,344,443,859,27,0,0,27
